1	144931699	T	137	AtTTtttttttaTttttTTtaatTtTatttttTcttttttTtatatataatttTttttattaaattattaaaaatattttattttttttattttttatttattaTaTTaTttttatttatTttTtaatttttttttt	C?@BAC:BBBBDEFEEDEGEEDDGEGBEEDEEGDCECEEEGBDEEEE;DDCEEGEEEEECDEDEEEFCEDED?EE;FEEE6E=EEEEEFEFEEFDEFDDDFFF;EBGDFBBFEFBFFFFFFEFFFA>DFFEF;EEA@	T	104	A	32
1	145075903	C	316	CCCcccctcTTcccccccCcccTctcCcccCcCCCTctTcccCCCTccccccTTccTCCccctccccCctcccCCCCTCccCCccccCCCcccCCctcCccCCCccccCCcccCTcccCCCccccctcCCCCTCcCCccCCCCccTCCttccCCccCTCccccCCccCCCccCCCccctcCctCTCcccctccTCccCcCtCCcCCCCCCtctCCCcCCtccCCCtcCcCccccTCCcccCCCCcccCccCcTctctccCcccccctccctctcccccccTcccctccctcCccctcCcccctcCtcccccccctc	DDBACC>?A@=AAAAA@>ABDBDDCD@CCDGCFDEEDEEDDDGGGEDDDDDDEEDDCFGDDDEDDDDGDEDDDGDGHF?@DEGEDDDGGGDDDGG9EDGDDGGBEED?:DDDDECD>DGGGDDDDDEDGG=GEGDD7EEGDGGDEDBGFEDDFGDE?EGBEEECGEEFG@EEFE5EEEFEDDEGEGEEEEEEEEGEEGEGFGGEGG=GEGFEFGGGAGEFEEGGFFEGEFEEEEDF;EEEFFFF;EEDEDGDDCFEFECFDEEEEEFEEEFEFDEBEC9EDEDEE?EEEFDFE<EFDFAEEEFCFDDAAA?@?=9B	C	269	T	47
2	179309165	G	92	ggGGGGgGGGgGGGGgGggGGgGGgGGGGGGgGgggGggggggGgGgGgGggggGGggGGGGGgGAAAAAAAgaagaaaaagggagggGGGG	?ABAGECFBGCGFGGCFCDGGCGFDGGGGGGDGDDCG>D@DDDEDFDFCFDDDDF=DDFFFFFDFEBFEDFFDGFDFGFGGEDDF??>?BC?	G	77	A	15
4	53428	G	341	AAaaaaaaaaaaaaaaaaaaaAaaaaaaaaaaaaaaaaaaAAaaaaaaaGgaaaaAaaaaaaaaAaaaaaaaaaaaaaaagaagaaaaaaaaAaaaaaaaaaaaaaaaAaaaaaaaaAaAggaaAAaaaaaggaaaaaaaagaaaaAaaaaaaAaaaaaaaaaaAaaaaaaaaaaAGAaaaaaaaaaaAaaaaaaaaaAaaGAgaaaAaaaaaaaaagAaaaaaaaaaaagagaaaagaAagaaaagaaAaaaaAAaaaAaAaaaaaaaaaaaaaGgagaaaaaaaaaaaaaaaaaaAgaagaaaaaaaaaagaaaaaaaaaaaaAaaaaaaaaaaaaaaa	CEAA?CC?A?AAA?AACBCAAAB=:B55BBABBCB>CC?ACBBCDDDEDBFFGGFGFFFEEFEEHEFAFFEEEEFFFFFFFEFEFEEFFEFEHFFFDFFFFFFEF:EE<FFFFFFFEGFFFFFFHGFFFFBFFFFFDDFFFDFFEEHDFFFFEHFFF5FFFFFEIDFFDAFFEEF@CHFFFFFFFFFFHFFFEFEFFFHFFC@FFF=HGFFFFFEFFD5FFE;GFGEFFFEFEGEEGGGEGGGGGGGGEGGBGGGHGGGHGGGEGEGGGCGFGFFCGGGFGFGGEGFGFGFEGGGG>GFFCGFGFFFGGEGFGEGGHHGGHGFGFGAGFGGGG?DCB=?@@	A	317	G	24
4	53446	T	225	CcccctttctttcttttttctCctctctTtcttcttcttcTtttcttttttCTTccttctttttTttcttccttTttTTttttCttttcttcttTtttccttcttttttttttttCctcctttctCttctCTctcCtTtttctttttccttTtttttttctttttttttcttcTttctctttttcttttttttcttttttTccttttttttctttctttcctcct	ACAC:BBC>CBD?EEDEEE8CB?E?EADDGCFGA>GAGFBEEGF@FFFGGFFGGAAGGBFFFFFGGGBCGBBGGGGGG7EGGFGGGGGBGGBGGFGEGBBGGBGGGGCFFAGGFGGBGBBGFGBGHGBBFDGBEBGGDEHHBGGGGG?CFAGGHGFFH?CHFHFGFHH@=HFCGHHCCCHGHGHBHFHEEGGH=HAHHHBF?CHHHHFHHHCEFDCDHGCCG?>;	T	166	C	59
4	60210	G	129	gGggggggGgggggGggggggggggggggaagGGggAGgggaGgGgGgGaGGggGgAgGgGggGGGAggGGGGGGGgGGAgGGgGGGGGGAGggAGGGgGGgGGGGGggagGGGGGGGGgGgGAgGgAA	A@=9GFFFGEEEEDGFEDEEFFFFBFFEFEEEGHFEEHFEEEHEGDHFGEHHEEEEEFHGEFFGHHEFFGHHGDHHGGHBFGFGFGGGGGDGHGDGGGGGGEGGGGGFGFFDGGGGGGGEFGFB@D>A?	G	115	A	14
4	60294	T	229	TTTttttTTTTTTTTTTtTtTTTTTTTtCTTtTCTTttTTTTTTTCTTTTttTTTTCTtTTCTtTTtCTTTttTTtttTTTTTTTTTtTCTTTttTTTTTttTTTTtTTTTTTTTtttTtcTTTttCCTtttttttTtTTttTTtTttctTtttTTtTCTttttttctTTtcTTCtTtTTttTtttctttTTTttTttttTctttttttttTCTTttttTTtccTCTTt	DB@AAAAFEEEGGEGGGDGDGGGGGGGDDFF?GGGGDDGGGGGGGGGGGFDDGGGGGGEGFGGEGGDGFGGEEGG?EEDFFGGGFFGEGGEGFEEGGGFF?EGGGGEGGGGGGGGEEEEEHEGGEEGGGE;EDBEDFEFBEEFFDFEEECCEEEFFEFFFEDCEEEHEFFEHFFFEFEFFEEFEEEGEE>FFFEEFDEEEFHEEEEEDEDCGBDDA>@?BC@B=CC??B	T	208	C	21
4	60335	A	226	ttTTtTtttTTTTTTTTtTTTTTtaTTTTTttTTTAtATTTTTTTattTttTTTtaTTAtatttttTAtTTatTTtTtattTtttTTtTTTtatttattTTttTATtTtTAttTtattttaTTTttTttatTtatttttattTTTTtattATtttATTTtttAattttaattTATTttttttaAAtttTtttTAtTtTattatttttaTttTtattattttatttt	A?A9BAC@CBEEDDFFFGFFEFEGFFFFEEAGFFFFGFFFFFFFFFGGEGGFFFGFFEFGFGGGGFFEG=@GGFFGFGFG>FHGGFFHFEFGFHHHGHFFBGGFCFGFHFFHHFHGHHGHGEEFCHEHHGGFHGHHGHHGHHFFFFHGHHFFHGHEEF@HHHF@HHHHGGFHEEEEHHHHHHGEEHGHEHGHEEHEGEGGFGHHHHHGEHFEFDHHGE@DD?CB@@	T	189	A	37
4	60345	G	208	GGggGGGGggGAGGgGGGGGGAGggaGgaGGGggAAGgggggagAGgggGGgGagaGgggGGgGAGggggagagGGgaGGAgGgGGaaGgggaaggGGGagGagggGagggggggggGAGAggagGGgaaGAAGaggGggaagggggAGGGaggggggGGggaGgggAGgGgGgggggggggggGagGgggaggggggaaggGggggg	@8AC@@:@@>>@ACCFGEEEEFGFEFGFEGGGFFFCGFFFFFFFFGFFFGGFGFFEGFFFGDFGGHEFCFFCFFG?FFGFFFDFGGFFGFFFFFFFFFGEGGGGGFGFEGGGFGGGGGEGFGGGGFGGEFGFFFGGGFGFGFGGDDGFGGFGGGFGGGFFGGGGFGGFGGFGFEGGGGGGGHHHFGEFGGGFGGGGGDFGFGFGGG<B	G	168	A	40
11	194509	C	153	TcctCcCtCcccCtcCctttcccCTcCccCTcCcctcCCcTcCcCcCcCcCCttcCCCtctcCCccccccCtcTtcccccCccCTTCcccCTcCCctcTcCtctTTcccctccccctcccctcTctctCctcCcCCCttcCcctcttcccccc	BC?@B>CDECCCGFA>BG=GBBBGEBGBBGGBGB:GBGGBEBEBGAG?GBGGGGBGGCG@HCEGB?BBCCGHBGHCCCCBDA@FGEGCC?DGBEGCFCG<GHCHGFC>BCBCCC@CHCCCCHCFCHCHFCHCFCFFDAHCFCC>ADD?:>>;<	C	114	T	39
17	21194771	A	140	AAAAAAAAAAAAAaaaAAAAAAAAAAaAATAaaaTaaatAatAaatAAaATaAAtaaaAAAAaaAaataAAaaATAAAAAAaAAAAAaTAaTAAaAAtAtaAAAATaAAAAaAaaAAAaaAAaAaaaaAAAaaAAaAaAa	CC<??DD<FFFFFEEEFFF=FFFDFFEFFFFEEEEEEEEFDEFEEEEFEFFEEEEEEFFEEFFFDEFFFFFFFFFF9FFFEFFFFFFFFFEFFEFEDFEFEEEDEDFEEEEEEEEEEEFFEEDEFFFEEEDFFDDEC@?@	A	126	T	14
