1	900298	C	67	GCGGCCCGcGCGCCCCCGGGCGGCCCCCGGcGGGCgGGcCGGgGGGCCCGGGGgCCgCGCGCCGcGC	<B@CDDDCAADBDCDDDCCBBCBCCDCCBBC;BBCDBBCCBAEB7BCCCBBAADBDCA@A9@==<AC	G	35	C	32
1	1116227	G	65	gAGAaaggggggaaaaaGGgGaaggaagaagGagaaaAggggaaaagagaaaaaAaggaggggaa	??@<BEBBCBBCEFEEFEECDFFCCEFCFFCEGCFFFFBDDCGGGG8GDGFGGGFFDDEDDDDGG	A	35	G	30
1	1225641	C	64	ACaaaACaaacCaAAcACACccCACCACccCcACCcaccACACcCAACcAAAaaaaaaCAACcC	HDFFFFD@FFFDFGHFGDHCGFCCDDHCGBDFGCCGGGGGCGCGCGGCGFGFEDEGF?ACC?A?	A	32	C	32
1	1226348	C	50	GCggGGGgGCGCCccgGGCCGCGgCcggGgcGggccGcgGGgcgCgGCCC	<?DE7CCE>DCEEDDGC=@DBDCEDEEGBGEBFFEEBEF9BEEFBB>@A?	G	30	C	20
1	1226552	G	55	GgaGGGGgaAAgaggaGgaGgaaGAAAGgaggggggaagaggagggGgaaAAggA	<@C>=@<CF:GCFCCFCCFCC@FAHHHCDG@BDDCDGGDGDDFDDDCDGCGGDCG	G	33	A	22
1	1246004	A	46	gAAGgGGAgGGaGaGgAGGggAAaGgAggAAagGgGaaggaAgGgg	BCEHFGC7FHHFHGHGEHFFGEEGHGDGGDCEEGGGGGGGFDFG:F	G	29	A	17
1	1263144	G	67	GGgaagGgggGGAAGaAaggaggAgAaagagggggaGgaGaaaAaagaagagggaagaaggagaagG	BBAAC=?ABAADEFE?<FCCFCCFCFFFCFCC@CCFECF7GGEFGFDGGCD>6D=GDCFDDGDFGCC	G	36	A	31
1	1288583	C	59	GCCGCccCGCGgCGccCGGggCgCcCGgCcGCcGCGCCcgCCgCGccgCCCCCGCcgGC	;DD=DBBDBDB7DCBBDCCDCDDDBDC@DC8DBCDCDDCDCCDCB>B5CCBBD<C<:A?	C	36	G	23
1	1289911	G	54	gaagggAaaaaggaaaAggagggGGaggagagaagggggaggggagaaaggaaa	CD<;A@=DGEGCCDFFFCCCC?CEFFCCFCFCFFCDCCCFC7DDFDGD<DAGEG	G	29	A	25
1	1293764	G	57	CGGGGGCGGGCCCGgcGGGCgCCCGCCGCGGgCCGCCGGGcGgGggGGcCcggGGCg	CCC@=C@CBA:>DBCCCCCDDDCDBCD>CBBD@CBCCBB?CBDBDDBBBBB>CA==?	G	35	C	22
1	1354515	C	103	CCGGcGCCGGCCCCccGGcgcCGGCggcgcgcgcCCCcGCggGCcgGgGcGcGCCGcccGggccccggCGGcgggGcgcGcCGGcgGGGgggcgCgCgCgggg	D?B?BBECHHGEDEDDCHDEDGH@EFEDFDEAEDGGGDHGFEHGCEH?HDGAHGGHE9EHCFEEEEFFEGHEGEFGEGCGEDGGEFDGGFEGEFFFF<FF@D@	G	55	C	48
1	1560865	T	62	CtttCtTCtCCTtCtttttttTTTTTtTTtTTttTTtTTTTTTtTtTTTtttTTtTtttttt	?EEECFB?F75@>=EFC:FEEFFE?>FFF<FFEEFF:ECEEFFFE@FFFCBADF<B;A<?==	T	56	C	6
1	1918584	C	40	CtcctcCcTcctTctccttctctttcctcttcctctCctt	A?BDDCDCGDDEGDEDDBEDEDEFFEEFEFFEEEEBCECB	C	21	T	19
1	1988044	G	33	cCccCcGgcCCgccgcGCgGcccGcCGggcgcg	>=BAEBCCBG<CBBCBGGCHCC:ECGGDDCDCD	C	20	G	13
1	2075560	T	25	TTTTGGTGTTGGGGTGTGtTTTGTG	?E=EHGEHDEGGGGDGDFHCDCECD	T	14	G	11
1	2433900	C	70	CtctTttTTcTCcTCCTCCcTCCtCTCCCTTttTTtTccCtCtTCCccCCCccTCCCcCttTCCctcCcT	@FBGGGGGG@DEBGDDGADBGDDHCGDDDGGGDFFHBCCCHC9FCCCCCCCBCFCCCCCHHEBCAB?A=A	C	40	T	30
1	2487663	C	83	CCAACACacCaAaACccacAcCCCaCCcCACAACACAacaCCcAAAaAACACcCCcCCaaAAAccAAaCcccAaAAAAACccC	A>BBCEDEDDEHEHDDDA>HDDDDE7DEDHDHHDFDGE@EBDEGGGFGCCGCECCA?CFFGGG@EGGFBEEEFCC?EDBA@@?	C	43	A	40
1	2488153	A	40	gaggaAaagaaAagaaaaAgaGggagaagaaagaAgAaag	@AEFDEDDFDDF6FDCDDFFCGFGDF9EGEE@DE@GEE@C	A	26	G	14
1	2490898	C	141	CccCcccaaaCAccccaCCccaacaacaccaccaaAccaacACCcaAccacaaCCaccCCCCAcACCAAaaCAcaaAcCcaCAacACAAccccACCCCAaCCcAAACCCaAccCAcaAcaacacCaAcaAaAACaCcAACA	BC?;:=8CDD?8?@;BGEE?>EEBFFBFBBFBBF@FBBEFBFGEB@F<BFBFB7GEAAG5GFFBFFBFFFEBFBBEFCEC:FF;CFFFFCCA?F@F8FD<9F?ECEEEEGECCFE>GDCF9>DCE<ECGEGDDEFF=C?AB	C	77	A	64
1	2700117	C	32	CGCCCGGGCGGcGCCGCGcGGcCGCCCCgGCG	ACDDDBA6CCBGBCCBCBFBAGC<BCBCA=CC	C	17	G	15
1	3414105	C	59	TCTCcTCCcTcCcTctTCccTtCTtTTtCTtCttCTCCtcTCCtCCcCctCctTCcCct	@5GDBGDDBHBDBGBGGDBBGHDGHFGEDG=D:GCGCCGBFCCGCC@CBHCCHEBCBAA	C	33	T	26
1	3416502	C	31	CtctcCCCCtcTccTcctcctcttcttcCct	CCB7CFFGFEDFEDFDDEEEFEDEEE;EEE@	C	19	T	12
1	3440824	G	107	GGAgAGGGGGAagGgagGAaaaGaGaaagaAgGaggGGgggGAgGggGAgaAAAGaGaGAaAGaAaAgaagAGgagAAggagaggaaggggaGggaaaagaggggaa	@=;@DDEEEEEFBECFCEFFFFDFEFFFCFFCEFCCEECCCEFDEDBEFDGFFEEGEGDBFFD8FFEDGGDEDAGCEDDDGCBDEGHD;DCFDDDGGGGDEDDCCBB	G	58	A	49
1	3644349	A	74	agAggaaagGgaaaaagggaagaaggggAaaaaggaaaaAgaggaaGggagagagagagaaaggaaaaaagagg	ACA=ABCCC8BFFFFFCCCFFCFFCCCCGFFFECCFFFFHBFDDGGCDDEDGDGDGDGDGGG:DGGGHDGDG@A	A	42	G	32
1	3645835	C	31	CCCCACAAACCAACCcCACACAAAAACCCCc	DDDDHDHFGCCGGCCECACGCGGGGGBBB<B	C	18	A	13
1	3645844	G	35	GGGGAGAAAGGAAGGgGAGAGAAAAAGGGGgGAAA	CCCCHAH@GCB?GBBGBGBGBEGGGGBBBAGAFEC	G	19	A	16
1	3646192	G	60	aAAaAagGAAGGgAaGAAgaGGGAGGggaAgGGaggAGaggGAAGgAagAAagggAggAA	AA>CCDEEFFEEEEEBEFDEEEDEEEGFFFEEEFGGFDEFEDEEDGEEGEE?GFFDGEBC	G	31	A	29
1	3647962	T	32	CCCTCCCCCCCTTtcTCCcTCcTcCTTTCccC	GGGGGGFGGGFGFHCFFFCFFCCBFFFB@;<@	C	22	T	10
1	3679146	G	33	GAaGAAAgGaGGGGGaGaGGggaGAAggAagGg	?>FGFFFCGFDGGGGGGGGGDDBGDEDDD<C>A	G	20	A	13
1	3688030	C	60	GGcGgcgcGGCcccCGcCCCgggCcgCCgGGCgGGgGgcCgccgggcCcCccgcgccgcG	;<A=FCECCCCDDDDCCDDDEEEDDEDDFCCDG@CFCGEDFDEFGGECCCDAFEE@@B=?	C	31	G	29
1	3701663	T	36	ctTtcTTCCCTtcTCTtCTCCTttcTcTCCCTCTCc	?FEGBEEGGGFHCFGFHDEDFEHIBEAEEFFAFDB=	C	18	T	18
1	4772717	G	62	AgAgagaggggaagaGggggAgaAAGGagggGggGGGAAgAagagAGggggggAgGGagAgg	A@HCECECCCCFFCFCCCCCHCFIHCCFDDDCCCCCCHHDHGDGDHCCDCCDDEDBCGDGB>	G	41	A	21
1	6147407	C	40	CTTCCCTCcTCCTTTCTCCCTTtTCtcTTTCCcTcccCtC	AGGDDDGDGGD>GDGDGDDDDF;FCDFFFFCCHEGDC@?A	C	22	T	18
1	6157282	C	28	TTCcTTTCCTTTTTTCTTTCTTCCTTcT	FF6DCEEFGFFFEEEEEEEEEEEE?B<C	T	19	C	9
1	6170353	C	41	TCTtTCCCTtCTTCTCTCTCCCtTCTcCCTtCTtccccttc	;EGGGGDGEHGGFGFDGGGFFFHFFFCFFFHBFHCCBBG?>	C	21	T	20
1	6185532	G	46	AGAAAGAGAAGGAGGAGaGGGaGAAaGaAaAgAgaGAggAAGggAG	?E6FFFFHFFGGFGEEGGFFFFFEEFFGEGEDEDFEDBDEEE@@B?	A	24	G	22
1	6188779	G	56	ccgGgcgCccccgGccCcgcgCccccgcGcccGGgCCccCgggggggccgcCcCgg	CCADC>CFABABCGBBGBCBCG<B:BCBFCBCEHDAECCEDDDBDD7CCCBFCFCA	C	33	G	23
1	6196943	A	49	gAAAaagGGGAagAAaaAGaaaaaaGaagaaGaGaAgaggGaaAggaag	B<<BDFEBCCHFFHFFFICFF8FFEBG<GDEAGBCGGGDGBE5GGGE@G	A	31	G	18
1	6196951	T	41	aAAATtaTTttTAtttttAttattAtAtTataaAtTaatta	?BB@GEFGGGGGEGGGGGFHGGH@FHDHFGHGHDFFEGHE?	T	24	A	17
1	6210970	G	39	AGGAGGAAAAAGGaAAAGGGGAGAAAAAaAaGgGAggAG	CCCHCCHHHHFCCGGGGBBBBGBGFFGGGFGBCAB?<B?	A	22	G	17
1	6257826	T	58	TTCCtctTCCctTtcCCCtTCTcCTtcCCTCCCCCtCTtcTcTccCctcCctTTttcC	@EGGDGDGCGHCGEHGGDEGFGHGGEGFFEEFFGFEFFFGFDEF>FHEHFHEFC@>=C	C	33	T	25
1	6269120	T	31	ttTTTTTTTTTTTTTTTTTTggggggggTTT	CCFFC@EBEAEEEDEEEEDDDD:>7EDCCBC	T	23	G	8
1	6399724	T	30	ttTtcctTcttcccCctttttctccttttc	?HCGBBGEBGGBBADBFGHHHCHCCHHHCC	T	18	C	12
1	6705874	G	171	GCGCGCGCGGCGCGCCGCCGGgCCCCCCGGGGCCCgCgGGgGGCCGGGGgCCGGCGCgCCCgcCGCCgCGgCgGCCCCcggGGGGCCcccggcCgCGGGCGgccCGccCcCGGGCGGgGGCCGgGCGCcgGCCCCcGGcCGGcGGgggGcggCGGgcCGggGGGGggcGCC	B:?EDFEFEEGEEEGGEFGEEFEEEGFGCEE@FGFFFFEEGEDFGDEEEEFFEEGEFGGFGGGFEGGEGEGCGEGGFB?GGEEEEFFGGGFGGEGFDDDFD>E8FDGGFGFDDDEDDG@DEEDGDEDF?FDFFFEBDDGFDDGDDGGFDGFGECDGGDCFFCBCDBB<ACC	G	93	C	78
1	7797503	C	190	gCggCcCGcGCGgcgCGCcCcccCgGGggCcggcCCccCcccGggCCGCGGCCGGCcgCCCgcggGCcggCGGGGCGCGGGcCCCcCgcGGGGCCCggcCcccgGGGGcgcgCCcccGCGCGCggcgGCGCCCgggCGCcgCgggGCgcggGGcGGCgggGcCCCgcCGcCcccGGGgcgcccgcCCgCG	B:ABBBCFDGGFFDEGGDDGDD@FEGG9DGDBEDGGD<GDDDGE@GGGGGGCGGGGDEDGGFDGFCGEGFGFGGGGGGGFFDGBBEEFEGEEFFFFFFEGAEEFFFEFEEEFGFEEEFFCGFFHGCEFFFFFFGGFCFFEFCFFFFFFAEFFFEFEFFFFFEFFEFEEFEEACDFFFFCE@@@B>BA=C?	C	99	G	91
1	7863051	A	34	TAATaAATTaTATTAaAAAAAAAAtTATATATAT	GFFGGFEEGGEE@FEGEEEEEE;EHFEFEFEEDF	A	21	T	13
1	7906914	T	86	TccctTccTtCtCTtcTTCttCcctcCtcccttCctTctcTcCccttccCcttccttcccccttcTttcttcttccctttctttct	AACC@@EGECGDGCDGEEGDDGGFDGEDGGGDDGGDDGDGEGGGGEDGGGHEE<GEEFHHHHEDHEEE>EEGEEGHHEEEHDEEH@	C	44	T	42
1	8384575	G	89	ggggggggCggCgggggggggggCggCggggCgggCgggggGggggggCggCCCgggCCgggggggGggggggggggggGGggGggGGg	AC@AABCF<EF@BFFFFFEFEEF@FF@FDFFCCEF?DFFFE6GFGEEEBFF@D=F7FD9GF8GFGCBFGEFEGGFG@GGBBFE@7ACCD	G	77	C	12
1	8384582	A	87	CaaCaaaaaaaaaaaaaaaaaaaaaaaaaaCaaaaaaCACaaaCaaaCaaaaaaaaaaaaaaaAAaaAaaAAaaAAAAAAAaaAAAA	8>A:;CDDEDDCDD@DDDDCDDCCCDDDEE?DDD?DC8C9EAE>ED:7EEDEA9EEEEBBCEEGGF>GEEGG?EGGDDBD>?<BBCC	A	80	C	7
1	8390495	A	71	gAAgGggAggGggAgAgGaAGAaagGgAGgAaAAGGAAAGaGgggaaaGGGgGAAaaAGGGgaGaAAGGAG	C>CCBFEHFECFEHF8FCEHBHAEFAEB=EBDHH<CGGHAFBEGFFGF@BBEBGGAFGBBBGEBFED?:BC	G	39	A	32
1	9011537	G	174	AGGGgaaGAGGGggGgGAGGAGagAggAGGGAGgAGggAAggGAGGggAAAGGAAAgGaGgGGAAgAGGGgaAAAGaaaAgAaAGaGAGAAgGgAggAgaaAAAaAAAgGGgGGGGGGgaaGgggGGAaAaaagaaGggGAggAgggagggGGGgAgaAGAgAAAGgAGAggga	;;=BDDBCACA@EFCFCH;CHCDFHFFACC@HCFGAFFIHFFCHC;FFGGHC>HCHFCECFCCGHFHCCCGEHGGCEEEHGHEHBECHCHHG:G>GGHGEDHGGDGGGEBBGBBBBBBGEEBFDHBBGEGEEEGECBGGBGFGGFGGEGAFBAAEGGEFAGEHHB@CD=CBDAA	G	101	A	73
1	9034421	G	93	aAGgAaaGGgGgAgagGggGGGGAagAgAaagGAaAAAgagaAaAAgAAGAGAaAAaAGGAGAAAAgAgGAgAGAaaAAAGGAgAAAAaGGGG	?A9CCFFEECECFCDCD@CEEEEFFCFDEGF=EF>EFDDGDGFG>FDFEEFDFFFDGEDDEDEDEEDDDDEDEDDGGEEDDDEDEEFEFCBAA	A	53	G	40
1	9070178	A	83	GAgGGgAgAAAAGAgGGaGAAaAgaAaaAAAAGGaAgGGagAggAAAagAaaGagaaaaGggGaaGGgaagaAaGGgaGAGga	8BA?BBHCFFF@CHCC<FCA;FHCGCGF9GEH@AF<DBCGDC@DFGGGDGGFAGE5GFGBDDBHGBBCGFDGGF@AAB<B<<D	A	46	G	37
1	9307230	T	36	taaaattttttattaattatatataaaattaaAtaa	AABCBCDFDEEDEEFFEEFEFEFBFFGGFEGFEF5E	A	19	T	17
1	9658707	G	41	gggaGaaggaagaagaagagaaaggaaggaaaggagaagag	AABFBGFBBFFCFFCFFCFCFFFCCFF@CFGGDDGC7GDGD	A	22	G	19
1	9670483	T	45	ATTATATTAAAATTTATAtATATaTTAtaTAATatAATtttTAat	BFGFFE=FEFFFGGFFGFG@EEFGFFEHGFEEEGFEAFDE>C?DE	T	24	A	21
1	9670834	C	25	tCtcCCtcCttctttctTtcctccc	A=C?@DFADG:BGGGCGGGCCHCCC	C	13	T	12
1	10689942	G	40	tTtGgtttgTgTtgtGTtggtTTTtggttGgtgGtttGtG	BFGECGEGCCCDGC>ECGCDGFEFGDDHEE?GDDHHHDHE	T	24	G	16
1	10714436	C	38	cTTCCTtCCTCCCCCCTTTtTCtCTCTTTCTCCCTCTC	BFG>DGHDDGDDDDDDGGGHFCHCF8FCFCCCCCECFB	C	20	T	18
1	11014118	C	253	ccTtTTTcCCcCccTTTTTtTccctcccTCcCcCTTTCTctCTCcCCTCcTtTCtcTTtcCCTccTCTcCCttCTCCTcTTTcttTCCCTccCTcCCTTTtctCttCCTtccTccCTCTttttTCCTCcttCccCTcCCTctctCCtcCttctccttccTcttccctTCcttctcctttccttccccCctCTTtTTttccCtcttttccCCtCctttctccttcCCtccCTtcTttCcTtCtCTcTtcCCCTc	AC;A>?ADCBGEFFF7?FFDFFFFCCFGFFGFGGDFFFEGDGFDDGGFFGFDFGDGFF;GGGFGG9GFGDFCDGFGGDGFFFG6DDCGFAGGGFGGGFFFCGAFECFFFBHHFGHGDFEEEEEEFGEFHEEFHHFBGGFFHEHDFFDGGDDHDGHEEHGFHEEHGHEDFGEEGEHCDDEEGEEHHHHFHEFEEEEEEBEHFDGECEEIH?FEEHECEHEGHDEGFFEHHFEEHEDEEHEEDDEEGDACBBAAC	C	134	T	119
1	11735262	C	32	ctttTTCTtcTcctttccctcctcctccccct	ADGFDGGGGBEBBGGGBBBGBCHCAHCACCCA	C	17	T	15
1	11737051	G	70	CGGggCGcCgcGGcGcgCcgcCCggccGggCgCgGcCcGcGgGcgggcCggcggcccgcgccccccggcc	A;;AC@?FBGHC@GCGFDGFGDD<DGG@FFDDDFAFBGDG6FCGFFFGDFGGGGHGHGFFGHGHHH>FH@	C	36	G	34
1	11740358	A	96	GGGGgGgGgGGGGGgGGGGGGGGGgGGGggGGgAAGAAAAAAAAAaGAAGAAGgAGAgGGGGaggAGgGGGaAGaaGGGGAGgGGAGgGAAAGGGa	GGFGFGFGFGFGGGGEFAGFFFFFGFEFHGFFFEEFEEEEEEECEHFEEFECFGEFEGEFFFGGGDFFFFEGEEEEGFFDDECCCAB>BAC????B	G	66	A	30
1	11779762	C	78	CtTtctTTtTTcTTCccTcTctccctccTCtcCtctTTtcCCtCcTTTtcTCCTcTTTTtccTtttcCtttTttcCtc	BC@@?>A?FCFAFCFBBEBFBGBBBGBBEFGCAHBHFFFC7GH=BEDFHCDFF=C;CDEHCCEHHC@EHHEEGC=?B>	T	45	C	33
1	11824346	G	67	AgAGggGAgGAAGAaAGAGAgGggaGAGGAAAGGAGGGGGaaGGgAAaAAgAGAAgAAAgGAgAGgA	<DEGCCHECHECIEF>HDGECHDDGHDH@EEBGGEH?GGHGGFFDDBGDDDDGD6DDDD@FCDC>=C	G	35	A	32
1	11844330	C	114	cctccctcTTctTCCttcCTCCTcttcttCCCtctCCctctccTtccCTctttcTTccctcTTCCTctctcCctTtCCCTTtTttcTtttcttCTCcttccTctcctctctccc	?ACAC6B<?B=EDC@EFBDG@DGAGGBGGDDDGBGDDBGBGBBHGBADGBGGGBGGCAAH@GGDDCBGBGCCC9GCDDDGGHEHHCGHHHAGHBFCCHECCFBGBCHCHAD@B?	C	59	T	55
1	11905995	C	89	ACACCAcAACACACAACACaACACaaACCACccAAAcCaACCAACACCaAaCCAACAAAACcACAACAACCCAaCACAcACAAaacCca	ADFDGFDF<GFGFGEFGFGCEGFDFFFGEDGEEFEEEFFFFFDEFDDF5=EDFEEF:DEEFEEFEEFEEFEEEFFDGCBC=A?A>;CBC	A	49	C	40
1	12082461	C	113	tCCCTCcTCCCcTTCTCcTTTCctCTCCTTTCcCCctTTttCCCTcCTctcTcTtTTttttTtcTctTccCccCCTcctTtTCCTctCtCCCCtCtTccTTTcTCCTcTTctC	C<>>@?DDCD:DGG:GDDGGGDDED9CCHHGDD?DDEGGEEDDCEEDDE?EFEGFGGFFFEDFDGEDGEECEECCEEDDFEFCCFDFCFCCCCECEFEEFEFEF@CFDEA@?C	C	58	T	55
1	12628471	A	69	aCaaccAAaacCaaccaaAcaacaCaaCAacaaaaAacacccaAcaaccaccaacCccacCaccaccca	?8CCEFEFDDFGDDGGDDFGDDGDGDDAFDGDDDDF9GDGHGEEHEEHGEGHDEHFGADHGDGGEHBGE	A	37	C	32
1	13910417	C	128	CTCTttttctccctcCcTttTcTccCcCtTCccTtcTCtTtcTTtttTcCTCtTTTTccTTCTccttCCTCTTcCCTTtcTtTCTCTTTCctTTcTCCTCTcTTTCCCCTtcCCCCCCTTCTcTCCCT	=?@FDEDBDEDDDDDDDFEEGDFDDDD?FGDDDGFDGDEGEEGFFFFGDDD=DGGAGEEFGDFEEFFCCFCFFECCFF>EEFFCDC@FFBEFFFEFCCFCFCFFACCBBFEECCBBCBFFDDBDBA@C	T	67	C	61
1	16042725	C	29	CCCCCCcCcCcCctCtcccCcCtCcTTTt	@GG@FCFGGGGG@F?EFGCFGF>F@DC>?	C	22	T	7
1	16096934	C	27	TCCCctCcCCCTCtTTTTTCTCCCCTC	=GG@EEGEFFFEFEDDDDDFDCDCDCC	C	16	T	11
1	17313454	G	57	AaGgAggAaGGAAAaGGAGaaggGaAaGgGagagAGagAAAAGGGAGAGGGGGAGGA	>CGCC<CEFGHECDFAHEGFFCCHFDGFDHFDGDEHFDDEECGGGDG=FFGGGDGGA	G	30	A	27
1	17319011	G	144	AgggaGgAGAGaGGAggaaagGGaaAaGAGGGGAGGGGgGAAaAGAaagaGgGaGaaAGAAaagGgaGagAggggGGggaAaaAGGgGaGgGAGGGgggggGGGgGAgaAAgGGaaGAGggaaaaggaAAagGAggggGGAgag	>=@ADCD:E9DFEEBCBFFFCBEFFDFEFEBEEFEEEECFFEFCEFFF9FECE5EGGFE<EGGDEDGDGDFDDCCEEDDGFDGCDDDEGDDECDEDDDDDDDD@DAEDG>EDDDGGDEDDDGGGD9DG?DGCCDBBDDEBC<@:	G	85	A	59
1	17402116	G	93	TTGTTGTGGGGGTGtTTGTGTTGGTTTGGggGGGGtGgtGGGGgTGTGGtGtTgTGTTGTtGTGGtgTTGgttTTGTTTTTGGgTGgTtTGgt	???EFCF=CCC6DDGGGACCGEBCGGF=CDBCCCCHBDHBA;BDFBFBBHBHFDFBFCBCHBFBBHDFFBDHH?EAEDFEFAADDB?B@A?B?	G	48	T	45
1	17557133	A	134	cAAAaAACACaCACAAAaAcCACAAaACaaAaACCAcCAAACAACACaacaaaaaCAAaaACAaaAaacAAaACaaAcCAAACAacAaACACAacAaAaaACcaaaccaaCcaacaCcaaaaaAaCccAcacCa	CCCBCFGCFDFDHD=GHFHBDHDHBFHDFFHFHDDH@DHHHDHGDHCGGBGGFGFDGHG=FDHGBGDFBHHGHDGGHCDHGHCGGBGFGCGCGGBDGGHHGCCGGGCCFGCCGGCGCCGGFFEBCB6>B<;7CC	A	91	C	43
1	17707739	T	49	CttCTtcCttCccttCTcctTcttcTccttttcTtcCtctttttccttc	?7BEGEFGDEGFFEE>GFFEGFEEFFEEFFFEGDFFGFGFFFEFGHFFE	T	28	C	21
1	17929990	A	96	AAAAAACAAAAAAACCAAACAACCCACCCCACaACCaaaAAAaAcCAcCAACaacAAcAcAAaCCCcCaaCCcCAAacCCCaACaAcacCcaCCcC	HHHGHHDGGH8HFHDDBHFDHHDDDHDDADH@EHDDFD8HHHEHECFECGGCEEEGHEGEGGCCCCACB=CCECGFFEBBBEGC;GADABB@B>??	A	52	C	44
1	18807953	C	171	caaACcaCaCCcaACAAAcCcCcAacaCCAcAcacCAccCCCCAaCCCccccaCaccaaaCAACaCcAAAaCCCaCAaaaAccaCCaaacCCcAccAacAACAcAcAccccaaaaccCCccAcCCAAacCCAcCCaCCAccCCCCCCCcaccAACccAcCCCACCCCACca	ACC:?>EAFBDBFHCHHHBDBCBHFBFDDHBHBFBDHBBCCDDHFDDD@B@BFDFBBFEF@HCDDDAHGDGCDDGCHFGEHCCGDDGGGCDC8F?BHFCGGDHCGCGBBBCGGEGCCCCCBHCCCFGGCCCGC@BGCCGCCCCCCCCCCGCCGGCCCG>CCCG?BCCDA>B	C	104	A	67
1	19199487	A	65	gGAaGgAAAaAgagGGAaaGGgagGagGaAaAaaggGgggAggaaAgagaaaaAgaGgAgaagaA	A>CGCFEFEFFFFFEEFFFE?FFFCFFEFFEFFGFFEFDGFGGGGFGGGGDEGEGGDGEFGGGCB	A	35	G	30
1	19202896	G	49	aGaAgagAAagaGgGAggaaaAGgaGgGagaGgGgGgGaagggggaGgG	D@FFCFCGHFC@CC@HCCFFG;C9FCDCGDGCACDBD?GGEDDDDAB?C	G	30	A	19
1	19216428	G	33	GGGAGGAAGAGGGaAgGGGAAGAAgAGAAGAAA	EDEFDB=FEEDDEGDD;DDEEDEE?EDEECABA	G	17	A	16
1	19487656	T	53	cCTCcTTtccCcCTcTcttTTCCctCtCccctcttTccTctcCccCTttcttt	A:B7>AGFBBGBGFBGBGGGGFGBGGHGCCCABGHFCCFCHCFCBFFGHBHGC	C	29	T	24
1	19490231	C	132	CCcGCCcGccGGGGcGCccgGccCCcCCCCccGCGcCCCccCGCCCcgcggGcCGCcgCGgcGCcCCggCCCCCccGgCcGcgcCCccCCcgGCgcccgggcGcgCCCGCccgCgccgccGcgcGgGgccCc	A9C??@CBEDCCBCDCCDDFCDDDDD;DDDEDBDCDDDCDDDBDD?CGEGFBED;DEEDCGECDEDDG>DCCDCEEBA5EBEFEDCEEC;EGBCFFE@GFGEBDECCCBCEEFCGDDDEEBEGDBGAEDC@@	C	87	G	45
1	19565344	C	81	gCCCgGcGCgGCCCCGcGGCCCGGGgGCgCgCcGGCcCGCCCgcGggccGGCggGGccggGGCGcGCcGGcgCCGggccgc	BFGGEGFGGFFFGFGGFGGGGGFGGGGGFGGGGGGFGGGGGG=GFGGGGFFFGGFFFFGGFFFFGFFGFEGGFFECCBA@?	G	42	C	39
1	19582563	G	53	aagAaGgAAAAGgGAgaGagagaGaGaggAAggagggaggaAagagaggggag	AC?<?E>EFFFGCGECFGFCFCGGFFEDD:DDDGDDDGDDFEGDFDAD:DDGD	G	28	A	25
1	19683301	G	45	gTGgtttttGtttttgGTgGGGGgttgtttggtttggggtgtggt	?>@AHGGGGHGGGGGBIECHHFHCHGCHGHDDGHHDDDDFDHDDF	T	23	G	22
1	20662938	A	88	GAGagGGGGGgggaGgAAAAGgAAAaaAAgAgAaagaGGAgaagGGGaGAaGgAAaGgAaAaGaGAAggGGgaAaGaagGAggGggGA	D??DFEGFGGFDFDGFFFFGGFFFFEDAFFFFEDEFEFFFGEEGGGBEGFEGFFFEFGFEEEGDFEEFGFEGFEEFEEGE<GFGCBC?	G	46	A	42
1	21329345	T	31	CtccttttcctctcCctcCtcctttcccctc	@D@BGGFFABGBGBGBDBD>BBGGHCACCGC	C	18	T	13
1	21625357	G	52	gggggagAagGggAagaaaaggAaGaggaaaaggAGgaGGaaaaaaAgaggg	?AA@AADAFCGCCFFCFFFFCCFEFFCCFFFG@DFGDEGGGFGGFGEDGD>?	A	26	G	26
1	21896767	C	98	cCtCCtCCTTTTtcCTCCTTcCCTTCCtCTtctTtctctTCccTcTCcctttccCCCcTTctCTtcTTcTCCTCCtTTTttTcttctccCTTTCtccc	C<@BBH7B8GFFEBDGDDGGBCDHGDDGDGHBHGGCH7HGDCCGCGDCCHHHCCCCC;GECC@FHCFFAFCCFCCHFFFEHFCH:CGABBEDCAC=;>	C	49	T	49
1	21929260	A	105	AGAAGAaGGAAAAGGaGGGGAgAgAaGAGAgAGAGGAGGgaAaGaaGaGAaAGAGAAgAGAAAGaggAaaaAAaAaaaagaAagAAAAGgagggagGAggagAGg	AEFEEFFEEEFBFEFF=EDEEFEGE=EAC;G<EFEEFDDGGFEEGEEFEFGFEEEDFGDDAEEDGGGEGGG<EGEFGGGGGEFGEEEECG>FGFE@AA6B?<?CD	A	60	G	45
1	21934693	T	53	CCCCTTttTTTcCCtTTttctcCCtTTcccCTcTCtCttTttTTCCcCTCtTC	<>?DGFFGGGHBDDDGGGHCGBDDGFGBC>CFCFCHCHIFHHF=CCCCEC@CC	T	29	C	24
1	21939741	G	78	GCGgcCGGgcGgGgccggcccggGCcCccgcccGcccgcggGcCgccggcgggcggcggcgGGggccggggcggggcc	BABC?@=8BCADDFGGEEGGGFFECGGGGFGGGEGGGFG9FEGGGGGFFGGFGHGGHGGHGEDGGHHGDEGHGGEGHH	G	44	C	34
1	22970642	C	77	TCCcctttTTTTTTcCcttTtctCtcctCTtCtctctCTTttCTtCTCTcctttttCTTtCCTtTtttTcTtCTTcT	CCDBBCGGGGGFGGBEBGGGGBH>HBBGDFHDHCHCGDGGHADGHDGDGCCHFH9HCFFIACFHFHHCFCFHCFFBC	T	50	C	27
1	23340361	C	35	TTCTTCCCTcCTTTCCCCTCCCTCtCCCcTCCCCC	DFDGGEDDCEDGGGDDDDFCCCFCF;CCEFBC>CA	C	23	T	12
1	23697617	T	26	cCctctccTTtctttttcCTTtCCtC	A<CFCEDAEEEDEEEEEDGDBEGF?F	T	14	C	12
1	23810658	G	32	aGaaAAAAgaagaaggGaggaGaaGgggaaag	C@CDEEB>CFFCFFCCEFCCCEDGEDDDAGFD	A	18	G	14
1	24201109	C	76	cCtCTTTcCCcCCcTTcCTtTCTcTtctcTtccCcTcTCCccCTcTcCTTCTCTTTTtTTTCCTTCCtTCCCTCTT	<?DFD?CBGGBGBBEEBHEGE;EBEGAGCDHC@GCBCEGABCFDBDCFDDFADDDDCH@D:FFCDEFHCEE<ECBB	C	39	T	37
1	24421334	G	42	TGGTGGTTtGGTTTGtgTGTGGGtGTTGTgGgGTGTGGTTgT	FEDGBDFEGEEEDAEH@EDEDDDHBEEDE9DCDE>DDEDD>A	G	22	T	20
1	24671287	C	85	TTTCCCCCTcTtTCTCttTTCtTCTTctTtTttTCCCCttTCTttTCTcCcCCcttctTtcCCCTtCcCTcTtCttctTcCtccc	ABDCGGGDGDGDGGGGECGGGBFFFGEFGE?FFGGG;G9FBFGEADFFD?EFFEFDEF8:FFFFFFFEDFEBFFDEE?CBA:BBB	T	46	C	39
1	24695749	C	52	GCCGCGCgGgCCCGGCCGcggGGGCGcGcGcccCccCgggGgggcgGgGCGg	?;?AGGGFGFGHGGGGGGHGGDGFEGHGHGHHHDHHFGGGFGEGFGFGFGEC	G	30	C	22
1	25254317	C	31	tctcccttcttttttctttttcttCtccctc	A?CDDG>DGDDDDCDGDDCDDCDDDE@HAEB	T	19	C	12
1	25570081	T	136	TTTTCCCCCTCTTTCCCtCtCCCTttTtCCccCtTCTttCCtTCCCtCTtttCTCCctCTTtcCcttTTCTccCCCcCctctccctcccccCtcttCTtcccctctCTcTccCTctcTcCctCTctcctttcccCc	B=?@BBEF@CGEEEFGGECEGGGEEDDEFHDDGEAGEEEGGEEEGEFGEEEEGEGGEEGEDFEGEFEEEGE;EGGGDGEECFEDEFEEEDEGFAFFFEF:DEEF<EG=ECEEFDDEECEFEBDDDFAEFDEDB?C?	C	78	T	58
1	25889632	T	48	tccCtTCcTtCttTtTCCtctttcTttTtttccccCtttttccccccc	CCEDEDDDGEDEEFEGDDEDEEDDGFFGFF>EEEEDFFFFF9FEDEDC	T	26	C	22
1	26073300	A	38	aaaaaaaaaaaaaaaaaaaaaaaaAAAAAAggggAggg	CCCCBCCCEEDDEFFE:EFEEFEEE@EEGB7D:BDA:?	A	31	G	7
1	26357656	C	248	AACaCCACACACAAACccCCAACcCACcacAAacaCCCaacAAcCCACaaaCcacaCAACAAccCCAcaACAAcCacAACCACACcaaCcCCaaACAAAcacaccaACCcaccacccAaaaAacaaccAcacaCCCaacaaCAACCaaaCacCCaAAccaccaCaCAaacccacaAAcAccaacAAcccaAcCACACACaacaAACccaaAcacAacaAaaacacccCcaAACaCCcACaaccaAcCc	B@A9BB?A@CBFDDDGGGGG?EGGGEGGDGEE:F@GGEDDGEEGEGEGD@DGGDGDGEEGEEGGGGDGDBGEEGGDGCEGGEGEFGECGHFGEDDAEEE;DHCGH;EEGGEGGEEHHDEEEDEHEEHED<EHEGEGEEHEEGEEGGEEEGEC<GEEEHHEHH;GEFEAEGGHDHEDDHEHHEEHEDHHHEEHFDFDDBFEDHEDDEHHEFDG?HDAHEDEDCHDDHHFHEDDFEFFHDF9?HEC?CC@	A	125	C	123
1	26385003	T	162	tCcCCtctTCtTtCTCTctcCCCtttttcctCCTCcTCTTCTcTCccTCCcTtcTTtCttCcCCtTTTCTTTTCCTCcCTctTCTccTCTtCTcTCTCtcCTctTctTtTTcTCtTcTtCTCCCtTCCTTCtcctTCtCTctccCCCcctcttCCtttCtCt	CACEFFAEEGEDDGCFDDEDGFGEEEEEDDEBFFHDE8EEGEDEGDDEGG=EEEEDEGFFGEGGFECEEEDEEGGDGEEED:EGEEEDFDF;AED?CFFEGDEFDDEDFDDEDFFDDDFFDFFFFD@FDDFFEEFDFFFCEFEDEFEE@@DFEFGDCACAAA	T	82	C	80
1	26511700	A	116	AAAaAGGAAGAgGgAggaAaaGAGaAGGAGGaggaGagaggAggAAAgaaggagGAggGGaGaAgaAgggaaGGAAagggaGagaAgaGGAgaaAaggaagggggaaGaagagaaa	@A=C>>BFGCHBCCFCCFHFFCHCFHCAHCCFCCFCF@FCCFCCH@HCGGCCFCCGCCCAFBFHDGHDDDGGBBGH>D>AGCGDFHDGCCGDGGGGDDCGDDDEDFGADGDD@??D	A	59	G	57
1	26515956	C	144	AccCAcCCCACCaAACCCcCaAccCCAcACcacCCccCAcCAAAcAACccAAacaCacAAccccCAcACAacACAAAAcAACcCcaCCaaAaccaCCcacaacACacccAaCcACaaaCAaaaacAcCccccCcaaccCAAacc	@AC<;FBCCGDDCHHCDDGDDHGGDEHGHCGDGDDGFDHGDHGHGCHDFGHHEGEDEGHHHFHGCHGHDDEHHDHHHHHHGDHDEBDDEEGEHGECC=CHADHGCEHHHEECHGCEEECGECEEHGHCHFFGCHCEFHB@B<EE	C	81	A	63
1	26648826	G	27	aaaGAggggaggagagagaaggagaGa	?DCCBCB@BFCCFCFCF?DF=DGDGFF	G	14	A	13
1	26671084	G	141	TTtgtGtTgggGTgTTgGttGGtTTTgtTTTGgTTtTTTTGTgGgtTttgtTGGttTTtgTTTTGttttTTttGggtTTtTTTGggtggttTGttgtTGtTTtTTTgTGTtGTtTGTTggGgtgtTTtGTTGgtGGtggtG	AAC@DACECCBEFCEFCEGGCDGCFFCGFFGACFEGFFFFEFCEDFFGG=GFEEHHFEHDEFFDEHHHG?FHG?AD=FF@FFBE>DHDDHEE>HHDHEDHEEHBEEAEDEHDEFE@EEDDDDGBHDDGDDBB??@AC<<@?	T	90	G	51
1	26673076	G	222	agaaggGggAAGAaggagagAAGAgggaGagaAaGGaaggGaaAgGAAAaaaGAgaggAGGgGgAgAagGAggggGAgaggggAGagAgGAAGGgggGgggAaagGGaaaAAGgaagGggAAGgGgAaaGAGgaGAaaGAaaGAaaGGAGaaAGggAGaaaaaagAAaaAAaGgaAAGgaaaagaggaaggaaaggagaggaggaggaAaaaaAaggaggag	BBAA<A>CBCD@GEGECFEFFHBHDDEDCEFEHECCEEFECEECECHHHAEECHFEFEBBCFCEHFHEE@>GFEFCHEEFFEEHCEEHDCHH?CGEECEFGGFCD8BFFFGGCFFEDCGFHGBFCGHFFCHCGFCHFEAHFFCBBFC?FCFFHBGFFCFFFFCEEGGFFHGFCGFHHBFEFCFCFGGFEFGEFFFGFGFGGEFFFGFBGFFEFFEF:A>B;>	A	113	G	109
1	26898142	A	140	GGAggGgggaaAAgaGggaaaaaaagaaaagagaGggaGgaagaaggaaAaggaaggggggaaaaaaaGgGggagaggggagGgggagaaggaagaaaagagggAggaggaAaggggggagagggaaagggAAaaaAgaa	B?>>>BBA=BCBDFG9FEEEFFEFFFFEFFFFFFGFFFGFFDFFFFFFFGFFFFFFFFFFBF@FFFFFGGGFGFFEFDFGGFGFGGFGGFGGGGGGGGGGGGFGFGGFGGGEGGGGGFGGGHGDFGGGGGGEEDEABB@?	G	72	A	68
1	26899687	C	72	CCAAaCCAAACCCCCACACACAAAAAACCACCACACCACACaAACACCCaAcCAACCCaAACcAAACcAACA	=>GDEDDH>HDDDDCBDDDHDHDHHHHDCFCDCCGCDGCGCFGGCG?CCFGECGGC?BFFFBDGHD@?BACC	A	37	C	35
1	27679954	G	67	AagagaaaAgagaaaagagggaagggaagaAggggaaaaagaAgggaaaggagaagaaggaaaaaaa	>FCGCFFEECFCFFFFCFCCCFFCCCFF@FECCCCFFFFGBGBDDDDGGDDGDGFDGGDDGFFGFF?	A	41	G	26
1	27685108	G	150	GAaGAAgGGGaGAgAGgGAAaAGGAaaAaGGagAaGGagaGGAAGggAgAAGGAGggaggaAGGggGGAAgGgggAAGAGAGgGAAAAAGGGAGagGAgaAgGAAAaGGaGGGGgaGaagaaAGAgGAAAGggAagAAAaagAGGGGGgg	<>D;CBCAEEFEFCEECEFFFEADEFEFDEEF@FFEEFCFEEFAECCDDEEEE@ECDGDDGFEDDDEEDFDEDCDF@EFEEEDD?FDFEDEDEDGDDAAGEDDEECGD?GDADDDFDHGDGGE>EDDEEDDDDEGDEEDGFDDCDEDC?9	G	81	A	69
1	27688633	G	143	GAAGAAGgaAagAaGgAGAgAaGgagggAAGAAAgaAAgggaAgGagaAaGAGAAgaaagaaAAGgAggAAaAGaGaaGAaAgaaaAGAGaaaagGgGGGGaggggGgGGgAGgAaAaagaGGgAGaAaaaGAAAAAgAggaa	BB:AD;AFEFFFFFEFFCEFEFEFFFFFFFDFGECFFCFFFFEGEFFEE@EF@BFGGEGGFGF:E8DFAE=GEDGCGGDDGDGGGGDEBDGEGGEDGDDDDHHG?GDGDDGEDF@GE?GGFDDGDDGDGGCCBB?BAA?@?D=	A	80	G	63
1	27942155	T	54	gtggGtTtgttGTttTtgGgTtGGGGtTTtTGttgTgTTtgGTTTTgTGTGGgG	???DBEFDFE?CFEEEEECFGDCC?<FGEFG=EFFFEFFFGBFAFFFEBF??AC	T	30	G	24
1	29581711	G	33	AGGAGAGAAAGAAAGaGAAAAGgaGAAAaAGGG	;DFFFEGFFFGFEDG>GFFDEFG@EEEEAEEFE	A	20	G	13
1	31733782	T	28	AAATAAATAAAaATAtTATTATTaTtta	:DEDEDDEDDEEEDDEEDCDDDDED>@?	A	16	T	12
1	31898162	C	198	CTTTTCCcCCTTCCTCTCCCccTTTTTcTtttTTCTctTcCCTcTTTtCtCCttCCttcCcCCtctcTCCCTCttCCTTTTCTtCCcTCCccCcTCTCCTTTtcctTTcctCCTTTcCtTCCTCCtCtTCttccccTCtcTctCcttTtTttTCcCTctCTTTccCCccccTCTctCctcTCTtTtccTtCtttTTTc	>@DCECDBDDGGDCGDGDDDBBGFGGGBCG@GHGDGBGGBDDGAGGGHDFDDHGDDEFCD?DDGCGAGCDCFD9HCDGGGGDFHDDCGDDBCDCGDGDDGGGHCCFF?BBA@CFFF<DHFDCECCGCFFCHH<@>AFCHAFCDCCDHFHFHGFCCCFCGCFFFC=CCCCCCFCFCHB=HCFBEGFDABDC@BB@AA?@	T	100	C	98
1	31898279	A	110	CCaaCCAcaaaccaCaaCAaCaaacAacccccAcAccaccaACaaCAAccacaacaccacaaaaAaCCAcccaccccaaccacAcccaacacaaacaCccaccacaacaa	A<?@=;@CACCEFECFFCHEDEFDFHFFFFFBHF>FFFFFFFDFFDHIE;>FFCFBGEB;=FBEHEDDFGGGGGGGGDCEFBDGFGG@FF:GCFB8ECDGF=F@BEEGGA	A	55	C	55
1	32136168	G	73	GGCGcCGCCGGGGCGGCGCcCcCCCCCccCGCCgCCCGcCGGGgccgggcCcgGCcgcCgGgGgCCGGcCGGg	BCEEBFEBFEEEEGEE7EFBGCGEBFFCCFE>FDAEFCC8DDDD6CDDDCFCDDECDCEDDDCDEDDD>A@>A	C	39	G	34
1	32155284	T	89	TcCTTtTCTTTCCTTCTTTcCtCCcCcTCCTTCCtttcCTccTCTtcTtTtTTCtcccCctTtccctTTttccttCttTtcCCTtctTc	ADEEEEFEFFFCFCGFGFFDFEFGDFDFFG=FFFFEFEFFDEFA;FEFFFEEFGEEE@EEFEEEEEFEEF=EEFFFFFEF7FFC?=?CB	T	49	C	40
1	33741587	C	28	cTtTTCTCTcCCCTTCTTTTCcTCTCTT	BFHGFDFGE?GGFFFFEFFFFBFDFED?	T	16	C	12
1	33778063	G	25	aGAAGAAaggAAaagGAAGaAgAga	FHEEHEEFCCEEGGDFDCGD>?CAB	A	16	G	9
1	34076550	T	29	CCTCTCCTTTcTTCTTcCTCTTTtTTCTT	GFFFFFGFFFFEEEBEGFEBEEEFDDE??	T	18	C	11
1	35259946	G	236	GGGGAgagGGAggGaAGgaAAGgGaGGAAgGAGGGgGGAAAGAGGgaGGGGAGAgGGGAGaAGGaaGgaGGggaaGGAAAGGAaGGGGAaAggGgggAGGgagaAgGAAAaGAagAaAaaggGGGgagGggAGGAagAGAGggAgggGAAggGAaAggAAAGAgAGGGgaGGaGgGAggGGgaGaGAAAGgagaaaGAGAGGGGAAgaAAGAagaggggGAAAAGgagGGagAAGg	=A<A:BDGGFDEFAEDHFEEDHFHFHFCEFHEFIDFGIEEEGECGDFGBHHAGDFHHHE@ECGHFFHFF@HF>EG7HEBEHH;DGHHGEGDGGHGGGEHHGGGFEGH9E6GH?GGEDE=CFGGHGGGGFAGCGDCGGDGDGGGDGGGG9DGGGCGAGGDDDGDGDFFG>GBGCGGGDGGGGGGGFG?CDFGEGGGGGCFCFFFFD5DGDCFBFFEGFFFCEA?BFCCCD?BB@<CD	G	139	A	97
1	36381165	G	47	aAgggagagggggggaaagggagagagagGagaggaagggaaggaag	CCDFEDECFFFFFFFDDDFEFAFDFDFCFGEGCGGEBGGEEDGGDD:	G	28	A	19
1	36563158	C	27	CAACCAACCaCACACCaAAAACAACCA	DHDAD@HDDBDHCGCCFGGGGCFFBCB	A	15	C	12
1	36602943	C	30	TttctctcttttTTttttccttTctttctc	D@@AGBGBGGGGGGG=GGCCHHDBHDHCHC	T	22	C	8
1	36809698	A	143	CaaCAaaaaaaAaCACaaaCaCaCaCCaCCaaaaCaCaaCCCaCaCCaCCaCaCaCaaaCaCaaaCaCaaaCCaCaCCaaCCaCaaCaaaaCaCCCaCCCaCCaCaCaCCCaaaaCaCCaaaAaaaAAaAAaaAAaAAaaAaA	;AB=<CECADBCEDCDEEE@DDDC>:9D>7EAEE7EDED9:DEBFD9FCDDCDB;>FE<8ECFFEDED;E=DDA=BCC:E:CDBAD>AFC=7B8CAFCC<<A?ECFCB@CC=B=ECD9:BFBG>>DFG=DEAACDABB;;@??	A	89	C	54
1	36809705	G	129	ggCCCCgggggCggggCggggggggCgCgggggggggggggggggCggggggggggggggggCCggggCggggggggggCGggggGGgGGgggGGgGGggGggGggggggGGgGGggGGGGGggGGGGG	C@?CC5CCCCCD?CCCDCCCCCCCCDC7CCCDDCC7DDDDDDDD;=CADDDDDBDDDBDDDD@=9DDDCDAD9DE?DDB8BDDDDB:CBBDDDBBDABDDACCADDCCCC@?A>?>>?=>=<<<AAC?C	G	116	C	13
1	37335458	A	27	agaGaaaGaagAgGgaagaaaagagag	CCDCEEECEEEHF=G;FEFEAF?DD@G	A	16	G	11
1	38272660	G	108	AGAggAGAaagGgAGgggaaGGAGgAaGGAAaaaAAGgGaAaAAggggGAgAGGGgAgGgggAAaaggAAGagaaggGGGagAaGaagGaAGAaAAggagGGGAaaAG	B<ECCDGEFFCGCFGCCCFFFHFGCFFGGFDGFFFBGCGFFGFFDDDDGFDFFGFD6DFDDDEDGGBDEEFHEEFDEFFFGEEGFGGDFGEFEGEEDDGEFFFEGDBC	G	56	A	52
1	38450367	A	163	AgGaAAgAgGAgGaGAaAAAAaaAggagaAaGaAaaAgAAAaaAaAAagGGGagAagAAgAGgaaaagAGaAGagagaAGGAagaggGAAgaaggGaagGGGGAgGagGaGGggAaaaagaAAAgGAAgggAAAaaagGgGgaaaaGGaaagAGAagaaggaA	EA<ABDDFFCHCCD=HEHFHHEEHEEEFE@BCEHEEIFHIHEBHEHHEFCCCDFHDEHHFHCGBBEFFHCFHC?GEFE@BCEFFFEF?HHFFFFGCEF9CCCCHGBBGCDBBFGGFFDFEFGGGGBGGFFEGGG<FFFBGAFEEFEBBFFFFGBGFFDD@>@C	A	95	G	68
1	39815143	T	119	ATAAATTAATATaTTTATTaAtAtTTATTATtTtTtaATTataataaaTATtATTTTtAtaTaAAAAAatATATttTaTatTATAaTTAAATatTAatTAAattttTTTaTaAtaattt	@??=CCC=DCEEDEEEEEDDADEBEEEEEEDEEEEEEEEEEEDEEEEDECEEEEEEEEEEEEEDDDDDEEDDDDEEDEDEADDDCEDADDDDEDDD<EDDDEEEEEDD:ECECCE:BBB	T	65	A	54
1	39889677	G	33	AGAAAgGAaAgGAgGaAgGGGAGAGGAGAgGaG	@@FFEFGFFFFGEFGFEFFEFEFDFFEFB@C@B	G	18	A	15
1	39929240	T	109	CCCCTTTCTCCTTTTCCTTCCtCTTcCCTCTTTTTctTTtTCCCCttTCTCTCTtTcTTTTTTCCCTcTTcCCTcCCTctctCCCTtTTCTtCcTtcctcTCCTCttcT	GCGEEBCEEGGEEEEFGEDGFDGEEGFGEGEEEEEGFBEFEGGGGFFDFDEDDCFEGEDCDDDFFDCGDCGCFDFFFCGFGEFF;D9DDFBFFGDBEG@FEFFC@A??A	T	59	C	50
1	42506381	T	25	CcCTTtCTCTTccctccTCTCTCCC	?FGG8EG@GGFGGGFFGFFFCEC?C	C	15	T	10
1	42846786	G	31	gcccccCgggCCcccCgCggcgcgccgccgc	C?C:>BDBCCDDBBBDDCD:CDCDBCDCCDC	C	20	G	11
1	42915727	C	125	CCCcGGGccgcccCgCCcCCggcGcGGCcCgGCggCGcGggCcgccGccgCcgGCCCccCCCCGCcGccGgCGcCcGgCgCccgCGCcGggCGCGGcCgcccCcggcCCCggccgcgcccCGCcc	AA<ECCCDDEDDDDEDDDDDEFDCDCCEDDD>DEEDCDCE?DEE>EBEEFDEFCDDDEEDDDDCDECEEAFDCDBEBGDECEEFCBCDBGFCB@BBECGEEECEGFDCCCGFDEFEGEEEA=A@B	C	78	G	47
1	42962800	A	101	TTTTATTtTatTttaATAtATTaaaaTatAttAtaAAtAaAtTTTTtTaAtAtTTaTtaatAtTAattTTtAtTtTttaaaTaAAtTttTttAAattatTa	DA?GFGGDFDDEDDDEEFDFGGDDDDFDDFDDFDDFFDFEFEGFGGEFEDEFEGFEGEDDD>DGFDEEGFDE=EAEF9EEEFEEEEEECEECDDBB?=;CB	T	61	A	40
1	43213797	A	32	AGGGAAAGAGGGGGAAGAAGAGAAGGAGAGGA	EHHGCEEHEHHGGGDDGDDGDGDDGGCGDE;<	G	17	A	15
1	43263489	T	77	CCCTTTCTCTTTTCTTTTcTTTTTCCCtcCTTtCCTTTCTCTTtCTtCtTCttCCcCttCTTTTcttcCTcCcCTtc	FGBEEF:EGEEEEGEDDE<=EEEEGGGEBFECFGFDDEGEEDDFFDFFEAFFFCFGFFFFDDDDGFF9EBFFDBA<C	T	45	C	32
1	43638457	T	79	TaTTTTATTAATTAaaATTATAtAaatTaAATTTTttAaTAatAAAtaaAATTTTTTTTTATAAAAtTtAaatAAAaAt	:EE>AFEEDEAEBEFFEEDEEBFEGEFEGEEEEDEFFDGDDGFEDDFGGDDAD@DDBDDDDDDDCDFDFCGGFABBC?C	A	40	T	39
1	43774495	G	25	GCCGGCGCGCGCGGCGCGgCCCGCc	HF@HH9HGHGHG@FFFAFDFDEG@@	C	13	G	12
1	44086080	T	100	CCTCCCTTcCTTcTTCTCCcTtCCCCCCCCTTCTTCTtCTTTCCCTtTttCtcccTCCtCcTtccttCTTtcTTTcCTCctCCTTcCCCcTctTTTCTCT	>=GDCDGGGDGFGGFDGDBGGDDDDDDC@@GGDGFDG9DCGFDDDFEGCDDEHHHGCCDCHFDHHEDCDFEGFFFHC@?HCCCFEABBCHEGDFDD=DAA	C	52	T	48
1	44386615	A	60	agaaAaaaaggggaaAagGgaaaGggaggaaggggggggaAaggAaagggagaaAAgaGG	AAGFDFFDFFDFF7EDFFGFFFFHFCFCFFFEFFGFFCAEABGD=EGDGEGCFFDD>>GF	A	30	G	30
1	44426948	G	148	AGaaaaaagggagggaAaGaaaaggGgGaGGAgaaaaGgAGgGggaggaaAAggaagaaGgaGaGggggGGGgAggAgagggGAaaagaagAgAAgaaagggAaggggagAggggagggaaaaaagaagaaagaagggaaaaaggagg	E>CD<CBDABBECCDGFEBFEFECB@BCFCCGCFFFFCCEBCCCCFCCFFHHCCFCCFFDCF?FCCCCCCCCCHCCHCFDCCCHFGFDGFCHCHHDGGGDDAHGDDDDGDHDDDDGADDGFGGGGDGGDGGGDGGDDDGGGGGD>C<=	G	76	A	72
1	44432500	C	82	cGgggccgcCccgggCgCggCCcgccGgCcGgGCcggCgccCCccccgggcccgccgccccCgggggcggcccCgcggGccc	AAAAB@DDDBDDF7EGEGDFGFDEDDHEGDGDHBD?GGEDDGCDDEEFFFEEEFEEGEDEDFGFGFGEEEEEDFGEGGFD@=	C	46	G	36
1	44442521	A	32	aacaaaAaacAcaacaCaaacccCccaaacAc	CDFDCDHDDGHHDDGCDEEEHHHDGHEBFHFG	A	19	C	13
1	44460857	C	40	CtCcTcCTTCCTTCCCTCTcTcCTTtcTTccttttTtcCC	FDGDEDGEEGGB=GDGEGDD@DFDDEEDCEEEF@ECB?BB	C	20	T	20
1	45241587	G	96	GGgAAgGAAGGAAAGGGAgAAGGGAAGGaGAGGAGGGgaAGAgGGAGAGGAGGGGgAgaaaggGAAAAagAGAGAAaGaAAaAGGgAaGAAGgGag	B@B?FFCFFEEFFDEDEFFFF;DD@DEECEAEEEEEEGEFEFEDEFCFEC:DEEDGDGEEEGGDEEEEEHEDDDEDEDCEEEEDDFEEDDDBB>BD	G	51	A	45
1	45504858	G	31	GgtggtgtgtggggtgttgggtgggTggttt	E?CFEEFEEDFFFFEFEEEGFEGFFFF:B@<	G	19	T	12
1	46080947	A	160	CcccAcacaaAcaaAaCACCccAAcaaCaAacAcCACACccAcACAaaccCcccaACccaaCacacaaaAacaccacaaaaCAAcCaaAAacaaAaCAAAcAcAacaaaaccacAaaaaAaAccacaaAAaaAAAaAccaAAcaCAcAAaAAaAAaAAAc	DAC??<C>CDA>EEBEFDEECCEFADFEFFF?FBGFGFFBBFBFEFFFBBFBBBEFGBBFEFFBFBFFFFDBFBCFBFF@FGFEAFGFEFFCGGFGFFEDCFCFG?FGGGCCFCEGGGGEGEBCFCGGEEGGEDEGEC<CEECGFECEEGEEGDEF??B>	A	101	C	59
1	46473902	A	45	AAATAATATAaaATaATaAttATTaATAAaAAAttAaTTAtAaAa	A?EDFFF?FFFDEFG<BGDDFFDEGEAFDGEEE6FEGDDEBBB=C	A	30	T	15
1	46487552	G	135	AAAAAGaGGAGGAAAAGgGgGAAAGAAAAGAGGGGGGGAggAAgGGAAAgaAGGgGAAGAAAgGaGGaagGGgGAGGAaAgAAAAgaAGaaGGagGgaGGAgAGAGgaGGAAGaagaGGAGgaGAaAGGAAAagg	?EEEEGFGFEHHDEEFIDGFGE<EHEEEEGD>HHHHHHEFGEEGHHEEEGEEHHCGEEGDDDGGGGGGGGFGGGDGGDGDGDDDDGEDGGGGGGGGGGGGDGDFCFGEGFCBGGFDDEEACB?BA@CCAC??DDD	G	68	A	67
1	46493460	T	125	TGGTGGTTTTTGTGGGTGTgGGTTTTTtgGGGtGTGtTGTtgGTTGGTgTgGTtttgtggGgtGTGGtgGTTtGTgtGgTTTTgTGTTTTtggGtggTtgGgttTgTtttttGgGTttTttTGgt	BACBEGEEEEEHDHHHEHFCHIDEEEEGCHGGEHEHGEHDFDHEEHHEDEDH9HHGDHDCHCFHEGGFDGECHHDDHGDDDDDDDGDDDDBDDFHDC@HDFDHHDDCHAHHHFCHDFGBDEA@AC	T	69	G	56
1	46659363	T	116	TTctcTTCtccTctTtCCtTTCtTTcCCttCTcCTcttCTtcTTCtccCTcTcTTCCCCcTTtTtTcttCTctttCcTtcTcTCttTtcTTTcCctcCcCttTCtTctCCtTCttt	CACAC?ABDFEFFEFEFDEFEGEFGF5GEDGFFFFFEEFFEFFFGFFGFFGFGFEFFFFGFEFBFEGEFGFGFEFEFFFGEFEGFFBGHDEE@EGFGEGFFFEEFEGEFEDCB?>A	T	66	C	50
1	46976837	C	116	TTTCCCTtCCtccTtTttCtTtcTTCCTCCccttcttttCTCtCTTCcTTTtCtctCCCTTtTTtcTccCCCtCcccCTtcttTTtcttttctctTCtcTtcCcccttcttctCct	CD?>>BGFDDGBBGGGGEDGHGB;GDDGDABBEGBGGGGDGDGDGGCCGGGCD;CHD7CFGH<GHCGCCDDDHDBCCDFHCH;GGHCGHHHCHCHECFCFBCCBCCGHCHH=GB=E	T	64	C	52
1	47131248	G	57	gGGAGAaaaAGGgGaAGGAaAAAGggGgaGGaGGaGGGGAggaGGAaaGGAggGGGg	CBCFEFEEEFEDEECFEDFFFF<EFFC9FEEFD@FDDD9EGEFDDEF>DDF@?B?@E	G	35	A	22
1	47737930	C	52	CttctttCCTtCtcttcCccTcTCCCcctTctcctcttCcccctcttcctct	DAAECCDGG>CGCGDDGGGGGGGGGFHHDGHEHHEHEDGHHHHEHEDHHEGC	C	29	T	23
1	50572096	C	125	aAaaaaCCacCcCaCCaAacCaCCcCCaccaaacaCaacacACAacaaccAcAacccaaAAaACCcccccaaacaCaaaCcAaCaaCcaCCCCcacacAAacacccacacCcCccacCccaacca	?C>@@@==CE@EBCBDDGCG;CDDGD@DGGDDDGCDDDFDGFEHDGCDFGGGGDGGHDDHBDCADGHGGGEEEHDCEDEDHHEDEEDHEADD=HDHEHGFEGEHCHEHEHCFCHHEG?CB@=ECB	C	67	A	58
1	51767923	G	66	ggCCCggCCgCggCggCgggCgggggggggggggggggggggggggggggGGggGgGGGgGGgGGG	@=9@:GF?8E8FEDEFDFFBDEFGGGFEAFFFGGGFFFFFG6GGFFGFGFBAGF:FB??D?@@CC?	G	57	C	9
1	51826921	T	151	CCTTTCTtCtcTTcTTcccttTCCctcCCtccTccCTcctTtTCctccctctTcCTcctCCctCCtCcCTctcttcCTTttCtcTCccCtTTCtTcCtccttccTtcttCctTccccttccTctcTtTTcCTCcctccTTcCttctcCccc	@=@A:BABCBFEEGGFGFFCDGG@GDFGGDGGGGGGGGGDG@GGGDGGGDGDFGGGGGDGGGDGGDGGGFGEHEDGGGGEEDEHGGGHGEGGGEGHGDHGCDGHGCGEEFHEGHHHFEEHHFHCGCEFFHFFFHHEHHFFGEECGDDBBCC	C	83	T	68
1	52082930	G	56	agggggagGaaaagagaagaGgaggaagGaAggGggaaaaggaagaaaagggggaa	A??<BBGCEEFF?CFCD5CFECFCCFFCFFDCCECDGEFGDDGFDGGGCCEDDDG?	G	29	A	27
1	53364976	A	71	ggAaagaAGGGgggaGagAGaggagGagaGgggggggaaagggggaaaaaggagggagggaGgAggaggga	?@>>9?B@AHHFDFDHDFDHDFFDFHDFCDFCFFFFGDDEEFFGAE>EEEGGEGGGEGEGEGGDEFEGG=D	G	45	A	26
1	53453683	C	27	CTCTTtCCCCcctCcTCTCCCtcTTTT	GFGGGFGGGGGGFFGFFFFFFFGCCBA	C	15	T	12
1	53558521	C	47	ccctttcccTctcctcccttcttCtctcccttccttTTcttccCctc	?>A=BBBCDGCDDDEDDD?EDED9EDECDDE=DCFBCGDFFFECAFE	C	26	T	21
1	53679096	T	173	CttcctctCcctctcCcTTcTCCctCCccCTtcTCtttTCttCcccttctctCtCtcctTttccttTccCcctctttctcctcCcTCtcccttcTTctcctcccCtccTttccccttttccccttcTtttctctcccCctccTttttctcTtctccCcctcccCtCcctctCC	D?CAAC??<<>C?D?CADB>EAGAGGGAAGFGBDFGGGEGGGGBABGGBGBGGGGGBBGEGGBBGGDBBG?BGBHGGBGBBGBGBEGGB;BGGAEECHCAFACCGHBCEHHCC>CHHHHCCCCHHCCHHE>CBHC>CGCGCCDFHHHC5CDHCHCCFCCECCCFHFCCHCGBA	C	97	T	76
1	53683921	C	65	gggGCcCCCCgcgcCGgcCcccccGcCGCggccgGGgcGccgGcgGcGcgCgcgCcCggcccCcg	AC@EEAFGGGCBCBGHCBGABBBAHBGCFCCBBCHHCBHBCDHCDHCHCCFDCDFB@BECCCFB?	C	37	G	28
1	53684525	C	94	GCCGCGCCGGCCCCCCGGGGgGcGGcgCGGGGCGGCCGGCCCGcGgGcCcCgcCGcCcGggGgGgcgCgcGcgccCgGGgggCgGCcgcCCcgc	=EDCEEFGECFFFFGFEEEECEBDECDGEEEEGEEFEAEGGEECDDECECEDCCD=DCDDDDDDDCDDD@DCCCCEDCDDC@BCEC??>BA@A@	G	49	C	45
1	54706733	A	120	AagGaGGGGGAAgGGggAaAgaagaGaaggggagGGaAGaAaagagaGggagaggAgggaaGGgaggggaAggaagggaggagagAggAgaaAgaagaGgGggagggaaaggaaagagGa	CA?<D>>>:;EFCBBBCHECCCFBFCFFCCCCFCCCFHBFHFFCFCFCCCFC@CCHCCCFDCBCFCBCCGGBDFFDDDGDDGBGDHDDADFGGCGGDG?DBBDGADDGEGDCGGCDB=CD	G	68	A	52
1	55058160	G	148	TTTTGGTTGGGGtTTGGTGtTTTTtggGGTGGttGtTTTGTTgtTTGGTTttTGGttTTggGgTgTgggTGgTGGtTGTTTGGGtTTGGTTTGGTTGgGtGGGGTggTtGGTGTTTtTTgtTGttGTGgTgtttttGgtGGGGgGggg	=ACEDECFE9EDEEFDDCEEFF@FE?FEEEBEEEEEEF?BCCGFEFDDFFFFEEECEBFGEEG:FEBFFEDGFDBDEDEEBDDDCEEDABEDDCEEDFDADDDDEF@EF=DEDEE?FEEGFED@EDEDFE@E>DFBCB@B9@>>@>?B	T	77	G	71
1	55165942	G	133	AgAagaaAaaGaaAAagggaaAAaaagaaGAaGaaaagAGaaaaAaGgagAAaAgAaAggagggggGgggaGaaAGAaaaaGaAaAGAGaaGGaagagGAgaaagggAAgAgGaaaaggaGaAAaaAGaAgaG	??@DBEF9EFEFEFFFCCCFFFFFFFCFFEF=EF?FFCDEFFFFF=ECFCF@FFC>FFCDGBDDDDECDDGEGGFEFGGG8EFFGFEBE@GDDGG7CDDEDGGFDDDEEBEDDGGGGDDGDGE=GGEDFA>B?	A	84	G	49
1	55518198	C	29	ccAccCccaCaCAcACcccAcCaCcaCAA	GGEG?DGGDDDDH@HDGHHGHCECGECBC	C	19	A	10
1	57221553	G	45	GtTTGTGGtGTgTggggTTttTGGgTTtTGGtGTGGGTTgTGggg	HGEEHEHHGGEEEGDEGEEHGEHFGDEBDGFGGBGGGDDEEE?DA	G	24	T	21
1	57221554	A	45	AgGGAGAAgAGaGaaaGGggGAAaGGgGAAgAGAAAGGaGaaGAg	FFHGFHEGFFHDHDEEHHGG@FFDHGEGEEGEGEEEGFEG@=AAD	G	23	A	22
1	57409459	C	151	AAaACcCCAAcCAaCaaaaacaacaCCCcCcACAaaaaaCcCCCcaACcCAcCCaAcCCcCaCACCcCCcACAaccccAcccACaAAccCcccccCacCCaaaCcAccACcccccaaaaccaccAaacccaccaacccCcaaaccacaacc	>?@=ADBB?=FGEDGDCDDDGDDGDGGGGGGEG>DDDDCGGGGGGDEDG?EGFGDEGGGGGCGEGGHGGHEGEEGGGGEHHHEGEDAHHGHHHHHGEHGGDEDGHDHHDEGHCHHEEEECHEHHDEEHIHEBHDEHHGFHEEEHFDHE?AC	C	90	A	61
1	57602334	G	195	gGaAGGgggagaagaagGAAAAGgaagGGAaaAGgGAagGGAAGGAAAAAgGGAaGAGggaagaAGGAgAGAagGAAAAaagggaaGAAAGgGgaGGgAaaAAGGAAgGAggggAGGGGgaggGaAgaAaGGGGaGGAgggagGggGgaaggAAAGaaggagGgAaagaGGaaggaaAaagaaaggAGgagaAgg	?AC@<BBCDGCEFCFFCHEEEEHCFFCHHDFFEHCHCFCHHCEHHEEEEFCGHEEHDGCCFFCCEHGECEHEGCHEEBDFFCDDGFGEEEHDHCGHHGDFGEDGHEEDHEDDDDEHGHHCGDDHGEDGDFGGHHGGGDDDDGDGDCGC6CEDDDDFGGDCGDFDDGFCFGGFBD@GGD;GCFFFCAAE=B=?CAA	G	102	A	93
1	60466814	T	37	CttctTCTtttCTTtTCttccCcCCtTTCTCTccCct	AEEDEEE<DDE;9EE9GFE@ECDGDFADDDFDDEFDF	T	20	C	17
1	61743337	G	25	tttggtgttgtgggttgtggggtgt	?FGCBGCGF@G8CCDGCECCCDHDC	G	13	T	12
1	62365217	C	29	CTCCTCTCCTCcTCCTCcTTCTCcCCTTC	8H@DFDGDDGDGF8CFCGFFCECGCCEFB	C	18	T	11
1	62728918	G	134	GgAagAGGGGGgGAgGggAagaGGGAAgggGAGaAGAAAaAAAGAgaaAaAAggAAggagagggaGAGAgGagggGAGggAagGAagAAaAGAAGGGAagaAaAGgGaggaGaAAAAAGgaagGGGagGGAgaa	<@DGCHCCCCCC@HCCCCHFCFCCCHGCCDCHCGHCHEHGHHHCDDGAHGHHCDGHDDGDGCDDGCCCH@CGDDDBGBDDGCDBGH=GGDGBGGBBBGGD?FGGBDBGEDGBGGFGFF@CFD@?@>B>:<B<;D	G	69	A	65
1	65614260	C	42	cttTtTCCtTtctCcTCcCCtTTttTttccttcccttccttC	A?CFHGCCGDGBGDBGDBEEGGBGEFHGCC=D?CCHHCC@H@	T	24	C	18
1	67000162	T	48	gtttGtgtggtTggttggttggggttttgtgttggtggtttGttgttt	?CBCCGCECCGGCCAGCCGGCCCCGGGHDHDHFDDHDDHHHFHHBEFH	T	27	G	21
1	67145440	G	168	GgagaagaagAaAAagGAgagagagAagGggGaAGaaGaGggAAggGgGGGgAaaggaAAgagagGAAGaggAgggAAaaaGgAGgaAAggAGGGaggGAaaAaaGggGAaGaAAgAaaaGaaggagGgaAaggGaGaaagaAaGagaaAGGgagAGaaAagaggAGg	7?AB>>CCBCEDAGEECHEDFEDEFHEEAFECEHCEECECFFDCFEBECCC?HEEEFEHHFEFEFCHHCEEEHEFFHHEFFBGGCGFGHEGHCCCEFGC<FFDFFBGFAGFBFFHGHFFFBFFFFFG;GEGEEBBEBFFFFFGFBFGFFGBBGEFFBFCHCF9D@BCA	A	86	G	82
1	67861520	C	134	CCCAAaccCCCCcCAAcCAAAaACCAcCCACACAACCAACcCaACCCAcAcCCaACAACACCAaAcAcacCCAaaCaCCccCAACCCcaccAccCCCaCCCCAaaCAcaCCaCcaCccAccccaAacCacaAcc	AA>ACA<<BC:CBDAH@DHGFFHDDHBDDHDHDHGDDEHDCDGHD>DHCHADDGCDFGDECCGFHCGCGCCCGCF@GBBDCCGGCCCCGBCGCBCCCECCCCGGGCGCGCBGBAFB@CFAACAFD@:@A<B@@@	C	80	A	54
1	68151685	C	94	CCTCTTCTcTTCCTcTCTCCTCtcTCcCTCcCTCCCCcCTTTTCTTtCTtCTtTCtCtcTTTCCcttCCcCTTTcTTTTCttctcTcCCccTCt	>DFBGGDGDEH7DDDGDGDDGDEEGDEDGCECDDDDDE@EGGEDFFFCFECFCFCE?FFFFFCC:F6CCECFFFBCFFECEFDEEEECCC@C=@	C	48	T	46
1	68173264	C	110	tcCCCCTcCTTTCCCCTCCctCTtcctCCCTccCcTTTTTCCTCTTctcCtttcCctcTTttcCTtccccTtTTTTttTCttTCCtCTCcccTTcTccCTCcctcTcCTt	?=?ACEEBFFEEGGGGEGABGGFGBBGGBDCBBGBEEEEEGEEGEDCGCDHHHCGC=?EEHHBFDHCCABDHDDDDHHC=FIDFFHFDFCCADDCCCCFDDCBG?C<@>C	C	58	T	52
1	68943665	T	31	GGggTgTTGtGttTGGTGGttGtttgttggg	CGEFGDEGGEGEEFGGFGGFFFFFFFFFGFF	G	16	T	15
1	70781108	A	26	GGAGAGGAGAGAGGgAAgAAagAGAa	GGFGEFGFGFGFFFGBEGE7EGEECD	A	13	G	13
1	74670172	A	83	AGaAAaaAggAggGgaAGaaGAAAAAgaGgAAAagaaagaaGGAggagAggaAAaAAaaGAaaagaaGGgaAaAaaGaAaGgg	:@EFDECFEFFFFGEEFGEDGEFEFEFEGFFEEEDFFFGFFGFFGGFFFFFFFFFEEFEFEFCBFGFFFGEEFEFFFFEDDBC	A	53	G	30
1	75072264	G	56	GGGTTTgTGTTTGTTTTTGTGTGGGGTGGTGTTTTTGGGTGGTGTTGGGtTGGtGt	GGGGFGFGHHFEGGGGGEGGGG:GFFFGFEFGFFFFFFFFFFFFFFFFAEFCFAB=	T	29	G	27
1	75602384	G	34	tgttttttggggGtttgggtttgggtggtggtgt	?@>@@@ADFEFFEDDDFFFDDDA@GDAG;EG7CD	G	17	T	17
1	76198785	G	247	GgaaaGGAGGGAaGaAAAAAGaagAAaagaAAGggGGGgGAAGGAAGGgaagAgAGAagGGaggGGGGAAGGAAaGAAGAAAAaagagAAAagGaGAGgAGAGGaaAAAaGGgaagaggaAAAggaGaGAGgGAAaGGGAGagaaagAgagaGGagaaaaGGaAgggggaAaGAgGgaGggagAgAgaggaAaaaagaggaAggAGgagaggGgggaggggagAagggagGgGagagGagggagAGa	A>?CC;=>5;<DDAGGFFFHBEBFHEFF6FHHCFDCCCFCHHCAHHCCFFEFGFHCCFFCCFFFAA<AIHC@HGCCHHCHCHHFFFFFFHGFFCGCBCGGCHCCEEHHHGCCGG<FEGGGHHHGGGCGC;CGCHHFCCCHCFGGEGFHGGGFCBGGGFGGCCGHGGGGGFGGBGGBGGBGGF:GGGGGGHFGGGGGGGGGGGGGGBEGGGGGBGGGEGGGGGGGFGGFGEAGBGFFFACCABAAA?A	G	127	A	120
1	76209935	T	37	CCcCctcCcctctttttcTCcTccccttcTTcttctc	D?BG7G?BBBGBGGGDGB<GBGBCCBDHCFF=HHCGC	C	21	T	16
1	76227022	A	70	aaaagGggGgAGgGAgaaAgGAgagaaAaaaagaAagaGaggggggAaaaaaagaaagagaagaagaagg	CCCDAABCHCEHCHCCFDECHECF<FCEFFFFCFEGDGEGDDDCDDEGGGFGGDGGGDGCGGDGGDEGD?	A	40	G	30
1	77042405	G	49	AAGAAGAGGGGAGAAGAAGGGAAGAGGAAAGAGAGAAGGGGGGGGGGAA	EEGEDFDHGGGBGEEHBDGGGDDGDGGDDDGDGDGBDFFGGFDCCCA??	G	27	A	22
1	79355596	A	25	GAAgGGgGaggaAggagAAagggaa	DDFFGEFGFFFFFFFGFFFGGGDE@	G	14	A	11
1	82302600	T	31	CCTCTCTTTTTCTctttCcTtTctttCtTtc	CGFGEGECEEDEEGFEFFGDFAGFFFFEC<8	T	20	C	11
1	84864256	G	162	GCCGCCGccGCCgCgCCGGGccCgcgCCGCCgGGGggGgGCggCCGCCGgcGGCGGcgccgggcgCgccccGCggCgcccgGGCggggGGGccggcCGGCgCGccgGCcgCccccgCgccgCGgcgggGcGcGccggGCGcccGCccGcgGgcGCgcgGcGc	BB@D;CCFGFGAEGDGGGGGGGGFGFGGDCGFGGEFFGFFGFFHGGGGGFGGGG?GHFGGFFFGFGFFGFGGEGEGGHHHGFGGEGB>FFGGHGEHG>GGFGCHHGFGHEEHHGHG@GHGGFEGHEG>FGEFFGHEAFFBGFHFFHHFGGFFHEEGFGEDAE	G	84	C	78
1	86173298	C	127	TCCCCCCTCTTTCTTTTTcCCccTCTCTTTCCCCCCcCTCtCCCCcTcCCTCTTcCTTTCTTttTCCtcTtCCccTccccTTCTtccTCtCTcCcTTTCTcTCtTcCTcTCTTTTtCttCCTCCccc	BDGFFGBE?EEFHEFFEEDEGDDDGEGEEEEFGFGGEGEGEFFGGEDEGGCGEDDGEEEG>EFEEGFFECFFFEECEDEEDDFD@EEDFFEDEFEDDDFCCDFFDEFDEDFCCCDFEEBC>BBA@=B	C	70	T	57
1	86818572	T	55	tCCTtCTcCcctTCCTTTTTTTTtcTCCTcTCcCtcCCtccttCcTttCCtttcc	EGGCEFFFEFFBEFGFFEEFEFFFGFFGEFFFGGFGECFGGEFFGEBFFDEA@B?	T	28	C	27
1	86920904	A	185	gGAGGGGGAAgAGGGAgAAAAAgAggAGGAAGGaAAAAagAAAAAGGGAGAAaAGGAagGGGGGAAaGGGaAAGGGGAgggagAAGagAGgaGAaAAAGAGAAagGGgAGGGAGaGGAAAGAggAGaagAAGgGAGAaaAaGGAgaGGGaaAaAaAGAAAAaaggGAAaaAgAaaagGGaGgaGA	B@@AEGFGFFFFGGCEF@FFFGFFFFFGGFEGDDFFFFDFFFEEFGDAEBFFDFGGFEGG7FGGFFEGFAEFFEGGGFFEG9GFFCEGEGGE>FEFFEGDGEEEFFFGEFFFE@EGFEEEFEGEBFEEGEEFCFEFEEDEFFFEGDFFFEEEEEDEFEEEEEEGGFEEEBDGDEDDFDC@CA9CA	A	99	G	86
1	89479074	C	70	tcTCtctCctccctcTtCTCCTCcctTtcccCcTttcTccctttCtttCTtCtttctcccCcCcccttcc	A?>?D?FGAGB>BGBEGECAG<GBBGFGBABE@EGGCBBCCHFHGHHFFDHFHHHCHCCCFCFCBBGF<@	C	39	T	31
1	91980447	A	270	GAgaAGAGAAGAAAGGGGGGaGAGGAAGAAAGaGaGGAAGGAGGGGAgaGGAAggAaGAGGAAAGGGGGAaAaggGAGaGAAAgAAGGaGgAgagAGAGAGgGaGgGAGgaggGGGAAGgaGGGAaaaGAaggaGGGAAAAaaGGAgAgGAGGAgagaGgagaaaggggGGAGAAaagGaaaGAGgaGAAGgagAGGGgAAGgAAGAgggaggGAggggAAGGaggaaagGAagaGAAaGagggAgaGAggagaAGaAGgGGGGGGGGGt	@EB@C=B?CH;HHH@CCCBCDCHCCCHCHHFCDCCCCGHC6HCCC9DFDACHHFFHDCHCCHHC>CBCCHCHDGFCHCECHGHGGGCCECGHGEGHCHBHCGCECFCHCDEGGCCCHHCGEBBBFEDEBFEGGEACBFGHGEECBGGGEBG<B@GEGEBGEGEEEGGGGBBGBGGE>E8EEEBGBHDBGGBGEGGBBBGGGBEGGBGBAGEEGBG?FGGGGABE?GEE>GBGEG@AGGEAEGEFGEECGEDCE>D@BC>B>>>?<<AC@B	G	150	A	119
1	94341267	A	123	aAGGaAAaGAGaAAAAGGAAgGGgAGAGGaGAgGgGGAgAaaGGaGagAAGgGGggAGgaAGAgAAAgAaAAaagagGagggAAGgaAAgaGGaagaaGAgaaGAGaaggaggaaAgagaAAa	B@ACDEEDHEGDEEEDDFEEFHDFEHDHGCHEFHGEHEGBEEHBEGDGEEHGCHGGEHGE6HEGEEDGDEEDEEGEGGEGGFDDGGE9DGEGGEDGEEGDGEDDDGEEGFEGFDDDF@?>A?B	A	66	G	57
1	103548497	A	93	CAACaAcCAAccCaCaCaaACAAccaCcccAacccAccaACaacCaAccaCccCccCcaaccacCaAAccacCaCccacaCAAaaCCaCaacc	DBA?CACC8EEEFEGFGFFADFFFFFGFFFFFFFFEFFEFGFFFEFFFFEGFFGGFEGFGGGGGFGFFGGGAGFECFFGGDEEFGFFGFGG=:	C	52	A	41
1	104615875	A	33	GAggGGaaGAAAAaGAgaGAaAggggGAGgaAa	=GDDCCFF<EHHHFCCDDBGG>DBDDBCADFCC	A	17	G	16
1	108185309	G	78	aAgaAGgGGAAGAGGgAAAAGGGgAGAGaGAGggAAgaaGgGaGGGAAGaaggagagAgAaGagagAggGAGaGaggg	EFCFFECADFFEFEDCFFFEEEDDFEFEEEFEDDFFDGGDDDGDDCDEDGFDDFCGDEDDGDGDGDEDDCDBDBB<<=	G	43	A	35
1	109377334	C	28	cCTtcccTccttccttttTtttcTctct	B??BDEDFDDEEDDEEEFGFFFADEADE	T	16	C	12
1	109466858	G	47	ggaAgaAaAggaaaaagagagggagaagGagaaggagagggaggagg	C5?A@DDGGFBEEEFFFFFFFFFFFEFFBFFFEGGGGGGG<FDFBGD	G	24	A	23
1	110036919	C	96	CcGCgGgcCccCgggGGCgGGcGGcgcggGcCGcgccgGcggcggGggcgcgcccgggcCcggGcGgcgccgCGcccgccggcccGgcgGcccgcg	B?>;A>@>@>?DDDCDDDCEEAEEBCBCCEBGEBCBBCD9CCBCCECCBCBCBBBCCCBG@CCDCEDCDB<DGECBCD;CADCCCDDADDCCCBA<	G	51	C	45
1	110155524	T	59	TTccctCtctTCcccTcTcCCTTctTTcttTcctCttTttcCCccTctcTCttttctct	DAFFGDDDGDGDGGGGFFGEEGFGDGGFDDGFHDDDEGCEGDBGHDHBHFCDECEGDG=	T	31	C	28
1	110766454	G	210	AAAgagaaaagagGagaggggGggGagggAaAaggaagAaAgagaAgggAAaaaGGAAaGggagGGagaagGgaGGAgagagaAAaAAaGagaAGAAGaaGAaaAGAGGGGgGagaaGaagAGaAaagGGGggAGaGAaAaGaaAgAggggaaAGGGaaaaGgggaaagagGAaggaaAGaaaggaagGaaAGaAaAagaaaagAGGggg	ECECCCAACC?C@=CADABAA<CC=ECCCHDCFCCFDCHFHAFCFHCCCHHFFFCCHHFCCCFCACFCFFCCCF=CG@FCDCFGHGHHFBFCFHCGHCEGBHGGGCECBCCDCG:GGCGCDHCGHGGDBBCCDHCECCGHGAGGGDGDDDDGGHBBBGGGGBDDDGGGDHEB?GD@GGGBGFGDDGE=BGGGBFGFHF>ED@B>CC?:AA	A	113	G	97
1	110925550	T	162	tTggTgggGgTgGttgtgggtgGGttTtgtTTTGttGGtGtgtGgGttTGTgGGGttTGTttgtTGtGGTgTGtgGttTGTGtgTggtttTtggttttGtgGgttTtGgtggGgGtGgGgTgTtggtTTgGGtgTttggGTgtgTGgGggtGggTggTTgtG	C<AA=A@ACABBFGGBGCCCGBGHG8EECFEEEHGGHGGHGCGHCHGGEFECGHHCGEHEGGCGEHGHHECEHHDHHGEHEHHDEDDHHGEHDDHHHHHHDHDGFEHHDHDDHDGHHDGDDDCHDDHDADFGHCDFHCDGDDHDDGDGDDHGD@ECBBA<<B	G	85	T	77
1	111854895	G	152	AGAGAAAagAGAaGGGAgAGGGggggAagGGggGgaAAaAGGGGGgAAGGGGaGAAgGGGAGgAagAgGGAGaGaAgaAGGAGAAAaaGAAGAAAgaAGGAGggaaAgaaaAAggGAAGGgAAAGggGggGaaggGAAAAGAAAAaGAGGga	E9C7DFH;DHCHDCC=H>ECC9FFFFC:F@>FFCFAFHCHCBCB<GHHBCCCBC@FGCCCHBFGEGHGB=GBDBEGEEGB9G<GGGE5BGGBFGG<EGBBGBGFEFGGEEEGGEFBEGBBBGGGBFFBGBBEEGGBGGGHCFECC=CC??DB	G	79	A	73
1	111857276	T	107	CttTtTCTtCTTTTcTtCTtTcTCcctCCcCtTTTttTttcTcTTtTTTTTcttTTCcTcTTtcttctccttCCttTcttcTtttcCCTcTtcccTcttcttTctTT	;@@BEFFFGEGGFGBGGGGGGBEGBBGGHBGGGGGGGGGH>GBGGGFEDFGCHHGGFBGCGGH:F8CHCBHHFFHHFCDHCFHHFAFFFCFHCCCFCDHCEHECHE?	T	70	C	37
1	111889457	A	30	AtTaAttAtTtAAAaTtAtTaaAATAAAaA	:EFE;EEFEFEFCEEFFEAEF<EE=DDAAA	A	18	T	12
1	111891192	C	213	CCCCAcaAaCCCAAaCCAaCCaAAaCaCCAcCCACCCAaCCACcCAccCcaCcAAAaACcACAACACacAAAACCCaaACCCACaACCcCcACACCAAaaAaAcaCCacaAACCACCccCCccccaACCAcCCccaacCcaCCccAccACAccccaccAAACccccCcaCCCAAACCaCcccCAAcaacacaCAAcAACcaAAcCCccccaAC	DB@8BFDDDGGGFFDGGFDGDDFFDGDGGFGGGFGGGFDFD9GGFFFGGGDGGCFEDFGGFDF?:@EDHFEEFGDGEEFFFFFGEFGGHGHFDFGGFDEEEEEHEFFEHEFFGEFFFHGFFHHHE7EFFEHGDHHEEHEGBFFHHEHHDFEGDHAEGHEEEFHHHHFH8FFFEEEFFFFHGHEDDGCDA:HDFEEGCBBA?>AABACCC@:A?	C	124	A	89
1	111964144	G	67	cggggGgCgggccccgCgCGcCcCgcCgccGCCCgGCCCcGcgCgGGGCgGCCCCgCccGCccGCGG	?<@D@ECFCCCBBBBCFCGEBFBFCCFDBCBGDFDDGAGCDCDFDDDDBDDFFEDDDCCDECCCBBA	C	37	G	30
1	114189067	G	25	GGGGGTTTGGGTgGtGTGGGTGTTg	HHHGFDDDGGGDFGFFCGGHCF;A>	G	16	T	9
1	114191994	G	137	GGgAAAAGAAAGGGgAGAGGGAgGaggagggAaAaaaaggGagGaGAGaaaagggagggGGagaaaagaagggagagagAggAaggGgagaaaggggaaagggaaaaGgaagaaaaagGGgGgggGaaggaggaggg	=@C@;@B=BDFA?CFHCHCCCHCCFFFFFFFDFGBFFFFFCFFCFCIDFCFFFCFFFGFCCF;FFFFGFF=FFGGFGGGGFDGGGGCGGGGGGGGGAGGGEEFFGF=BDDGGGEF?GGCBGBC?GB<FDGGGGGEF;	G	75	A	62
1	114249400	T	30	ttCtccttctcttctccTcttttcttctct	C?@BGEDEFEFEEFEEFEFFFFEGFFGFDF	T	18	C	12
1	114309873	T	31	ttCCTCcCtCTccttcCctCccccttcctcc	CDEGGEBGGGBBBGHCFCHGCBBCHHACFB>	C	20	T	11
1	116260532	A	83	taATaaaTaTTtttTtttatTTtatTTtAtATaAtaAaAaAttattattttttaaTaaTAaAataattttAatAAataAaATt	CB@AFEDGEGGEEEGEE7EECGEEEGFEFEGGEFDEFEEEF?FEEFFFFEFFFEFGFFGFFFFFEFFFFFEEGE@FFFEFEGA	T	44	A	39
1	117544331	A	56	CCACAAACCAAACAAAAAAACAACCCACAACACCAAACAACCCCCCACCACACCAC	?GFGEFFGGEF?GFFFFEEFEE@FFFEGEEFEFFEEEFEEACFEEFEBDB@B>>A>	A	29	C	27
1	118644524	T	75	tTAaATataaATTtaaTtTTTatAaaAAaAaAaattataaTTAtTaaTtTtattatTaTtTttataaAtattAAT	?@>CCEEEEEEEEDEEEEFFEDEDDEF<E7EEEBFDFEFFEE?BEFFEFEFFFEFEDFDFDFGF@FFDFFFFDCC	T	38	A	37
1	120267505	C	149	GCCgcCgCGCCGCcCGcggGGgGgCGGCcCCCgcCcCCccccCGGccGGGCgCcCccCcccGGGGgCCccgcgccCggcCcgccCGCGgccGCcCcCcGCCgGGgcccgGcggccggggggcgCggggCcCgGgcccCggccgcccccc	EDB@CBGFFFEGGFGHGFFHHFHFGHHGGGEGFGFGEFGFGGGHHG>GHFEFGGGGFGGGG:GHHFGEHHF?GEEGFFG<HGHHGGGHGHGHGHDHGHHGGGGHGHGHGGGGGGHCGEEGGFFFGGGGFFFGGGHHGEFGHFFFGBACE	C	87	G	62
1	120336876	T	39	tttgTGggttGtttgggttgtGTttggtTggggttgttG	ABBFEEFBEEEEEEEEEEEFEE6EFFGFEFFGG>FGFFD	T	21	G	18
1	144922109	A	369	AGaggGGAAAggAaGAagAGAagagGAaGAGAAggaAGagaAaAGaGGGgAggGAAagGgGGaAAaAAGgaaaAGAAGAAAGaAaAGAGggGAAAaaaGGaggAGGGAAAGAaAGGAAAgAAaAAAGagAgaaaGagaggaAAAggAAgAgggGGAAGAaagAgagGAAaggAAAAgGAGGaAAAGAGaaggAAgaaaGAGAGaAAAAGAAAgGaAAggggGGAgGaGGGgAAAGGGaaaaaAGgaAAAAAAAAGggAGgagaGgAGAgGAAAAGGGGAAGgaAGAgaAGGAAAgAGaaggGAGAGAAAGAGaggaAAGAAaaaGAGGAAGAaaagAGGGAgGAAGAAAGaaaaaAAAaaAGAgagaga	B@CC?AA=?@9A@CECEFCGEDFDFGEDHEHEDFDDEHDFDEDDBCHHGFEFFHCEDFHFHHCEEAEDHFDDDEHCEHCEEHDEDEHEHGFDEDEEDCHHCGGEHHHEEEFEECHEAA<GEEEAEEHEGAGEEEHEGEGGE?EAGGCEFEDGGHH=E;DDDGEEEGGECEG@?>EBGHDHGEEEADEGAEGDBDEEEAGEHDFDEDDDGDDDEGEDD:GGGFFDGGEGGGE?DDGGGEFEFDDFGEDDDDDDDCFGEDFECG?FG@GDGGBDCDGGGGDDGGEBGDGEDGGDDDGAGAEGGGCFCFCCCFCGEGF<DDGC7ADECDHGDDGDCDDFBEFFBC@@AD>AA<@@@??7@@@=<C?B=?=9B	A	213	G	156
1	144923887	T	51	TTTtTTtttttttTtTttttttaattatatatattatatttttatttattt	DBD?@;BDEEEEEGEGFFEFFFEGEFGFGFGFFFFGEGD@BFFFFFEGFEE	T	41	A	10
1	145109430	A	79	AAAAAAAAaTAATTAAAATAAAAAAAAAAAAAAAAAAAaAAAATAAAATAATAAAATAAAAATTAAAAAAAAATTAATA	?DEEEEEEDEEDEEEEEEEEEDADD;DDDDDDDDDDDDECDDDDDDDDDDDDDDDDDDDDDCCCCDCCDCCCCDC@@<?	A	66	T	13
1	145516481	T	42	tTTTTTTTTtTTTTTTTTTTTTTTTTTTTTggTggggTgTTg	DECEE6DCFBFEFB;FDDEEED76EEEDE=?AD?;D?B?=A;	T	34	G	8
1	145530254	C	108	CCTtCccTTTcCCCtcTCTTTTctttTCCtTcccTtcttTCtTTCTccTtctcTtcTTcTTcTtcTTTccCTTTTcccCcTTttctTctcTccttttCtTtTTttctC	?<?B@DDGGGDDDDDDGDHFGGDEEEGEDEG@DDGEDEEGD@GGDGEECFEEEGFDGGEGGEFFEGFE=ECEEFFEEDCEFFEEDFFEFEFEEFF?DCF@FECEEBB?	T	64	C	44
1	145588536	C	185	tTTtcTTtTcTtTcTccTtTTTCCTCctTCCCTCTtTCCCTtTCCTcCcTttTtccTTTtCCtcTTTCCCcTtTcTTcTCCcTTCCtCCcTCtcTTTcTTCTTTCCCtTCtcTtcTTtTTCtTTctCCTCCCtTTccCCTttTcTTcCTccCTCCTTccctcttCTtCTtCtTTttCcTTCtTtt	C??BA?=CEDGDDDGDDGEGGGDDGDDEGDDDGDHEFDDDDEGDDGDDEDEEGFDC=GG<DDFEFDGDCBDFEGEGGEEDDEFGDDFDDEGCEEGFFDGGBFGFCCCED?DEFEDCFFFFCEFFEFCCFCCC:FFDECCFFFFDFFDCFEECFCCDEEEDEEFEBEEDFECBDE?AA:CCA<CB@	T	106	C	79
1	149884743	G	168	AAgaGGGAgaAGAGgAGgGAAAaaAAAGgAGAgAgGGgAGGGAaGGgGAaaGagGAAAGAGGgaGGaGgaAAGGgGgaGAgGGGGGGgAGgaaGAAaGGAaggagAGgaGgaAggAGGAGaGaaGGgGaGAGggggggGgggAGAGAgGGaaGgAggAAAaaGGGggg	B@BCB?DEFDFEFEFFEFECFEDDEFFFFFEFFFFEEGFEDEFCEEGDFEEDEGEFFFDFEEGEEEEEGCFFEE7EFEEEGEDDEDCFFEGEDEEEDEDEEGGEGEDGDDGEEG<EDDBCFDFDDDFDEDEDFGGEGG@GGGEDEDEGDDEDDEEFEEEFDACA=ABD	G	100	A	68
1	149903122	G	30	GCGGCGCcCCCGCCCcGCGGGgGGGGGCCc	GGHHFHFEGGGGGFDEGFGGGGGFGGGCC?	C	15	G	15
1	149907183	C	32	ACaACACCAAACAACACCCaCcaaaACcAaaC	GDBADHC>HCGDHGDGDDCFC8;EFGCEGFEC	A	18	C	14
1	149908108	A	46	aAAgGaGAGggaggggaaaaagagggagggaaagggGggggaaGag	?@=?GFHEHFFFDFCCFFFF<F>DC@FFGGGFFGGGGGFGGGEGGG	G	27	A	19
1	150049934	A	50	aGgagaagggaAaaaGgggggagaaggggagggaggggggagagAaAgaa	?ACCDCD?FEEF@EDGDEFFFE:AEGF=GFGFGFGEGGE?FGEEEFED;C	G	29	A	21
1	150524878	G	74	aGaAaAgaAAGGgGAGAGGAAgAAGAAGGgGgaGgGgaaAAAAAAaAGAaaGgGGGGAGGaGgGgAaaaAAaaa	C=E@FECFECDECEGEFDE?@CFEE:EAEDEDGEDDAGGDFEE?E=EDEFADDDDDDEDD@CDCBFCC@B<B;B	A	41	G	33
1	150804429	A	26	aaaAccCAccaAaaaccaaccaaacc	DDDFGGCFHGEDEEBHG@EHHCECGH	A	15	C	11
1	150938571	G	25	GAGAAGAGAGGAAGAGaGAAAAaAg	:E?HG>@@HBBGGBGB8BFGG>?CA	A	15	G	10
1	150939744	C	38	accaaaccaaacaAcaCAAcCccAAAAaaACCCCCCcA	@ADEEEDDEDEDEEDFDHHBBEEDGGBFEGCCCCBBDF	A	20	C	18
1	150981266	G	71	cCcccccgccggcccccGcccgcccGcGccGcccCcGgCggcCGGCcgcGggggccgGgggCgCgCggggg	C?>?@@ABCBBBBABBBEBB@CBBBE@EBBEBACGCEDEDD@FDDCCDCEDCCD=CBDDDDEDFBCDDDCD	C	39	G	32
1	150981460	A	46	AgAgaGagGAggaaAaaaaAagGGggAgagAAggagaAagaaaagg	CAABC?EFAHFFFFHFFEFHFFDCFFHGGEHHGGGGGGGHGFGFC?	A	26	G	20
1	151107862	C	83	TTcttTtCccTtcCTcTCtCttTtTtCtTccCTtTtcTCccTCcCtccctCccttTtcTttctcccttcttctccctctttTc	BB?@>=DDCBEFB@EB@FEGGFEGEGEGFBBGFGFGBFGCCEFCFHCCCFGCCHGFHBFHHCHC?CHHCFH@GBCCDCHHHB<	T	45	C	38
1	151315287	G	111	cGCCcgGgGCGgCggGCCccGGCGggggcccGCcccCCGggCCccCCCGggcGgGgCccCcgGCCCCcGGCCCcGGCcGcGCggGgGgGcccGcCGgGGCcGgGgcGCCcg	A@BB@@ECCGECGCCEGFBBEEGECCC?BBBEFBBBGFEDDGFCCGFCEDDCEDEDFCCFCCEGFGF@EEDAFCDDECA=DEDDDDDDD?CCDCFDDDCFBDBC@?C=@;<	C	57	G	54
1	151679900	C	77	TTCTTTCCTCTCtTCCcTTTTTTTCCcCTCTcCtCTtCCTCCCTcCtCTcCtCcCTCCTCttTCCCTTCCtcCTTCT	D:?DCEDDGDG?FGDDCBGFGGGGDDCDGDGC=HCFCCCFCCCFC@HCFCCGCCCCCCFCHHFCCBFFBCHCCFEBD	C	40	T	37
1	151735576	T	96	CCtccTTcccTcctcTTTcCTCTctcCCCcCtCCCTtttTccTTtTtcTCtcCCcTCccCcttcTTTttcTtTcCtctTttcCCTtTctttCCtcc	<<>B?DCB=DGCDEDGFGDDDDGDEDDDCDDEDDDGEFEGEDGGFGEDGDFEDDEGCEA=EDBEFGFF@EFEFECE>FACFECCEFFDFEFC@@=@	C	49	T	47
1	152083325	A	69	AATtaAatATttAaaATTTATtAtTAAAaTAaATAAtaTtAatATAtaaTAaAAAAtaTAAAtattAAa	=?BEEFFEE?EEFFFFG:<EGEEFEFFFGGFFEGFEFGDEEGFEFEFGGFEGDDCEEFFC:B?<;<CCB	A	42	T	27
1	152691943	G	26	GgGGAAGGAAGAAAGGGAGAAaaaGg	@CHHEDHHEEGDDDGGGDGDDFGGG>	A	13	G	13
1	152692781	G	49	TggTGtttGtttGgtggGGtTGTGgTgtgGttgggggggtggtttgggg	@CCD:EDDHEECHEEFFHHDEHEHF9GEFHEFGFGGFEEFFFFFFGGEF	G	29	T	20
1	152882610	A	57	AAaGaAagaAgggAaAaAGGgaagagaagAAGGGgaGGAGAGaAGAagAGgAGGGaa	CDDFDFDEEFEFEFEFEFGGGEEFFGFFFFFFGEGEFGEFEFFEFECFDEFDDCC@A	A	31	G	26
1	153600585	T	81	CTCCCCCTCctCTtcCCCTCcTTTctTTTTCTTTctcctTTcTcCtccTTtCTtttCttTtTtTTcctccTccTCcTCttt	@<B?GGGGCFEGGEFGGGGFFFGGFEGGGGGFGFGEGG@GGGGBGFFGFFEFEF<FCEFFEEDFFEEAGGFGGEFGFDAA=	T	45	C	36
1	153941514	C	78	TCTcTCttttttccTctCtTtCccttcTtTTTTttTtCcTttCcttcttcTccTTtCTtttctTCCccTTCtttttCt	DACBB9BBBBDDDCDDECEGECDDEEDGEGGGGEEGEDDEAFDDFFDEFEFEDGGFDGEDFEFFCCEEFACECFEEBA	T	51	C	27
1	154245142	T	49	TGTGGGTTTGTGTTTGTtTGGtgTGtgGTgtgTGTgGTGGGGTTGTtgG	B><>GHEEEHEHEEEGEFEHHFECHFFGDEFG:GDGGDGGGGCCGCBF;	G	25	T	24
1	154544534	G	39	AgGAgGGGggaGaaGGAagaAgGgggAGgGaAGggAGgg	?>@CEE5EFECDEE:EFFGFFFEFG@EDGDFEDG=ECFB	G	26	A	13
1	155033334	G	43	gagagAgaggaAaaAgaaAgaaggagAggaaaagagagAaaaa	<EBECECFCCFFFFECFFECFECCEDFDCGGFFDBDGDFGGGC	A	27	G	16
1	155880159	T	45	CCCCCCTCTTTTCCCCTCCTTTCCCTCCCCtTccCCCTCcTTTcC	FGGGGDEEGGGFE@GDGGGFGEDFFGFFFFEFGHFFFEFGBCDA?	C	29	T	16
1	155899020	A	123	TTATTATTAAATtAAATATATTTAttTATttATTTAAATaTtTTTTtATTTATaAAaaATTAATATaAAtATAAAATTTTAttaTAATATaAaTAAAtAAaAAAaAAtTtTaaaAtTtTTATA	BCEDEEEEEEEEDBEED6AEEEEEEEDB;EEEED<EEEED=EA=EEEEEEEEEDDEEEDDDDDDDDEDDEEDDDDDCDDDDEEBDDDCDDEDEDDDDEDDEDDDEDDEDEDCDCEDD?AA?A>	A	62	T	61
1	155935244	C	45	CAacCaCacCAcCCAacaacAaaCAaccACCcCccaCCcccCACA	7BDEDEEDGFDGFGFDHEEGFEE7CEGHFGFHGGHEFDHHGFDCC	C	27	A	18
1	156105028	T	83	TctcttttctcCtTcTcTtTcctctttttTCcCcCcctTCtTtCcttTttcccCTcTcccCCtTCttCccctccttccttTtc	C>@@CFFEAFBDEGBGBGGGBBGBGGGGFADBDBDBBGGDGGGDCFHFHGBC@DGBGCCBDDGGDCHCC>CHCCHHA?B:A@@	T	43	C	40
1	156146218	C	78	CCcCtTtCCtCcTttcTcCTccTtTTcCTCCtTCtTCtCTCCcCtTCTTcCCTTCCCTTcCcTCCctCCTccCcCCCT	=@FCEEDDDCDGGDDGFGDFGGGDGGGCGDDEGCDGDEDFDCGCEFCFFHBCFFCCCFF>CHFCCHECCFHHBGCCDC	C	46	T	32
1	156212284	G	68	gaGgAGGAAAgagagggAAaggAaGaAaaGgaGGAAGGAAaaGgggAAagGaAaaGaaagGGGaAaAG	ABBC@EE?D@DD9BFFFF>DFG<EEEFEEE?EEEFFED9EEEDGG?FEEFDBECEDEC:GDDCC<CBA	A	37	G	31
1	156348006	T	70	TTTTTTTTTTTTTTTTTTTTTTTTTTTTTTTTTTTTTTTggggggggtgggggtgggggggggggggTTT	CEEAEFBFFFFEDFFEBFFFEEEEEEEEEBBEEEEEEEEE@CCD:>DBDDD8CDD7B9>D@DBC=CA:B?	T	44	G	26
1	156348012	C	58	CCCCCCCCCCCCCCCCCCCCCCCCCCCCCCCCCCCCCCggggcggggggggCCCcCCC	EEFEGGFFFGGGGFFGFFGGGFFFAEFEFEFFFEEFEF?D6=><9C??76:EDDB9>B	C	46	G	12
1	156446903	T	128	cCTTtCtCCtcCTTtCCCtCTCCTCCTTCCTcTcTccCtcTccTTCtCtTCcTTttCtTcTCtctcCCTTCTTCTtCCcttcCTTctCTTcTtCtCCtTCCTCTtTcctCCCTtTttcCTtctttCCc	?B9=DDFF@DAFDCGBGDGEFGFFFG:FGGAB?BCBBGFBDB@FCFHFHFGCE9G=FHFBB?HCHCFAFFFDEEEHG>CHHAFDEC=EDEB?HFHEFABEECEECECCHFFFEHE@H=DF>@C>C>>;	T	65	C	63
1	156628717	C	38	aacCACaCacCAcCACACCACCaACCcaaCCAAAcACc	A>DDHDEDE@DHEDGDHDDHCDFFCCEFFCCCHDAC?@	C	21	A	17
1	156640156	G	85	AAAAAGAGGGAAAAGAAAGAAAGAAAaaaAaaaaGGgAAaAGaAgGgaaAAaaAAaaGGgGagAaAAAAGagGGGaAGgAGaGAA	C:D;:EFEA9FDFFEFFDEFFD=F:FGEC6GGGG79D9FDFEF;DDDGGEEGGEEGGDDDDBEDFEEEEDFDDDCGEC@CBBAB?	A	57	G	28
1	156640678	G	28	agaGggaaggGAaAaGAAaGAggAgaGG	CBF6CCFFDDAGGGFBGGGBCDDG@D<C	A	14	G	14
1	158056549	G	62	GGcccCcccCcccccggcccgccgccgcccgGggcgcccgggcggggcccGgccccggcccc	B?:?>C@BBFBBBBBCCBBBCBBCBBCBBBCECC@CBBBCC8BCD?DCCCE?CB;;ADCCCA	C	39	G	23
1	158225019	C	127	cggCGcGgggGCCGgCGgggCCGcCCGgcCGcccCCCGCGGccggCGGccCgggGGcCGCCcCCcGcgCccccgggcCGGCGgGcgGcggGCCCGgcCCcCCGgGCgCggGGcCCgCGGCgcgGgCg	ABGEEDEEEEEFFEFBEEDEFFEAH7EFDFDCDEGF7EGEECDFFGEDEEFGGGEDEFEGGEGF@EEFFEE?EFGGEECDED>DCFDEEFADFFCGEFFEFFDBDFGEGGDDDDEEGCC9?ABBB?D	G	64	C	63
1	158297960	C	92	TTCTTCTTTTTCTTTTCTCTTCCTCcTTCTCCCTTCtcTTTCCCtTCTctTTCCCtcTTcCCtCCTTCTTTcttccTTttTTtTCCCCCtCt	EFFHGGD:GGGGGGG?GGGGGFGFEGFFGGGGFGGGF@G<FGGFFFFEGFFFFFFGGFFGFFEF@FFFEFFFF=GFEEEDFEFEEEFFFB@A	T	53	C	39
1	158389210	A	39	GAAggaGggAaaAaaAaaaaaaaaaaaaaaaaaaaaaaa	DBBCCB@EFFCDFDDFDDDDDEDDCDDEEEEEEEEDEEE	A	33	G	6
1	158507160	T	88	TGTGtGGTTGTGtTTTgTGtTtGGGtTGgTTGgGTGGGGgGGTGGGTTTTTtTGTtGTTGTTGgTTGGGTGgGTTtTTTTTGGTGtTt	?EFDEE5FFDDEFEFBGFEFFFE>EDFEGFEDGDDEECEDDDEDDDEEEEEGED5EDEEDEDDGEEDDDEDGDEEFEDDDEC=CDEDA	T	48	G	40
1	158619822	A	70	AAcCACcCACccCAcaCAcaaaCaacacCcaccccaAcccacaAcaaccccacaccaaaaaacaaccacc	CAAABCDEDGDCGFDEFFDDEEG8EDEDGDDDDA=EFDDDDDDFEEEEEEEFDEDDFEFFF@ECFEEEED	C	38	A	32
1	158813819	A	80	AAGGGAGGGGGGGgAgGGAGAAAggAgGGGgAGAAaaagAgGAAgGgAAAGaAAGGaGAaGagAgGGGagAAGaAgGGgG	C<=BCHCCCCCCCCHCCCHCHHHDDHC;<CDHCHAGGFDHDCGHCCDHGGBFGHBBDBGGBGDGDBBBFDGGAGFDBBA:	G	46	A	34
1	158848721	T	41	tgGTgGGTGGgGTTGTTtgtgggTTggTtggTGtGGggGtg	CAFEC@HDIHCGEDBEEGDHDDDEEDDDHDBCFHGGDDGGA	G	25	T	16
1	158990247	A	64	agAaaaAgggAgaAaagagGGaggAgaAAggaGgAagggaagaaGAaAaaAgaggggagaaaga	A>@ABDEDFFFFEFEEFEEGGEEEFEEFEFEEGEFEFFEEFFEEGFFFFFFGFFGCFEGFFFFF	A	36	G	28
1	159002301	T	55	CTTCCTtTCCTTTCCTcCTTTCTCTTCTTttCCTTCTtcttCcTtTTtTTtCTtC	GEEGGGGGAGFGGGGGCGGFGGEGGFFFFHHFFEFFFHCHHFCFHEFDDCC>?@C	T	35	C	20
1	159783225	G	46	gaAGGGAAAGAAAGAAGAAAAAAAGGGGAGAAAGGAaGGAgAaAGA	FFEHHHDD6HE?EHADGDDDBDDAGFGGBGD;DGGDGFFDFBCAD>	A	28	G	18
1	159807969	A	38	TtAtattattaataaAaaataaaatataatttataaaa	=BABDBCCDCDDDDDEDDDDDDDDEEEEDEECEEEEEE	A	23	T	15
1	160141268	T	117	CttCCtCTTtcttcCttCcTttCcCTctctcttCTctTTCtCTTtCTCcCcTtcCCtttCctcTCcCcTCttccttTCTcCctTTTTTtTTctcttctcCTcCTtttCTTcTCtCCC	?B:DCDDGAEDEEDGE>GDGEEGDGGDEDEDBEGFDEFGGEGCFEGGFE8DGFEFG@FAG@FEEGEGEGDFFDEFFBFEEFDDFFCFEEFEEEEFFEFEFFEFFFDFFFEAEB>>BA	T	63	C	54
1	160141286	C	124	CccGgGCgcgcgccGCgcCGcGCCcGCGgGgCcgGGcccGgcgCGgGgCGccggccCGCgGgcCCCCcCCgcgccgcgGCgGCcccGCCcgCGcGGGCgCGgGCGGcGcGCcgggcgggGCCCg	AC?;B9>ADFFEBECCFEDCFC@DFCDCFCFDFFCCFEE@FGFDCGCFDCGGFDGGDCBGB@DDDDCGDDGGGFGCGGBCG9CGHHBCCFGA9FBBBCGCBGBCBBFBGBABFGGEEGF?A8AE	C	63	G	61
1	160251792	A	105	GGAGAGAaAAAGgAGGAAGGAAGaGGgGAGAGGGGgGaAAGGGAGAAgGAGagggAgGgAAAGAgGagGaaGGAGaaaAGGAGAGAGAAaAAAaGGGGagGAGGG	DE>FDGFDFFFGFFGGFFG>F@FDFGGGFGFGGCGGGDFFGFG?EFEDFFFECGGBEF<EEEFEGFEGFCEFFEFEDDEFFEFEFEFDDDFFFACCDC@ABAA??	G	57	A	48
1	160260233	T	47	ttTtctCtctcccttttCttcCcCTcCTCTTtCCcCTTTTTTCtcCt	CDEEFEEEFEFEFEEFEDFFFG>FDGFCFDDFFDDFDDDDDDEDEC@	T	26	C	21
1	160318940	A	73	GggAAgAAGGaaaaaaAaGaAaGGAggAaggaAAAaaAaaggaaGGAGgGaaaAggaGAaagaaagagAggaa	9CBBEFDFFFDCDDDDFDGCFDCEFFFGDFFDF@EEEFEEGGCE9GFGGGEEEE@G;=EEFEE9EGEDEGGD?	A	45	G	28
1	160393905	A	82	AAgGGGGGGAAaAAGGgAggGAAGAaGagaaAAAAgGAaAgGaagaggGgAAGAGagGAAAGgGAaGGGAAgAAAGGGaAgA	A>BCGGGGEFFDFFGGFFFGGFFFF8GE9EEFFFFGGFEFEFEEGEGEFAEEFEFCAEEEEFGFEEEFFEEGDEEEDDAB?C	A	42	G	40
1	160786472	C	121	CTTCTTTTTCCTCcTCTTtTCcttTTcTTCCTTCTccCCtCTTTtTcCccCCcCctTtttTTcCtCcTttctTTtCcttTcCtCCCccTCTCCTctttTTCtTTTcCCtctTTttTCTTct	EEGGF8GDDGCBGBGHHGGGGBHCGFBGGGGGGGECCGGHFGGGHGCGCCGGCGCDGGGHGECFCFC>H9CCBFHFCHBECFHFFFC=FFFFFFBHHHFFFHEFECFEGAGDBCBA>AB<C	T	69	C	52
1	161049509	G	77	GGttgTtTTggtTGggttggGGGgTGtGTGGGtGGGgGGGgGtTGtGgGTGGGtTgtggtttTgTTgGTggggTGGG	ABEHCFGFFCCGFBCCGGCCEFECFEEE9EE5HEDEDEDEAEGFDHEDDEDDDHDDHDDHHHEDEEDCDDA@@BAA@	G	48	T	29
1	161068836	A	211	AccCCcaccaacccccCAACaAACccacccCCCAaCCaCcacCAaCCaCaaCaccaacAaCCACCacaACacaaCcaaaCcCCCcAAACcACCCACcaAAcAAAACCCcAACCAcCAaCcaaAAcAccccCcAacccAAcCacCccaaccaCcAaAAaAAcacaAAACACccCccaaAcCaaCaCCAcaCaAaaCCCcCaAaaAacCCcAA	EAC=<<C>>?C=9>=ACDGCG?G9BBE?B?DDDFFDCBCBFBDHFDDFDCFDFBBFF:HFDEGDCFBFGDFBFFDCFFGCBDDDBGHHDBHDDDCDBAHHCGHHHDCDCFGCCBCCGGDCGGHACHCCCCDCHGB@CAHCDFCCCCGE=6GDCGFEGGHGCGBGGGGCGCCDCCCGFGACGGCGCCGCGCGGGFDDCBCDDB@CA;@@=C?	C	114	A	97
1	161126705	A	103	GAGAAGGAGgGGAGGgGGAAGGGGAAGAAAAGGAAAAAGGGGGGgGGAGGAAAGagGGAAggaAGaGAAGGggGGggAaAgaGgGGagAaAgAAGAgAgAGAG	D>BDCGFFBE8?EGGGGGFF:FGFFFFFFFFGGFF?FFGGGG:GEGGFGFFFEGFFFGDFGGEE6FFDEFEGFFFGF<FDHFFFFFFGEF=FDEFEFDB<C?B	G	59	A	44
1	161681780	A	71	GgAAggAGAgGgaAGaaagAaGaGgAgGaAAgaggGggaaaAgAGggAGAGAggaggagaaAAGGaAGGAG	<@@?CBFGFCECCFGFFFCGFBFGCECEEFFDGDDG@DG<GBDF;DDEGEFEDDGDDFBGFEEFFGBDBCC	G	37	A	34
1	161736197	G	42	TtgGggTGtgGTTGtTGGggTtGGGGgGGtggtttgGGGggG	@DFGFEAGEEGCEAEG;GFGGFGG@EFFFFFFEFFGFFF@FC	G	28	T	14
1	161967681	A	191	gGAAGAAGaGgaGAaGGgaAGGgGGGGggGAGGAAGGGGAGGAAGaaagGgagGgAAgGAGGaAGAGgGgGAAGGagAGAGgGggaaAGAAAaGAGGaGGggGGAAGagAaaAgaAGgAgAGggagAAgAgaggGAaggggAgaaGaAaagGaagaGaagaagAgggagGggagagGAGGagagggagAAg	C;CC?FHBECEDCHECCF@GBBFCCACFFCDACFGBCBBHCC@HCEEEFADDDCEHCECHCCEHCHCDCFCHHCCFF:CHCFCGGFFGCHHGFADCCFCBEFCCHHCFGHFBHGFGAFGEHBGGEDEGGGGFFFBGFFGFFGCFFBFGFFGBEFEFBFEFFEFGEFFFGBFEEEBC9D??A@;A>?>>A?A	G	109	A	82
1	162689017	G	58	TGTGTgGtgttggtTtgtGtggTtGGgtttTTtttgggtgttttggtttgtggggggt	@??:<BDFEBDDDEGEEDGEEFFDAGFEDEGGEEEFEFEFF9FFEEFFFGFGGGGFF=	T	31	G	27
1	163117351	G	34	gggttggTttgtggtttgttgttgGtggggTgtg	>@GEEEEEE=FE6FEEECEFFF:F?FGFAGEGFD	G	18	T	16
1	164529120	G	31	AGGGAGAGAAGaAGAAGAGAGGGAGGAGaGA	GCCBHCACGH;DGBGGBGBGBBBGBBGBF?B	G	16	A	15
1	167487586	C	124	CGCGCGGGGCGCGCGGCGCCGGcGGGcCCCGCCCCCgCCCCCGGCcGgCCcCCCGcCCGCGGGGgGcggCCCgGGCGGGGgCcCCCCGCGCCgccgGCcccgCgGGCcgGCGCgcgCCCGGGCg	B>?CBGFGAGGGFEHHDHGEGHDHEHDEGEGGGGGFGGGGGGHGGEHGGGEEGFG7FFGFGGEGFGEFGFGFEFGEGGGGGFEFFFFGFFFFBEDFGFEE<FEFFFEDFGFFCAABB>@CC?@:	C	66	G	58
1	167988653	A	34	GAGAGGAAAGGAAGGGGGGGAAGAGGGgAagGgG	>@<G=DHHH=CHGCCB;BBBGGBGBBBGFEE=@C	G	22	A	12
1	168200733	T	28	TTCCCCCTCCTTTCCCCTTCCCCCCCCt	DDGGGGDE>GEDEG=GGEEEFFFFEEE?	C	19	T	9
1	169079825	G	26	TTTTTgggggggggGTGGGGGGGGgG	>E5>DFGGGBEDGFF;HHFFDDDC<C	G	20	T	6
1	169094100	T	99	TTATTAATATTATATaATATATAAATaAAAAATAttTAAAAtATaaTTTtaaTAAaAaTTAATtataAtAATaATttTATTttTtTTAtTtttATTaAt	EEFFFDFFFFFFFFFFFAFEFEEEEF@FFFFFFFEFFEFFFEFEFGFEEFGFBEEDEGEEEEEFGFGEFEEEGEEFFEEDDEFEDEEDCBA@=AAC?AC	T	51	A	48
1	169293721	G	68	AAgaAGAggGGgGGGagaGaggagGgagaggagGggggaAaGggGaaaGaggaaagGagaagagaggg	A@BBFCHEFCCFCC:DFDCDFFDFCFDFDFFDFCFFFFDHDCFFBEEEBEGFEEEGBEGEDHDFEFFB	G	41	A	27
1	169529826	C	82	cACACaAACACAAaAcAAAaaACcCCACCAcACCCaAaaCCaaCacAACAAAacccCCcAAAcaCACCCAaccCCCCaCacc	=:A=DDHFCHDH=FHBHHGFFGDCDDHDD5CHDDDEHGGDDGGDGCHGBGGGGB?CCCBGGG=GCGCCCGGCCCCBBAAD@@	A	41	C	41
1	169565346	C	80	CaaCaaACcACCcaaACCCCAAAaCAcaCAcAcAccCaCAccCCcAaacaCCaaAACACCcccccCAaacaACaacacac	DBFGEEFDDEGGDEEGGDGGFEFEGFDFDFEFEFEEGFDFEEGGEDFFDFFFFFEEFDFFFEEB;FEFFEFEFFFDF7AB	C	42	A	38
1	169580717	T	43	TTCCTCCCTTCcTCTCCTCCTCCCTCTCTCCcTTcCCCCCTTc	GGDBGGGGGGECBGGGGGEF5FFFFFFFFFFCFFCEFEDA?A;	C	27	T	16
1	169698825	T	151	tGGGGTGtttTttTTtgggttTGgTGTgGTggGGtTtgtGtgtGgttGTTggggTGttgGggTgGgtTtttGTGgttGTtTgTGgttTGTttgGgTGTtttTggTGtggGtGTTttggGgttTgGtggGTtggtGgttgtgttggtttTgg	?A@@C@BCBBCDDEECFFFDDEGFEHDFCBFFHHDEDFDH?FDHFDDHEEFFFFEHDCFHFFEGHGDDEDDGEHGEEHEDEGEHGEEEH@EEEHGEGEEEECGGEHEGGADHEEEEGGGGEECGGEGEGCEGGEGGFEEC99EGGDD@BB?	T	78	G	73
1	169823718	T	158	CtctcCtTCtctCTcCccttcttcTCTttTcttCTcTtCctTtcCTCtcCcTCCtCTTtctctCTTCccCctcttTCCctCTtcCCcTCCCccCccCttTTTTtCtTTtctTCTttcTTTCCcCccctCctCtttctcTtTcTCTCCCCCccTtcTtc	BC??C<>@BC@FFDBGBBGGBGGBEGDEGEBDEGEBEGGBG:GBFD<GBG@EEGGEED?BEBHGEEGBCDCHCHGDFFCGEEHCGGCEGGGCC8CCGEHEEEDHGHDEHCAEGDHFCDDDFFCFCCDIFBFFHHHBHBDHDCDFDFFFFFCCDF?CC@	C	81	T	77
1	169831993	A	32	gAgaggaGaAaagaggGgAAgaagagggaaaa	A?CDFFDGDFDDFCFFFFFFFEE9EGGGEEC@	A	17	G	15
1	172434812	C	90	CtCtCCCtttCTcCCTcCCCttCtTCtTTctCtCcTTTCcCtCTCCTtCCCctcctCcttCccCTccccccctCctcTtcTccTcccTcc	A?>B>>CDDEDFDDCHDDDDEEDEEDEGGDEDBDDGGGDEDEDGDDGFDDCEEEEBDEEEDEEDGEDDEEEEFCEFE@EDFEDECBAC=@	C	55	T	35
1	173797451	T	56	TTTcCCccccTcccccctctcCccCccTcCcccCCctccCcCctcCccccCcccCc	=>EDF9D<DDEBDEEEABEEEDEE@CDDECDEE5=E?EDFCDBBED9EDAFECECB	C	47	T	9
1	173855298	A	43	ttaatataattaatattTaaattTataataatttttaaaatta	?CBDCEDFEDECFEFEEEFFFEEEGFGGFGGFFFFFGGGGFEG	T	22	A	21
1	173952836	A	46	gAGaagAgAgGaaAgAGGaaGagGagAgagaaagaGaggaagggga	A@?DCDFFHECCDGFGCDDCCDFCEFHGDFEEEGECDEGEEGGGGD	A	23	G	23
1	175348723	C	58	cCTTCTTCTTTTTTcCCCCtCTTCCCCTcTTTCTCTTCCCcTttcTcCCttCTTCCTT	BDGGDGFD?DGGGGGDDDDECFFCCCCFDFFFCFB?FCCCGDFEFFGCCFFCFEBBDC	T	30	C	28
1	175355128	C	77	GGGGGCCGGgGgGcGCCGCGGCCGCCCCGGCGCgcCCGCCGGCCCcCGGGGCgGgGGGCGCCgCCCcGgccCGCGGg	@BHFHDGHHFHFH<HGGHGHHGFHGGGGGFGGGFFFFGFFGGFFFHFGGGGFFGGGGGFGFEGEFEGGG?A@@CCCD	G	41	C	36
1	175365663	G	92	AAAGGGAAAGGAgGGGgGGGGGAaGAGGGGAAGAAaAagGAAgAggGGAAGGaAAaaGGggAagaGaGAAGAAaGGGAGAgAAGgggGAGGG	BDGCCCHHHCCGDBCBDCC;CCHGCHB?BCHH@HGGGG>BGGBGCBBBGG<AHGGGGABDDGGDG@GBGGBGGG@BAFAGDFFAB@:?B=A?	G	51	A	41
1	176659463	C	217	CCcctttCCCTTCTCTCttCttttcCCctTCTTTTCCCcTccTCtCCCcCTTttTTctTCcctTCTtctttCtcccccTCCTTcctCttCtcttCCtcTtCtctcCTcTcTtCCCCCtttCtctCctCcctctttTCCCtttctctcCTTtcttttttCCCccttccctcttccTccccctttTcTTtTTcctCTTTcTcccCCCTctcCcctctct	AACAA?@;?=@B?B@CCCDBCCCCFBDFCGDGGGGDDD8GGGGDDDDDGDGGDDDFF=GDGGCGDGDFDBD@9GFGGGCADHEGGDD?CDD:ADDDDGGDDDGDFDGHGGDDDDDDCDEEDDGEDHECHHEHEEBGCDDEECHDFEGDGGE>DEE?EED?DGGEDH?HEHB?HBFDHHFHEFEFHFFEFFCEECFFFHFHA5CCCGFDFBDD@A@@@	C	111	T	106
1	176809368	C	149	CtcCtTttCtCtttttTCcCtcCcTCctTTTTtctCtttctcTctctctcccTTCTccCtCcccCCTtcccTCtttcTCtTTcCccCTccccCttcttCTCcttccctcccttcttctctctctctTctCctcTcttttctcCctccct	BCC>C?;C=>CEFHFFFFBGCBGBGGAGGEGGEBGGGEGBGBFBGBGBGBBBHHHDBBDGEBBAGFG<CBBBGHHGBEFGDGCFCCGECCCBGHHCHH=;GCHGCCBHCCCHHCHHCHCHCH<HCDECGFC@<FCEHHH7@CFCHCB?@	C	77	T	72
1	177901619	G	30	GGAAAaAGAAGAAaAGGgGaGAAAAAgGAG	BBH@HEHCHGBHHFHCCF=FBGGGFFGB>C	A	18	G	12
1	177902387	C	87	CCAaCAAAACAAAACACAACCAAccCCACACCACACaCAAaCcaaACaaaAAacCCacaAaCCAaAaAccCcCcCCaAcAaaAcCcc	BBBEFEFFFFEFEEGGGFFGFFFHHGFFGFGEFFDFG@EFGGHEGEFGGAEEGHEFGDAEFDFCGEGEHHEHDHDFGDFB@AB?A@E	A	47	C	40
1	177902388	G	91	AAGgAGGGGAGGGGAGAGGAAGGaaAAGAGAAGAGAgAGGgAaggGAAgggGGgaAAagagGgAAGgGgGaaAaAaAAgGaGgGaAaaGAg	BBCBHFGGGHEGGFHGGGGHHGGGGHAGHGHHGHGHDHGFDGGDDFCHDDDFFDGCG5DADFDGGFDFDFFEGFGFFGDEED@D@@>?ACA	G	48	A	43
1	177929379	C	29	CCttTCTCCCTTTCCCtCTCCTTcCTCCC	?9DF<GEEGG@DDFFFFFDFDDE@A@@>?	C	17	T	12
1	177933443	G	86	AAGGagGAgAAaGAaAAAgagAgggggggaagaaaGgaggGgaaAAaggAgGagGGgGaGAgaggGaaaggagaaagaAaggaaga	BE?AACBHCHGFCHFHGHCFCHCCCCCCC@FDFFFCCADDCDFFHEGDDHDAGDCB?BGBHDGC@BGGGDAGDGGFCFFEC?B@AA	A	43	G	43
1	179590352	C	25	TtcccctctCTcCtcccccttctct	?AEDFGDGDFFGFDGGGGFDEHEGE	C	15	T	10
1	181701799	T	52	TaaTtaAAtaaTATaTatTtttatAAAAAAtAAaAATtATTAAAaTAttTAT	8FEHGFFEGFFF@GFDFH?HHHFHECEEEEHEEGE@FDEFFEEDGFDDDCBC	A	29	T	23
1	181759657	G	96	agGaagaGgAaAaaAaaAGggggAgAaGAGgAGGGGgGGaGaAGAGgAgGgGggGgGaAGagagAAgAagggaagaaggaagAGGaGaGGaGaGGA	=B;CDDECEHEHDEHEEHBFECEA7==CHCGHBBCCGCBFCFHCGCEHFAFBGGBGBEGBFACGGGGGFFGFFEECBG8FFFGABE?B?>A??:<C	G	53	A	43
1	182027022	C	133	tctTTTtCtttCtTCCTCTTCtctTcCCTCCtTcCCCTtTcCttTcTTCtccttcTTttTcTctCCCcttCCCttttctctCTCcctcTCTTtCCctTTCcctctcTCcCCCTtcCCcctTTtttcTtcCcct	C???BDEED:EGEEG<CGCEFEDD>DGEEHDEEDGGGEEEDGFEEDEEGFEDFFDEBFFDEEEFGGGAFFG@GCFFFEFEFDCEEDFEDFDD:GFEDDDFEDFF;ECDEFFFDEDFFEEFDDFEFECDDFB@B	T	69	C	64
1	182355046	A	62	GGGAAAGAAAaaAGGAAAGGGaAGaGAgAAggAgaGaaGaaaAaGaAGgAAgggGgagagaa	?><B8FCCG<E?HD>HG<CCBEHCFCHGHHFFHFFCEFBDFFGBBEGBGGGGFFBDAB@@;=	A	35	G	27
1	186089112	T	54	TtCCTCcCCccctCCTTCCTTcCcCtTcCctcctTCcccCcccTTTTTTCcCTC	BBGEEDDGGD8BEGAEEGEECDGDGCEE>@E;9<DFDEEFECDDDCDEDC?B@A	C	34	T	20
1	186151493	C	62	GcCcggcGCgGggcccggccGcGgggcgcGGgccccccggccccggcgggggcggcCggcgg	DA?DCCFBEFHFFGGGFFGGGGFFFFGEF@HFGGGGFGFEHHHHGGHDGGGGHGGGFGGCBD	G	34	C	28
1	186909090	T	50	TCCCTTTCCTCCCCTTCCTCTCCTTTTcTCCCCctTTTTTTTTTCCCTTT	FDEEHGGDDG8B>DGG8DGCFCCFFFFGFCCCCCEFEEFEFFFFCBBDAC	T	27	C	23
1	193090894	G	84	gGAAagGGggaggGGGggAGaGagaAaaaaagaGagGaGagGGgGAgGGggAgagggGAgAaggaggGggGGaGgAaggGggag	=@@;<@BACCECBEEDCCEEFEECFEFFFFFCFFCCDFEFCEECDCDEE@AFCGDDDDEDEGD>FDDDDDDDG:DEGCCDD=>A	G	55	A	29
1	197447037	T	99	CCtcccCCCCTtcttCccTCccTCCtcTTCttccctTtCtttcCtttTctttttTTTTttTtcctccttTTCttcttctttcTtctcctccttCctTtc	DDAABD<FGGEEDEEGDDEGDDGGGEDCGGEDCDDEFEGDEFDGFFDGEFFEEEGGGGFFGFEEFEEEEGGGEFCFFEFFFEFFEFEEF<DEBFEFG?9	T	56	C	43
1	197480927	C	94	CCTTCCCCTCcCCTTCCCTTCCTTTCTTCTTTtcCTTTCTctcCTCcCcTCTCtTcCcctCCCTcttccCcCCccCcTTtCtctCtctCttctt	C9EGC@DDGDFDDEGDDDHGEEGEGDGGDGGGEFAGGGCGFEGDGDGDGGDGDFFFDDGFCDDFGF?AGCGC9HGCGFFFCFFFCDFDACCD=C	C	53	T	41
1	200867492	C	51	cgGGgCGGgGGgCcCGCCcggGcCCCCgCGCCcCgcCCGgccccCGGcGcc	CBBCFD=CFC;FAFDCDDGGFCGCDDDGDCCDGCFGC?BGCFGED@@<=<D	C	29	G	22
1	201012597	G	86	gGgAGGgGagGAaaagaAgGgaGgaggAAggggGgGaggggagggagggAgaagAaAGaGagggGaAgaaagagaaAggGggGgaa	@<AE?BD@ECBHFFFCFHCCCFACF?8HGCCCBCCCFCCCCF:D8F8CCGDGGDFGGCGAGDDDBGHDGGEDGDGGGDCBDDACCB	G	52	A	34
1	201079235	C	53	TTTTTTCTCCTCTCCCCCTTTTTTTTCTTCCTCCTCTCTTCtTcTCTTcTCTc	GGGBEFDFDDGDGD=DDCFFFAFF@FCFFC=FCCFCF@FFCFFFFBFFFBBC;	T	31	C	22
1	201079458	T	119	TAtattataataataAttaattatttttttataattatatttaaaattaAtaaaAtaaATATttAttttatttattatatATaTatatttAaaaTtatTtatttAAaaattataatatt	B?@BCEFFEEFFEGFFGGFFGGFGGEGGGGFGFFGGEGFGGGFFCFGGFFGFFFCGFFEGFGGGDGGGGFGGHFHHGHGHFGGFGHGHGHEFGG?GGFFHGHHHEEGGGFCGHGFH@<C	T	64	A	55
1	201197471	T	128	CtTCCTTTtTTCtTTcTTCTCTTCttCTTCtTTCTCTCcTTCCCcTTTCTCTTTCCTTTTTtTcTtctCCttttCCTcTCTtcCTtCCcCTcttttcTTtcCTtctCCtCTtTcTCCtTtTccCcttc	D?EEFFFFGFCGGFBBF5GFFFFGGGGFFFHFFGEGFFCFCDFFCFFEGFGFFFGFFEEFDHECFACAFEH=HGFFEBEED@DEEFFCCEE<GDHHCDE>CEEHBHEFHEEFDAFEFDDDC>>B=@A;	T	76	C	52
1	201868524	A	74	aaaaaaAAaaAAAAAaaAAAAAAAAAAAAAAAaAAAAAAAAAAAAAAAgAAAAAAAgAAAAAAAggggAgggAg	C?DBFFEFFFFEE<AD?B:EF@FFFCDC6FFE<FFFEEEDEDEDEDEE:DEDEEEDCDCDEFDD@BC<><?8?=	A	64	G	10
1	201868530	A	83	aaAaaAAAAAaaAAAAAAAAAAAAAAAAAAAAAAAAAAAAAAAAgAAAAAgAAAAAAAAAgggAggAAggAAgAgAAAAgAAA	CC@EFD?BFFFDFFEFFFFEAFFFEFFF?FFFFFFFFECDEEDE<BD=EE7?EEEEEEEE8@CABDDEC;C>?B9AB>A8CC?	A	71	G	12
1	201952574	T	87	CTTCCTTTTTTCCTCTTTTCTTCCTTtccTCccCCTtttttCctTCttCCCTTTCCcCTTCCCTctCTctTcTcTTccCTTtTCttt	EEEGGDBEEEEGGE>EDEEGEEG6EDFFGEGGGFDDFFFFFFGFDFG?FFFDDDFFGFDDFDFDFFFDGFDFDGCDEEECEBCB=:?	T	49	C	38
1	201970748	G	85	ggAgGGAAGAGAGGGGGGAaGGAAAGAGAGAGGGGGAGGGGGGgAAGaGaGGAAAAGAGagGggaAaAGgGAGGaGGAaaAAGaa	@DGCCCHHDHCHCCCCC@HG@BGGGBFBHCHCCCBBGCACBBBDGGBFBGBBGGGGBGBGDBDBFGGFADAFABC??CA?ACCDD	G	48	A	37
1	202194441	G	32	GGCCCCGCGGCCGCCGGGCCGCCGGCCCGCGG	BCBFGG;BEEGEEG?EE@GFCFFDDDFFDFBA	C	17	G	15
1	202197161	C	32	cCTtcCTttcTtcTttTTccccctcttttccc	CBDDFGGDDGGAFGDDGFHGHHGEHEEEEH>H	T	17	C	15
1	202276494	C	94	TcCctCCCtTcTtTCttCTCTtttctcccctTCCttctCcCtCtCcttccttctcccTctttctTttTctCccTcTTcttcttcTcttCcTtcc	@A<:FDDDGGAGGHDCGDGDGGGGBGB@BBGGDDGGBGDBDGDHDCHHC@HHCHCCCG@HHGCAGHGFCHCCCFBFFAF8CHHCFCHHCCEHC@	T	49	C	45
1	202287206	T	158	TttTCttTTtcTTccccctcttTTtCCttCCTtcTTCCCtTTTTCtTtcttcctccTTtttTccTcCtCtcTtCcttTcCtcTtcttcctttcttCcttttTCCCCCtTTTcctTCCTccctCTCctTccCCCTcTTCCttcttCcCCtTtTccCcCc	@CDEEEEFDDCEFDCDDDBDDDFFEEEEEGGFEDFFGFCCGFFFDE6EDEDDDECDFFEDFFEEFEGFGF9FEFDCCFEFFEFFAE?EEF>>EFFEE;<FFEFEEEEFEEEEEFEEEECEEBFEEDFEDDFFFEEEEFEEFDFEFDEEDDBC@?B8?B	T	85	C	73
1	202705455	G	55	cGccGccCCCCcCGCcCCggcCCcCGcGcgCGcGGcccCgcccGGGGCggcGGgc	=6BACBBDDD@BD<DBDDDDCCDCCCCACDCBCBBACCCDCCCBBBB6DCCAAA>	C	34	G	21
1	202735751	T	39	TcTTTTTTCctCtTCctttttcctttccttttcCcTttc	B:?CCEDFCFEAEEGFDEEFFGGFDFGGFEFFFFG;@BB	T	25	C	14
1	203003870	G	78	AaagaAaaAggaaaGgagAagaaAGaAgaggaGagAaGgGGAGaGAaGGGgAaggAAaggaAggaaAaAgAgaAcgAA	E@ADCGADHFFDDDCFDFHDFDDHDCHFDGECC=G@DCGCCHCECHECCCGHDGGGHEGDEGGFDEGEEGGGEFBFEB	A	45	G	32
1	203006179	G	73	AAGAAAAGAgAAGAAGGAAGAAGGAGAGGGGAGAAAAagGGAGGAAGAaAGgAGAGgAGggaGAGaAaGAGgg	@@<AHHH@HEHHDH;CCEFCHHCCGCH:CCCHCGFGGFFBBGBBGFBGFGBBCBG@EGB:FE5E9>B<CACDA	A	38	G	35
1	203032922	C	83	CCTCTCCCCCTCTCctCCcCccCtCTCtCTTtTtCTCctTTtcTTTCccTctCCTCcCcCTcTtcCccCTCCccTCtCCCtTT	AAFDFCDDDDGDFDDEDDDDDDDEDEDEDGGEGEDGDEFFGEEGGGBEEFEFCCFCECE<FEFEDCECCFCCEDFCFBCDEEC	C	50	T	33
1	203055101	A	62	GgGgAaAAaagggAggGgaggggAGgaaaGGaagaaaaAaAggaAagGaaaaaaaagaggga	D?<=>GEEEFCCCFCCECFCBCCFGCGFFGGGFDGGGGFGFDDCFGCFGBBGGGGGDFDDBD	A	34	G	28
1	203155882	G	43	ggggggcgcggggcgcggcgcggggggCgccCcgccgccCggg	BBC>FEGEG6DFF<CGFFGFFFFFFFGCGHHDHAH?GAGBFGG	G	27	C	16
1	203740615	T	55	ttctccTttttcctCttCCCcttCCCtTTcCCcttCccCtCCctTctcccccccc	C?ABCAEEDEEDDEEEEGGGDEEEGGFEDEGGEEFGEEFEFFEBDDFEEEEDECB	C	33	T	22
1	203799343	C	151	TCTcTTCTCTTCccCTcCTCCCCTcCCTTCTtccTTCCTCCCCcCTCCCCTTttTtCTTTCCTTCCcCCTCCCCTcTtTTTCCtTTTCCTCTCtCCCTcTCCCCcCCCTTTCTctCctTCTTtccTcttCTCCtctTtCCctCcCcccccc	A<B@FEGGGDGGBAGGBGGGGGGGBGGGGGGGACGGGGGFGGGBDEGGGGGGHHGHGGFGFFGGEGCCGGEFFGFBEAFFFFFEEFFFFFFFFIFFFFCFFFFFBFFFFFFFFCGFCHFFFFHCAFCHHEEBFHAFFGFGAGC@A=<<<>@	C	87	T	64
1	203807273	A	53	AgGaAgaaAgAAGgaagaaGggggagGGGagaGaaaaaagaagggggaggagg	@B>D@CEDHEHHBFFFFDFCFFFFFF>CCGFECBGGGGG>EDGGG<GHHGGGC	G	28	A	25
1	203832964	A	190	AGaAGaAGaaAaAGAAGaggaaagaGagAaggagGgggaGaaaaagAGGaGggGgaaGgaaAaggaAGAaaGGaggAAgGAGGAAGaaaaaggaAgAAGgaaAGgAaggAAGGAggAagAGaGagaGgaAgagggaagGaggggAgaggaAGaggGGgagaAagagaagggaaaaagagaaaagaggaaa	CC?>?C>@CCAABCBBCGDCFEEBFGFCFFCCFCGCCCFGFEFFFCDGFFGCCGCFFGCFFFFACFFHGFEGGFCCDFCGEDGFEDFFFFFCDFFCFFGDGGFGDDG9DFFGFEDDFGD@GGG@CGGDGFDGDCDFDCGGDADDEDGDDGFFGDDGFDGDGEHDGDGFDDDGHHGGDFDEFADBD>?=?C	A	101	G	89
1	204085609	A	148	AAgAAGgggAGagaAgAaagAggaaagGGgaggGAAgAagaGGgaaaagAGgAaAGgagGaaGagAAGgAaaAgGAaAgAAaGgGAGaAgAaGGaaGggaAGGgggaGAaAAagaGgAgAGaAaaggaaaAAgAgaaggaAGgGGagg	CC???B>A=BEBFEEFEFEDFFC<FFFGGFFFFGEFDFE;FGGFFFEFFEGFFFFGF?FG:EGEGFF<GFGGCGDFGEGECGGGFFGGFGEFGGGGGGG9FEGGAGGFEGEEF?GFGEGEFEEG=GBG>GEEGEGGFEEFFFDCBB@D	A	78	G	70
1	204161947	C	40	CcccCCtTtctcTctttccccCCtcttTtttCttTctTTC	A9BBDEDEEDEC;DEEFDDEEFFFEFFDFEFFFBDEFC@?	T	21	C	19
1	204210791	G	45	AggagaGgaggaAgAaGAGGAAAAaAAGAGAAAaAGAaAaagAgG	>@DFCFBCFCBFF?FFDEEDF@FFGEFDDDAEEGBDDGDFDA:<@	A	28	G	17
1	204216468	C	112	ttccTcCTtcttccCTTtCTCtCCCTCtCtCcTCTCtcTTCttTTTCtTCctttTtCCTtcTTCCTccCTTCTCCctTctTtcctcCTCCTcccCTtTctCTCCCTctcTCt	CC<>??AGFBGGBADGGGDGDGCDDGDGCGDBG7GDGCFGAEDGGGCHGDCHHHFHDDGHCEGDDGCCCFGDFCCCHFCHFHACHCCFCCF>CCCFFFBHCEBCBGBGBDBB	T	57	C	55
1	204230581	G	38	ggAAagaaagaAAgaGAagAaAaagAaggGgaaggaaa	=CEEFCFFFCFEECEIEFDEFDGGCEGADHDGGDDGC?	A	24	G	14
1	204379452	T	74	cTcccTCctCtTCCttCTtCcccTTcCtCCtTTTTcCtcCtttCTCTcCtCCTCCCCcTCTtCccCcTCTTTCc	A@BABCFCDFEEGGEEHEEEDEDDEE@FGEEEEDDDFFCFF@FFDFDEFFFFDF?FFEDFDFAEE@EECCCCB=	C	42	T	32
1	204399061	A	76	AAAAAGAAAgAAAaAAAaAGAAaggaAagGAGGAaGGaGGAAGGGAAAAGgaaAaaAaaGaAGAaAGAAGaaaAAA	AHHHHCBGHCHGHG:GHGGCGHGDDGHFD>HCCHGBCGBBGGBBBFGG?ADGHGGGGGGBGGBFFFBGDAGD:GCC	A	54	G	22
1	204399064	G	80	GGGGAGGGaGGGgGGGgGAGGgaagGgaAGAGgAAgAAGGAAAGGGGAaggGggGGggAgGAGgGAGGAgggGGGGGGGA	EEDEFEEEFEEEDEDDBEFEEDGGDDDF@EFEDEFDEEDCEFDDDDCEGDDBDDD;DDEDDEDDDEDBEDDDCDCBAA@C	G	58	A	22
1	204587240	G	84	AggAagaAGGGGgaGGgggaGGagGgAAAGAGGaaaGGAggaGaAAgagAagGgaAgaGaGAaAaGagggggggGAAGAGggAg	?BBEFFFEE=EEFECEFFFCEABFEFFFFEFEEFGGEECGGFE6EEGAGFEGEGGEGGDGDEGEDAGGGGFGECDEEDDDFFCD	G	48	A	36
1	204588140	G	166	AgAaAgggaAaagGAAGgGGaAAgAAAAggGaGaAgGGgagaGGagaggGAgGAGGGaAGGgaagAAgggaAaaaagAGGaAGgGagagggGAaGaaAAaAggAAGAGGGAAaGGAaAAGAGGGAAAagaGAAaaggGgaAgagGGAAAgaAGAGGGGGGGGAGAG	?>AC>GCGFEFEFEFDEFEEFEFFFFFFFFDFFFFFEEFFFFEEGFCFF@FGEFEEEEFCEGGGGFDFDFGCGGGGGDEEDFEGD=AGGGGD@FDGGEEGEGGBBEFDDD=AFDDEGEED?DCD?EEGGGDEEGGGGDGGDGAGCDEDDE@CCCABCBCBAB:AAC	G	84	A	82
1	204589101	G	78	aaGAggGAGaAAGgGaggGgGagGgggaggAaGgggaaGAgAagGGggAaAAaAgAAAaagagaagaagagggggaGg	DEBDCCG9GFE9HCGFCCHCHFBHCCCECDEFCCC7GFGEDEEDHHDD?GDEGEDECEFGDEDGGBGGDFDDCDCGG=	G	43	A	35
1	205028581	C	29	GCGGCCGCCGCcccCCgCGCCcCgGGCCG	EGEEGFEGGDEEEFEFFEDEDEFEBA>B?	C	18	G	11
1	205038731	C	29	cttCtcttttCtttttCcTcttccccCtT	CCCDDDEEEEDEDEEEDDGAFBEEEECFG	T	17	C	12
1	205116635	A	63	TTTAATTAAATTAtTTatTAAtTTTTaATTAATATTtaTAtTAattTAAAATaATtATAAaTT	GGEFFGE;FFFEFBGFGGG@EHFFCFGEFDEEEEFFFA;EGFEGHHFE=EEFGDFHDEEFECC	T	35	A	28
1	205280800	C	140	ACCCcCAAcACAcACCCACAaCAAaACcccACAcCCaCACCCCcAaACACCCAAaCCCCAAAAaACACcaCccaCacACCCcCCCaCACCACCcaCACacCCCcacACCacCaAcCccACaaAcacaccacAACcaCacC	AEFFDDFFDEFEDFGGGFE@AGFFEFFDDDFGFDGFEGFGGEGDFB9GFDDE:FBF5FCDFFF=FGFGEEGA5=G;EEGGG@DGGEGFGGEFGECFEFF@FFCEFEECFFEFFEEFEEEFFDEEED5ED@DFEBB;A=@A	C	83	A	57
1	205495392	A	103	aaAgagggGGaaggaGAAgAagggaggagggaaaggggAaagagaaGgGaGGAgggGGAggGAggagAaAgGAaaaGGGgaaGAgGgAaGAGGAGAgGGGGAA	AD@ABABCFFFEBCFHECCEFCCCFCCFCDCFFFCCCCAEFCFCAFGCEFGHDDDDGHEADHECDGD6GEDGDGGGFG?DGBGDDBDDGG@GFCF?CHGGCAC	G	59	A	44
1	205814485	G	222	GAAGGGaGgGagAGaGAaGAGGAggaAgAGGggAGaGGAggGGggAGAagGgaAGAgaAAGgAGGGAggAAGaaAAaaaAaAGAgAggAGGgggGGAGGgGGggGAGggaGgAagaAGGGAGaAGgagGAAGGaggaaaaaaGAGGaAGAggAgGGaGAggAAgaGGAAgggGgAAGaGaaggGagaaAAaagagggaaaAGggaggAGggGagAaaggaGG	@BB6<=?>CAEGF@DCHCCHCCHFFDHFHCCFFFADCCHFFCCDF?CHDFDEDCCGFDHHCFB?CCHFFHE>DDFHDECHEHCHFHGGHB?GGG@CH>CGCCEGCHCGGDCGHEGEHBACHCEHCGEGCHHC>AGFEEEDEECHCB?GBGGGHDBBE@GGEGG:AB?GGGGHB>GGBEBEEGGBEGEEGGEEG;BFGEDEGBGF9<GGBEGBDEGABCB@C?	G	124	A	98
1	207074905	T	102	CCttCTCTCTTTTccCTCcCccCCTCtCtCCTTcTTtTCCtTTcTTtTTCcTTTTtCCTTtTCccccTTCcCCCTcCtTTCCtTtCCttttcCTTTTCTTCt	A8AABGDGCGGGGFGBGDGEGGD7GDDDDDDGGHGGDGDDEGGGGGEGGDHGGGFEC@GGDFCFHHHFFCGCCCFHCEFFCCEFECCEEEE:BEGDD@AC?B	T	55	C	47
1	207087435	C	50	ccccccTTcctccttCctttcCTtCcttctcttcttcttctctccttccc	CCC???<A?@HABGFDAGGGBDDGDBG=BHCGDCHHCF@CCAH=CFICC:	C	27	T	23
1	207262980	T	87	gttggggttTtgggggtgTTgtGTtgGtGGGtgTTtgTGgGGggGtgggtGtttgggtgttgtgggggggGttTgGgtgtTttgtGg	CCC?@BBCCCDCDGFFEFGGFECGEFCD<CCEFHGFFGB@CBGFCEFFG@CDEEGGGEGFFFEFGFGGGGCFFGCAG?GFFFFHFBG	G	51	T	36
1	207504669	G	56	agaaagaggggagggggaaaGagAggagaagaagaggagaagaaggaagagggagg	AC@BDCDEFFEDFEBEBEEDHEFEFFDEFEEFEGFFFFFFEFEEGGFF?FFE@=?@	G	30	A	26
1	207510548	A	36	GGGGGAGAGAAGGAAGAAAAAGAGAAAGGGGGGGAG	FGGGFFGFF:FG>FFFFFFEEFEF:EEFFFFFCEBA	G	20	A	16
1	208200737	C	51	CgccCCGgCGcCgcCCcgcGGcGGcgGCcccGggggcCCgggcgcccgcGc	AFFGCDCFDBGEFFDDGFGCBHCBHGCDHGHCGGGGHCCGGGHGHHGGHAB	C	28	G	23
1	208219164	A	27	CCCACCAAACACAACAAAAcCCAACCC	DFFFFGFFFGE>EDEEEEECEEEDDD@	C	14	A	13
1	210856604	T	44	GGTTGgGTTGGTGTGgTTGTtGTGgtgtGGtTGGATTGggTGtg	HHEEHFHEEHHEGEHGEBG<DGEHGEGFGGFDGGDDDGEC>DA@	G	24	T	19
1	215741053	T	64	TTGTGTtGGTTGGtTGTTTTTTTgtgGTTtGtGgGGTGttGtTGttGTTgGTGTGgttGGtGtT	FFCGBGE<BGGCBE<BGFGFFGGGFG@EFFAEBGBCF@BEB?FBDFBFFFBEAFAFFEBA8?BC	T	37	G	27
1	216172380	A	61	GgggAggggGAGGGgGGAGAgaaaAgagaagagggaaaGgaggaaaagggagggaggggaa	EC@ADFEEFHEHHHFHHCHEFFFFCFFFFFFEFGFEGGHGGGGGGDDGG?GGDGGGGDGFD	G	37	A	24
1	218698728	G	86	GAGGGGGAGGGAAGGAGGAGGAAAGAAGAAAGAAAAAagGAGGAAagGAGGaGaGAAGAAAGGAAggGGGGgGGGgGgGAGAGGGa	=DGHHHHEHHHEEHGEGHEGHEEEGEEHEEEHDEEADFFGDGGDDFFGDGGFGFGDDFDDDGGDDGFGFGGFGGGGFFFCFCGFF>	G	49	A	37
1	219706428	T	239	CcCTTCTTcCTcCCTCCCTCTcTTTCTcccTTTTTCTTCTCcTTTtTCtCTTTCtcTCCTTTTTcTCCTCCTCCTTCTCCCTTCCCCTTCTctcTtTTCtTtTTCTTctTTCtTTtccctccTtttcTCCCTtcCCCtcttCCTtcccTCtctctccCtctttttCcttCTtttCcCCcccttTCTtcTCttTCttcttTTTCcccCCTtttCTTcCCTTCcTTtttCttTcCTcctcc	>:<BAAAFBGFBGGGGGFGG<BGGF>GBBBGGGDGFG6FGFBHGGGG>GGGGGGHB@GDGGGG?BGGGGGGGGGGGGGGCGGFGGGGFFFFA;CGHGBGGFHGGGFG?HGGGFGGHCBCGCCFHHHBGGGGGECGGGHBGFEFFGCCCGGHCHCHCCFHCHHHHHGCHHFEHHHFCFFDABCHFFFG?FFHHFFHHCHHFFFFCCCFFFHFHFFECEECEECFFGGECCCB7>A;=E@@	T	129	C	110
1	220239448	T	82	tcttctTCcttttcttTttcctTcccttTctccctTttcccTtTTctttcTttcttcTtttctccccCCtttccttttttct	AC??CCCCECDDDFEEFEEFFEFFFFEEFFEFFFEFEEFFFFDFFFEEEDEFEAFFGFFFCFFGGGGFEFFFGFFGFFFFFE	T	51	C	31
1	220298664	A	116	AagGgaAaaggagAagGAGGgGGgGagGgaaaaggAAGaagagAAagagaggaGaaggggagaagagGgggGAAaggggaaaGGaGggGgaaaagaagagggaggagaaaaaggga	CCCBBBC<<EEDE6DFGEGGFDFFGDFGFDDCCFFCFGDDDDFFFDFDFDDFDEEDDFFGEGDEFEFFFGGGFFEGGGGBEEGGE>GFBGBDEE;EEFEEGGEFFFFEECEEGBA:	G	62	A	54
1	221057646	C	85	tTccTTTcCTCTTTcCTctTtcTctTccttccTCcTcCCtCtCCtCttCCtCtCCCttctccctcttccCtTCcctttCctCtct	CAABFGGA?FDBGFBDH6GFGBGBBGBBHFABGDAGCCDHDHDDHDHADDHDHDDDGHBH>C?HCHHCCCHFCC>DHHCCGBB5A	C	44	T	41
1	221057739	C	81	CcgCggCCcGGCCGGCgggCGcCCGCCccgCGGcGcgGCCccCGcccCGGggGGgccGGGgGGGCcgcgCcccGcCCGCCg	DCBDFFAGDEEGGDEFEFFFEBGEEG5DDFEEEEEEFEFFEEEEEEDFCDEFDDGCEADCDDDDEDBEGEEEEDDEEDBAC	C	43	G	38
1	222697088	G	187	AgGGGGaGAGgGGAAAagGgaAaGAGAGGGaGAAGaGggaGAGAaAGAGAgggaggaagGGAGggAGaagagGaaaGAGgaAAAAgAGGagAAGGagaAagaAaaggGGAAgaagagggAGAAAAaaGaagGaaAGAGGgGaAGGaAgaGgAGgggAaAgAaAaGAggagGggggAgGaAGAaAggA	E@>6;;C>FBCACHFHFCCCFGFCHCHC?CFCHFCFCCCFCFCHFHCH;HCCCECCCFDCAHCDDHCGGDGDBFGGCCBDGHHHHDHC:GDHHC>GDGHGDGGGGDDCCHHDFGCGDDDHBGGHF>GBEGDBGFGBGBCD9GGBBGDDGBDGBDDDGGGDGFGGBGDDFDBDCDCFDAFF?D?C<?C	G	95	A	92
1	224001963	G	118	AGGaAgAGGgAAAaAAGgAGgGaGaaaGgGAGAGAGGggaaAGgAgaGgAggGAGGgAGagGAgGGGAAAAGaGAGgAGAGagAGAGAagaAAaAAaAaGaGagagaggaGagagagA	=;<CFFFBCEHH?FHH<FHCFDECFFF?FCHCA?HCCFGFE?CGGGECGHGGBGBBGHC:FCHFCCC?HHGCFBGBGGCGBFFFBGBGCGGGFGGGGGGBGBGGFFGFBG@FB?B:AA	A	59	G	59
1	224577595	C	30	cccccccccCCCCCCCCCCCCCgggggggg	C?::>?@@BFGFGGEGGGEFFFD8D@?9BC	C	22	G	8
1	224577599	C	25	ccccCCCCCCCCCCCCggggggggg	A???GFGGEGGGGFG9DDD;9C7C8	C	16	G	9
1	225439988	T	100	CCTTtTCttcTtCCTTTTTcCtcCCCCCTTCTcccCCTtCCccccCTcTTTttCcCTtttCtTcTttTtTtctcTTTtTcTCTTcccttcctttttcCcc	BB;?AEGCDGEDGGEEEFEGGDGHHGGGEEE>GGGGGEDGGGHHHGDHEDEEEGHGEEEEGEBHCEEDEEEHEHDDDECHDFDDHHHEDHGEEECEAC<@	T	54	C	46
1	225460626	T	29	TATAATAAtTTATATTTATATATTTAAAA	CDEEEEEDDDDDDDDDDDDDDDDEDABA?	T	15	A	14
1	225555602	T	42	TTGtggTtTtgttggGgttTtttgtgTGtTTtgggtgttttg	D>?A=CEEGBEEEF=G@EEGFFFFDFGGFGGDFGGEEFFEF@	T	26	G	16
1	225565073	C	47	cctCtcTtttCttTtttctCccCctCcTcctCccTtCCttcttcttc	C>@DFBFGGGFGGFFGGBGFBBGCHGCFCCHFCCEHGFH=BHHBHE>	T	24	C	23
1	225609884	A	39	GAaAagaaaaAAaaaGgaAaAaGGggaAAAAaGgaaAGa	;HFHFCFFFFHHFFFCDGHGHFCCDDFEEGGGBDGFF>@	A	28	G	11
1	227171739	G	68	GCCGGGCGGCGGCCGGGCCGCCGCCCCCCGCCCGGGGCCCCCGGCCCGCGCCGCgGCCGCGgGGgggg	@FGEEE?EEEEDGFEEEFFDFGDGGFEFFDGEDDDDDEFEEFDDDDDDFDFDEE>CCCBBA=C<=@;?	C	34	G	34
1	227299978	C	96	TCTTTTTTTTCTCCCCTCTCCTTCTCcCTTCCtTTCCCCTtCttcccCCtTCTCTTcCCCCTTTCTtTCTtTCcTttCCcCCCCttTttCCTCCtt	BGDEDEEEEEGEGGGGEDEFGEDGEGHGEEGGEEEGGGFDEGECHHH?FEDFDFDDHBFDDDCDFDEDFDEDFHDEEFEFFCDCAAB@?AB@CC@B	T	49	C	47
1	227381373	G	28	TTGgGTGTTGGTGGTTTGTTGTTGGTTG	EEHCHEEEEHG<GHDEDCDDGCDD@CCC	T	15	G	13
1	227387361	A	31	AGaggGAggggaggaaaAaaagagagaagag	>5CECCHFDFEEFDEEEHEFE?FEFFFFEFG	A	16	G	15
1	228289976	A	32	GGGaAGGGGGgGGGGGAGGAaAGAGgGGGAgA	CHHFDHHHGHDFGGG=DGBBFDGDGDGGGDCC	G	23	A	9
1	228327999	C	84	cTctcctTTtcCCtttCTCctcttccCCcCtTCcctctcctctCcTTccTTttcCtcccCctccccTtTctcTtttttCtccCt	@>ABDCDF:DCDDEED8FDDEDEDDDDDDDEEADDEDEDEEEEDDGGECDGFEED=EE@DEEAEE8GFACFEFDFEDFCED<@A	C	45	T	39
1	228402508	C	69	CTTcCCCCCTTTCTTTCTtTTCCCTTTTCCCTCCTTCTcTTCCTTCCtTtCTTCTCCTCTCTttCTcTT	DGGFEDDDDEGGDGGGDFFGG>DDGGGGDDCDCCF@CFGFFCCFFBCFEFCFFCFCCFCECGCCAEBBC	T	38	C	31
1	228407010	C	40	CTTCTCTttTCCCTCTCTTtcTcCtCCTCCCTCTcCcCcC	DHGDGDG@FGCDDGDGDGF9EGECFCCFCCCFCEECDB=?	C	23	T	17
1	228407265	G	35	ggaAggaaGgGaGgggaaAggAggGgggAagggag	@CFDCCFFHCGFFDBDGGEDDFDA<DD?EGDCCG=	G	23	A	12
1	228482569	G	178	GgaggAAAagaaGaagAAAgggAGGgAGaaGGaaggaaGaAgaAGagGgAAgagaGAgGGgAGgGAaggaAGGggaAgAaGgaGAgaAaGGGaAGgAgAAggAAGAGGggAGGAaaGaGAGgGGAAGGGGggAAagaggAAgAAAAAAagAAgGAgGAAGGaaagAGGAaGaaAAGGG	@A?A@CBDFCFG=FFBHHHBCCHCCCHCFFCCFFCCFFCFHCFIDFCBCHICFCFCHCBCDHCCCGFCDFHCCCDGHDGGCDGCHDGHGCCBEHCDHCHHDDGGBGBBADGBBGGGBGB=BDBBGBA@BBEBGDGDD;DG?DGGGGGGGDGGDBGDBGFABGGFCGACF@><@BA@??	G	90	A	88
1	228526011	C	107	cctTCtcCcTCCCcCCtTCCCTTcTCTTcCTTTtTcTTtCTCcTTcCCtCTCTcCCTccTtCtcCttcttTccCTcCTtTTCtccTTctTtcctctctCtCCCTctt	>?EFDFADAG8DDBDDGGCDDGGBGDGGBDGFGGGBFGFDDDCE:CCDHDGDGCDDGCCEGDHBCHHBHHFCC@FBCFIFCCHCCFFBHFGCAHC;CHCHDABC@C>	C	55	T	52
1	230497940	G	98	GGTTTTgTTGGgGTTTTGGTGTtTTGTGTGggTGGTGGTTTTTTGTTTTTtGTtTGGgTTTtTtTGTttgTGtTGGgGTGGttTTGGGGGTTTGTGTG	B;?FFBFFFEEFEEFFF@E8EED;FEEEFAGGFEDFEEFEFFFEDECDDEEDEFDDDGDEEFEFEDEEFGCDDEDDCDDDCFFDEDCEEB??BAA>CC	T	57	G	41
1	230498232	C	25	ccccctttcctcttcccctcccttt	AADCEEEEFFEFEEFFFFFGGEEFF	C	15	T	10
1	230883466	C	87	TttttcttTtTtttttCCTtTcccCcttttctttctcttttcttcttctcTtttTtcccctTcCttccCTcccccctttttcttctc	@A???<BEBDBHGGGGFGEGFBBBCBGFGGBGGEBGBFDGDBGGBGBBGCEGGGEGCCBBBC6FHG6CFE?CCCCCIHFHCCHHCFA	T	54	C	33
1	231956086	A	34	aATTTaATtAtAAAaAATTAttTtAataaTaAaA	DEFFFF9FH:GFFFGF:BEFGHEHDGHGGFE:BC	A	20	T	14
1	232581247	C	38	CCGGCGgGGgCCGGGCGGCCCGCcgGGCGcCGCcGGCG	ADCCACECCGDDCBCDCADDDBDEFBBCBECBC:B?C?	G	21	C	17
1	233362930	G	74	AAAGGAAAGGGAAAAAGAAAAGGAAAaAGaGAGGAGgAAaAaGAGGAAAAGAaGaaGGGgaGGGAAGggAGagg	EFHC<HHCCCBHHHHHCHHHHCAHHHGHCGB;BCGBDHGFGGBGBBGGGGBGGAGGBAACGA>@E:==<CCDAA	A	42	G	32
1	234546245	C	65	CtTTTcTTcTcCcTCCcCTtTCTccTcTtTCtctCTCTccTcCcTTtcCtCctCtttTtCTTctt	DBBFCCFGBGBGBGGGBGGGGGGBCGCGHGGHCHFFFECCF@FDEFHCFHFCHFFHHFHFCD;AD	T	35	C	30
1	236557771	G	106	AGAgGaAAGggGAAGaGGGGgagAGAAgAGAagAAGaAaaAaAaAAGaagAAGaaGAGaGGgaaGAAgAaAaaaGAGGgaGaAGagGGgAGAagggGGagaAgaaa	B?@AGFEDHCCHCE>FGFHHCFCEHEBDEEBGDBE6GEGGEGEGC;GFGDDDHFGHDHGGGDGGFDDCCGDGGGGDGGD<FGDGGDGGDAGCGBDDFG;B?@>@?A	A	59	G	47
1	236902560	C	76	TCCTTCTCTCCCTCTCTTTTTCcCCTTCTTCTCTTTTTTTTCTCTtCCCTCCCCTCTcCCTcCtCTTttCTTTCCC	B5@BCFBGFGFGBGFE?BDEEDDEGEEFEEEED>EBE?EBEFDFDF=DEEFEEFEEEGDEEGDFEDDFFFDD@=A?	T	40	C	36
1	236902955	T	52	CccccttttTctCtcctttttCctcttttctcccttcctctcttttcccttc	AAACBBBCEGFEGEF9EEEEEBFE=EEDEFDFFGEEGGFGEFECFFGGGFF?	T	28	C	24
1	237551376	T	60	TTTTTATAttATATTtTTtTTTATaaATTTatATATAtTtaTTttTTAAAAAaAAtatTT	=>ACEDEEDDEC7EEDEEDEECDEEEDECDEEECDD;DDEFDDEEDDDDDDDEDCDB<AC	T	38	A	22
1	237670140	A	85	AagagaggagGAaAAaGggagGAaGggAGgggAaAGAAGagggaggaGGagaaAgGgaagAgaAgggggagaaagaaGaAggaGa	CCCCAECC>ACHFGHEACCFCCH?CCCHCCC=GFHCHHCFCCCFBDGBBGDGGHDCDGGDHDGGDDCDDGDGGGDGHBGGDDC??	G	44	A	41
1	247615252	G	170	gGGggGAagAaggGAgGGAGaGGgGaggGgAagGaAGGgGgggGgGAAggaagGAggggAAaAAgGaaGgggAagGAGagGGAAGgaGaaAGAGaGgAAaGGgggaGAggggAGGGGGAAgaGaAgggAGgGGGGAaggaAgGgAgaagagAAgggaAgGAaaaGGagGa	B;@CDFDFDFFFFGEFGEFGBGGFEFFFGFEFFBFFGGCGFFFGBGFFFFFFGGFFFGFEFGFFGGGGFGGGFGGGFG8GGGFFGGFGFGFGFAFGGEFFGGGFGGFEGFF=EGGEDFEEGFFGEGEGDFGBFFFEGGGGEGFGEGGGEFGEEFGG?EGEDFGEGFF@BB	G	104	A	66
1	247978135	C	68	AAAACCCACAAAAaACAaCcCACAcCCcACCacccACcaCcCAaACacCACaCaCAcCaCCcaccCaC	B>BEGGGEGEEEEEEGB@GAFEGEEGDEEGGFDDAD:EFFEFD;DFGEFDFFFFFDEFFFFEFDDFBC	C	38	A	30
1	247991718	C	59	AAaCcCAAaACCCCCCACACaCaCAcCAacCccAccCCAcAAcCaAcCcaaacccaccc	@=>DEF?@FCAEGGGFEBDFFGFGE>GDGGFGGEFGGFEGDBGDFDGFGGGFGGGGF?:	C	35	A	24
1	248112754	T	90	TcttttcctttcttcTtctctccctctttcTTTTtTtttTTctTTccccctcctcTtctctttcttcccTTTcTTTctCTtcCTTTTTTc	CCCC??A:B@ACCBDBDBCECEEEFEDEDDBEE5DEEEEFFEEBEFFFFFEFFEFFEFEFEEDEEEFFFFFFFCCECFFFFGGEFFFDEG	T	57	C	33
1	248138531	A	76	GGaggAgaaggAaaAGggagAggAgggggAAGggggAGGagagaaGgaaAAAgagAaGgAAAgaAAGAAaGGaaGG	@>AAAEBFDEFFEF=BFFCFHDFEFFFFFHGCGFGGHCCGGGGC:BGFGGGGGGGGGBDGFGGGFGAGDA?<:???	G	39	A	37
1	248166472	C	349	CCCTTCTTTCTTTCTTCCCTCCTCCTCTCTCCTCCCTTCTTtCCtTcTTTCCCCCCtcCCCCTCctTCTTtCtTCTcTCCCTCtTCTTctttTccctcCTctTCCTCCTctCcCctCctTCTTccttCCCtTTtcCtcctTTCttTtTTtcttcttCctcCTcctttCTCCcccCCtCCttCCTCTtTCTCcttCcTTCCccttTTCTtTtctcTCcttccTtcTCTcccTtcttTttTtttCCCctTTTTcttcccCCTCccTTTTCTTtctCttCctcTTTCTCCTccTtccCCCTtcCccttctcTTCtctTCcCtccttCCTtctTtccTcTtcttTCccCTcTT	DBB?=BCEFFFFGEGGGGGGGGEFGFGGDGGGFGG7GDGFGEGGEGFG8>GGGEGHEFGGGGGGFEGGG:EGECGGFGGEGGGEEGGFFEEEGFGFBFGFGEGFFGGGGFEGGGFFGGEFFGFGGFEDGGFGGFG8FGFF=FGF>GFGGFGFFGFFGGFGGGGGFFFGGEGFGGGGEFFFFGGGGGFGGEAGFFGGEDGFFGDFFFFEB>FGFGFAG6FGGFFGFFFGGGFFFFDFFFFFFFFFFG?CCFFGFFHHHFFFFCGFFFAFFFFGCFFFFGBGFFFFFFDFGGF6FFFFFFFGFGFFDGFFFFFFGEFCGFFGEEFEFEFGFFDFFFEEBBA@CA@@@?BA?	T	177	C	172
1	248166526	T	269	TTcTTccTTCTCcCTCTtccTtCTTttccCCTCcCctctCTtccttCctCTCtttCctccCccCcccTTTtCCCCtcctttTTCTttCCCCTCCctcTccTttCCCTCTCttCcttTTTCctTttcctctCCTctcCTtTctccTCctccttCtCctccCTttTCtCCcttcttctccctcccttCCtccCttctCTCcctCcCTcttcTttctccctttCtctctttcctTcctcccttcctcttccctcccctctcctCtccttcCc	BBA>>AC@=@>B?CDE<FGBDE?>DDDFFDEEFEAFEFEGEE7FEEGFDG;GEEEGFEFFGEFGFFFEEEEGGGGEFFEEEEEGEEEEGGGFFFFECEFFFEDGGGEGEGEEGAEEEEEEFEEEEFAFFEG@EFEFG>EEEEGFEFFFFFFFGFGGFFGEDEFEFFFGGFFFFFGFGFGEGGGFFGFEFGGFFGFGEGGGFGEGEFFFGEFFGFGGGFFDGFAFGFFFGDDDGFFFGGGEFGFGF>GGGFFGGGFFFFGFEFFBAA:?D	C	145	T	124
2	1079143	A	86	GGAAGGGGGGGGAGGGGAGGAGAAAAgAAGAGGAAaGAGGGAGgAGGAAAGggAAgGGGGAAGGaAGGAaAAGAaAagGAaGagag	AC6>BGGHHH>HFHHHHBHHEHE6EDGEDGEHHEEGGCGGGDGGEGGBDDGEGDDGGGGGDDGG9DGGDCCCGDEDD;FACEB@?D	G	47	A	39
2	1093965	G	112	GgAAgAGAAgGGGGaGAGGgAAGGaaGagGaGAGgggGGGAGAagAAgGGGGgGgGgAAgGGGgGGGgAgAaagaGAGgaggGGgAgAGAaAaAGGAggGgggagaagaggg	EABCF;FEEEHHHHEHE>GEEEGHEEIDDHEHDHGEAHHH8HEEEEEGHGHHFHGHFEEFHHHFHGGFDFDFFEFGBGFEFFGGGDED?DEDFDGGDGGFADFFE>A@CDCC	G	72	A	40
2	1457364	A	103	GAAGAGAAAGGGAGGAAAAGAAAAGGGAGAGGGGGGGgaAGGGGGGgaGGGAGAaAagaAGGAAGgAgagGAgagAGGGAAAAAAgAGAAagGaAGAaAAGaa	@DFEFEFFDE<EFEDFFFFEFF=DDDDEDE<DDCEDDGFEDDDD?DGFDDDDDEEEEFE:C@DEDFEFFGCDEDFEDCCDDDEFFFCBDBA@A:AACAAC?CC	A	52	G	51
2	1460004	G	63	ggggtGtGgTgtGggTggGTTggtGGTgggTTTttgGtGTGTtttggggGggttGtggTgtGG	BAAABBEDFCFEAEFGFFEB?EGFE;FFGFBFEFFGEFEFEAFEFEFGFDGGFF@FFF?FDCB	G	38	T	25
2	1499899	C	128	tcCCCcCCtTTCtcTtcCTCCCtCtTTTtCtCCCcccccCCCctCCTcTCCCtcTTccCCccccCcCCCcCcccTTTctcCcCTTcCCctcTCcCcCttcccTtCccCccTCCCTctTCccCTCTtcT	C:ACCCDCGGGCGBGGBDFDDDGBGGGGGEGDDEBBB>BDDDBGDDDCGDDDGAGG;CDDCCCCD?DDDCCBCCFFFCHCCCCFFCDC;HCFCCCBCHHCCCFHCBCCC5FACCFCHFCACBEBCC;?	C	87	T	41
2	10262859	G	129	GAaggAGAggaAAaAgGaGaAaGAAgagGGAGAaaaaAGAGgGGgaagaggggagAaGgggggggaAggaAGaggAGGaAAGgAggAAAaaaaaAaaggGaGaggaGgaaagggAgggAgAAGgaagGg	BC=>ADDEFFFFFFFFACDFFFEFFFDFE@EEFFFFFEE=EFEEFFFFEGFGGFFFGEGGFGGGGEEGGDDEGGG@EEFFFE8EGGFFCDF8GGD=BGGDEDGGGDD8DGGG8GEGB@EGEEDDEGFCE	G	66	A	63
2	10563236	G	97	AgaaGaGGGGggGGAgAAgGAaaaagaGAGGaGgaGGgaGGGgaAGAagGggaAgaggaGGagaGgaAaAaaggggAgggggagggagaggaggggg	<CCDCDEDEDDFEEFEEFEEFEEECEDAFEEEEFEED:E=EEFEFEEEAEGFFC?F@GFEEFFFE>EEEEFDGF7E<GEFF:F7GGFE>E7DDE5>@	G	59	A	38
2	10930903	T	213	CctctcTCTtttcCtcTCtTCcTtTcctccctcctctccttTtCCTTTtCCTtCCTCTCtctTtttCTTccCcctcTCttTccttccCTccCCttcTCtTttttcTctttcTtcttttcTTcttTccCCTtcCTCTtcTttttttcctttcttcttctttcccctcctcctctttttctctctcctttcctctctttctcccttttccccccc	DCCACC>?=ACBB@AB?BBACECEEEFEFD>DFFDEEFFDEEEGGEECEGGEEGEEGEEEFEEEECGEEFFGFEEFEGEEFEFEEECCEFFGGEFFEEDEEEEEF9FEEEAEEFEEEFFEEGDFEGFFGCFGGEFEFGEFFFFFFGGEEFFFFGFFGFFFGGGGFAGFGGFFFFFFEGFGFFFGFFFE>GFFDGBFFGFGGGFFFBGGGEB9B	T	116	C	97
2	11702661	A	59	ACACacAacaaaAAAcAcCcAAcaAAccccaAAcACAaaCCaCcAcacCacccacAacc	C@?BA9@ECD@EFFFDED<DEGDDEFD?DDEFFEFGFDFGEFF=BEFEFEE;ECAD<D>	A	31	C	28
2	17773524	G	32	AggAgGGgaaaAgAgggaagaagaaaagagga	?AAAFHHFFFFEFEFFFEFFFEEGEFGGGGBB	A	17	G	15
2	20173255	A	36	AACACCACAAAACcAACAAACCccCCCAaaAAAACC	EDGEGGEGCCD;FGADFDDDFFGGFDFCFEBA?>B<	A	20	C	16
2	20824559	C	59	CTcTtTcCTttttTcCTTCccttCCtCtTTCccctctcCccCtCcTccCcCcctcccCc	8BFEEF>DFDEEEGCDGGDFFFFD>EDFFGDFGG>GFGDFGCFCGFHGCGCGGFGGGB<	C	36	T	23
2	24423473	C	124	GCCCGGCCcCCGCcCcGGCCGCCGGCGcCCCCccCCGcccGGgGggCgCcgcgcCccCCCGGCGCccGcccGCCccGgcGgcGCgGCcGggCcCggGgCCGGCCGgCGGcgGGcCGgccCGCcg	CDAAEGEFCDGGGD@DFGGGGGEGG:FDGGGGDCDGGEEDFFGFGGGFGEEEFDDDDGGGEFFG5EEFEEEFFFEEFFEFGECDGFDEFGEFEFGGFFFFFFFFFEFFEEGFE?EEFDDFFC?D	C	72	G	52
2	26781247	G	78	GCGGGCGCGCCGCCCGGCCGGCGGcGCCcGGgCCCGCCGgCCgccGcCGGCCgGCCGGCGCCGCGGCGCCCCCCGGcC	C@BHHGGGHGGHBGGHHE<GHEGGE>ADEHGFGFGFAFGG?FEEEGEFGGFFG5FFGGFGCDGFFFFCFCDDDBDD@C	C	43	G	35
2	27260957	C	91	TCtcTtctTttttCctTtcTttTttcttttTTttcCcTtTCCtcCtTttcTTtccctCTTCcTccTtCctCTtTCTTtCcTTcttTtTtct	B<CA?BBCDEEEE@:DDEDEEEEEEDEEEEBEEDDGDEEEGGEDGFEFF?EAFCDEFGEBGDDEEDFFEFFDFDECDFFEDDEFECDC??B	T	60	C	31
2	27323385	C	104	TCTCTtCCCCcTTTCCCTTCCCTCTCTTTcTcccttTTTTtctTcTccTCctCcTCCTTCCTTttTCTCctctcTTCTcTcCtTctctCtccTtCTCtTTCctT	CCFDGDDDCDGGHGDCDGGDCDGDGDGFFHGHHHDD>GGGDHEGHFHGGCHECGFCCFECCFCEEFCFCGDHEHFFCF?FDCEFHEHEBCFGFABDB?CDAC@A	T	55	C	49
2	27346810	A	60	AAGAGGAAGGAGAGAAGAaaGgAAaGgGGAAGGAgGaGGaGGGGGGaGGAGGaaGAGAAA	AFGEGDFFGGFGFGFFFEFFGGEE;FGFFBEFEEEF;FE@FFFFEFEFEDDDBACBBCBC	G	32	A	28
2	27801759	A	134	aggaGagGagAgaAgGgGgGaGaAaagAgAaagAaaGGGaGAAGgagAGGGAGaAagGaagAaGAGGgggGGgGGAgGaggAAGGGggGAAgaGGgaGGGGGAGAAAgAGGaaaAGAAGGAAGaGGAggaAGGa	CCAAFGEHFFEFECFHFHFGEHFEFFFDFEBFFBGGHHDGHEEHFGCDECHDHGEGGHED;EDGCFHFGCGG=GGDGGGG<DDFGGHHGDDGGGGGGGGGGG5GDDDGDGGEGADG;DFFCCGEFFBCBA@@DB	G	75	A	59
2	28796182	G	40	AggGaAaAGgGaaaaAgaaAgaagggaggaaaaggaagaa	>CCEFFFFECEFFFFFCFFFDGGDDCECDFDDGDDGGCGD	A	24	G	16
2	28802355	G	42	CGGGCgGCGGGCCCgCCgGcGGGCCgGcGCGGCCGCGGGGgc	@FGGGFFGGGGEGGFEFFFEFAFFFGFDFFFFEEEDDBBCB;	G	25	C	17
2	28827026	T	31	CctCtttttttcttTttTtcTTctccctttt	CBFFEGGGGGG@GG=GGBGAFFCHCCBHHHH	T	22	C	9
2	28975107	G	27	ccggggccccccggcggggcgcgcgCc	CEGFFFFFFFFFFFFFFG;D>FFGGCC	C	14	G	13
2	29041877	T	31	TTCTTTCCCTTCTCTCtcctCCCTTcccCTT	FFGBFEGFGFFFFFFFEGGFFEE;EGGGEB?	C	16	T	15
2	29092679	T	120	cttctttcTcCtTTttCCTtTTCcCCTTTTCCCCCcTTCTCCCCTCTCTCTCTTCTCTccttCCCcTtTTttCTCTTTTtcTtTCCcCtTCCCttTTtCCcCcctCTCCTCtctcTctcc	@ABGEBDFFEFEFDEEGGFDFAG=FFFBFFGGFGEFEF<EDEEAFEFFFDFGFFGDFFGGFFFEFGFDAD:?8EFEEBEFGEFEAEBFAEFEEFFEDFFFGEGGFEFEFDCACBD@CCDD	T	61	C	59
2	29092850	G	240	GGTtTgTTGgGTGTTTTGTGGgTTGGgGgGTgtTTGggGGTGTGtTGTTGGTTGGgGTggTTGGGGGgGGTTGGGGgGggGTgGttTTGTgGTTGTTGgGGTGTGTggGGgtTGtTTtTtTTtgttGgGTTGtggGTTGGggGTGTtggGTTGgTTTGGttttgTTtgGgGtggttGTgGGGTGTTtggGGTgtGTTTGGGGGTGGtTtTGGTGttTGtgttGGGgTgGGgggGTttgTt	>@DEECFCECEFEF>EFEFEECEFFFCECDCCGEFECCEE;EBEGA;FFDD@FEBDEFD?FEECED;DE9DFED;EDEDCEECA8HFFEFDEFDEFBEDED@EFEFDDDDDHEDCEEHB:EEHDHH>DDBDDHDDDEEADDCDBDEIDEDEED?EEEDDEHHHDAEHDCDDHD@HHDECDDDEDEEHDC;DEDHDEEEDDDDDED@HEHECCECHHDDFDCHEDBAB?B@??<>CC@<C@	G	133	T	107
2	29296870	C	154	ttcctCTTtttTTCTTcttccTTCCCCTTccTTCtcTTCtCTCtCcTTttCccTcctcccTTCttttctCctcctttCtctTTctTccCCcTCCctccCCtTtcCccctctCTctcttccttTTCcTCtTtcctccCtCtCtcTTTTcccttcT	A5A??B??CCDDDEEECEDDCEEGGGGEEADEEBEDFEGE>FBDGDFFEEGDEEDDEDD@EEGEEFEEFGEFEEFFFGFEFEDEFEEDGGEEGGEEEEGFF=FEFEEEF@FGDEFEFEEFFFDDFEDFDDFEEFEEFFFFEFEDCDDDDD?A>C	T	79	C	75
2	31424885	C	92	ccTctCTTctttTTCTTTCCtCTTCtTttTcTTtTcttTcTTtTTCtcTtCTCCTCtTCCctCtTCTcTtctTTTccTCCttTTTTTCTTTt	CCA;GDGDBGGGGGDGGGDDG@GG?HGFHFBGGHGCHCGCFGHABCGAGHCFCCFCHF?CAHCHFCFBFHCFFFFCCFCCHHEEFF6DCDAA	T	61	C	31
2	31876492	G	73	GGAGGAGAGAGAGAGGAGGaggAGgAGAGaGGgagAAAAgaAAGgAAGGGgAagAAGGgggAaagggGGAAag	BAFEEFEF?FEDEFEDEDEGEGFEGF9FEFEEGDGFEFFAFEEDGEECBDGEEBEEDDGFGEGGEEGDCBDB?	G	41	A	32
2	32707476	T	41	GGGGGTGGTTTTGGTgTGTTTTgGGtGTGGGGTgGTTTGTT	?>EEE@EEFFFFDEEGEDFEADGDDEDDDDDDDGCDEEC@A	G	22	T	19
2	32715095	C	91	CCCCTTCCTTTTCTTCCCCCCCTTtCTCCTTcCCCcCCTTCctCTTTTTTcTTTTCCCcccCCTTCTTTccTTcCtCTCtCTCtCTCTTTc	GEFGEEGGEAEEED;GGGGGGGEAEGEFGECGFFDFFFDDFGFECDDDDDGDDDDFFFGGFFDDDFDDDGGDCGFFDDFEBBB@9AAAAC@	C	48	T	43
2	33752152	G	34	TGGTTtTGGTGTTGTGTGtTGTgTGgGGTtGGgt	CEEFDEFDEDBFFEFDEAFEDEFCDGDDDFECBC	G	17	T	17
2	33759563	G	39	GGaaaaGggAgggggaGagagaagggaaaggagggggga	@<?DFEBBCHCCCCCFCFCFCFFCCCGGF@DGDDBDD8F	G	24	A	15
2	36668395	T	72	TAAAATAATATTATTTaAAAATATAtaATTTTTATATAATTTTTAAaaatAaAtATTtttttATAAaAAAAA	BHCHHGGHGHHGHGGGGHEGHGGFFF<HGGGGDFFGFGDFFFFFGCGFGFGDEFFFFEFF=EDDDCB;DBCA	A	39	T	33
2	36771701	C	43	cAaaacaaCaCaacaaacccAacCaaaaCaaaccaccccaccc	?>??BBCDEFGFFFFFFFFFEFFGFEGGGGGGGGGGGGGGGGF	A	23	C	20
2	36808732	T	80	TTGtGTggggGGtTggggGTGgttTtgttGtgGtggGtGgtTtgGttttGtttggttgTgGtggTggtgttggggggggg	BB@AB?CCCAHGDFFFFFHEHFDDEDFDDHDFHDAFGDHEEDDFHDEDDHECEGGCEDEGHEGEDGEEGEEHFGGEFGEB	G	46	T	34
2	37094945	A	42	GAGGAAGAGAAAGGGGggaaaGaAgaAgggAaAGAGaaAGga	GEGFDFGFGFFEGGGFFFFFFFFEGFEGDEEEEEEDBBAC>B	A	22	G	20
2	37406680	C	152	CcCgcgGccGCCGCCCGcGCCGggcGgcgCCcgCGGcgcgCCGccccGgCcCCcGGcgCgcCCcgCCccggcgGCcgCCgGgCCGccCcCgcGggggccCcgccCcCcGgcggcccggcccggCgccccccGcgcccccccgcccCCcccgc	;D?ACB@EH@F8EEEFDGDGFEEEGEFGFGFGFGEEGFGFDFEGDGGEFG?GFGEEFEEFGGFFFGGGG@FGFEEHFEFGDGDGEHHEHGGHEGGFFHHGHDEHFHGHEGHGGHHFGGHHFGGEGHGHHHHDHGHHHHGGHGHHHFBHGFBD	C	97	G	55
2	38178362	T	29	TCTCCCCCCtCCTTCccCCtTctccTTCt	CGEGEGEGGBFADEFGGFFECGCCABAB?	C	18	T	11
2	42282632	A	39	TAattataAaAaatAtaataaaTAattaataattttatt	<?FEDEEEDEEDEDEEEEBEEDFAAFBFEFFFDEFEFCA	A	22	T	17
2	42579743	T	94	TCTCTtTcTTtCTTCCCCttCTCTTTCCCCCTtCCTCCTTCTTTccTcTCCTTTttccTCtctCtcCTCTttTTCctTCttTtTCTTcccCttc	=:>GEEEFEEEFA=HGGGEEGEGEEDGGFFDDFGGEGEEE?E=EGGEG@GGBDDF?GGDFFGFFGFFDFDFEDDFG=DDDEDFCFCDFFEE@@C	T	52	C	42
2	42997614	G	92	GGGGAAAAGAGAAAGGAGGAAAAGAAGAAAAgGGGGAAAAGgGaaGgAGGAAAaAAGGAAAgaAGGGAGAgAGGGAGAAAagAGGAAgAAGg	BB@?<BFBEEEFFFE8:CEFFFFEF:EFFFE>DEEEDDEEDDDGGDDEDDDEEGEEDDEECD@ECDCDD@BDCDCECEEEEBDCABA<?CA?	A	50	G	42
2	43011169	G	47	tgggTTgttgttttTgtgtgGtgtttggttttttgtgTgtggtggtt	AA=CDEFDDFEEEDFFEFEFDEF:EEF=AFFFFEGEGEGFGGFGFEE	T	28	G	19
2	43015814	G	48	ggGGaaaagaGggAgggaaggggggagagaAaaGAgAaagggaggagA	CBCBFFFFFFCFFHFFFFF@FFFF@FF>FDHFECGDGGGFGGGGGGGF	G	27	A	21
2	43872032	A	29	ggggggagagagaggggaaagaaagaaag	AACEEEFFFFFFFFFFFFGFGGGGGGGGG	G	16	A	13
2	44016885	C	84	CCGCggCcGcCCGGgcgcCCgccGccgGGGcgcggcgGccggcGCGgcggcgCccgCgccggCccgcccgcgggcCgcggccgc	:@@>DGED9<FGGFEDFDGGEDDEDDEGGGDFDEFDDGAAFFEGGGEEEDDCGEEFGG9EFFGEEF>EDGEFEG:FGEGGE@@B	C	44	G	40
2	44071625	C	76	cgccAAAAACACCCaAAAaaaACCaCCCAAcACACAAccCacCaaCaCcaAaAAaaacACCAaccACAaAcAAACA	D9EFEEEEEG8GG>DDEEAADEGGCGGEEEGEGE:EDHGGDHGEDGEFGEDEDDEEFDDFFDEHHDFDCCFBCDD@	A	44	C	31
2	44101538	C	120	TTCCCTTTtCTCCCCTCCCCCTTTCcctCtCCTtTCCcTcCtCccTCtCTCTtcTTTtCTtTtCCttcttccTTtctTccCCtTTTctTTcccTttcctCCccTcctCCttCCTCttccC	DD@A:@@B@GGGGGGGGGG@GGFHFECEBEDGFEGDGFGEEFGGG8GFGEGGF?GGGFGGFFF=GFFGFFGGF@FDFFFGCFFFFFGFFFGGGFFFGGFFFFGFGFFFEFFEEEFCC>AB	C	62	T	58
2	45645512	C	190	CCTtTtTTCCtCTcccCCCtCTCCCTCTTTCCTCTcCtCCCTCTccCCtcTcCCCTTCTCTtCCccTTTcCCTCCcTTctTcTCTttTTctcctTctctcCTTTTCtTttttCcTCCTttTcccCTtCcTttCtttTTCTCCtcCCTcTctcttCTcccttCCcTttCcTctctcttCccCccctTttcC	?C<EEHFGGGGGABBBGGGGGGEGGGGGGGGGGGEB<GFGGFGGBBAG?B?BGDGGGGFAGHGGBCFFCCGDGGGCGFCHFC?GGHHGGCHCCHFCH?H6FFGGGFHGHHHGGCFFDE<H<CACFFHGCBHHFHHHFFCFFFI5FFFCFCHBGHFFCCCHGFFCDHHFCECHC>BHHF<BF?B=FC<@7>	C	98	T	92
2	46203796	G	43	ggcGgcggggggCcCCccgccggccgccggGcgcccccggggg	ABFDGGEEFFDFGGFFGGEGGFGHH9FGFFBHGGFHHHGGGG>	G	23	C	20
2	46603671	C	110	CcCCcCGCgCGCGGCCcCCGCCCggcgCCCccGcCGcCcGCGCGGCGcCCCcggcgCGcCCcccGGGGcGCCCCCCCGCCggGGggccCCcGcGCGCGcGCcgcccGCcc	?CBDDDCDDD;CCBDDDDD@EDDEFDE?DDEECED@EDECD?DCCDCEDDDEFGEGCCECCEEEB>B:EB@CCCCCCBACGFBBGEEECCEBEBCBCBDACE?DE@=A@?	C	71	G	39
2	48822381	G	58	gAGGggGAaGgAAGGAAGGAGAGAGGgGGAGggAGGAAAaAGGAggaGAaGgaaAGGa	CCFGFFFFDGEFFGFFEGFEDEGFGFEGF:FDFECFEEE@EFFEGG<EDEEEACCEC@	G	33	A	25
2	48873582	C	38	TCCTTTCCTCCCCCCTTCTTTCTTTTTCTCCTTcCCTC	>GGEEDGGD=FFFFFDDEDDDFDDDDDBDFFDCCDC@C	C	19	T	19
2	50574554	G	38	ggtGttggTtttgggtgtgttggtgtgtggtgGTtgtg	ACC8CCACGFFGCCCGCGBGGCC?CFDHDDHDBFHDDA	G	20	T	18
2	54120820	G	45	AAgGgaaGaGGggAGGGaAaAgGAggggAagGAGaGgaaggGAgg	AE7EEEEEEEEEFFDEEEEEFFBFFFEFFEGEDDFDBFDGFDEFE	G	27	A	18
2	54125495	T	28	tCTccCCccTCCttctccttcctctccc	C9=?EGGGFEGGCDH6AHEEGHEHEEC?	C	18	T	10
2	54127041	C	69	ttCcCTTtTCCTtCtTTTctCcCcTtCCcCcTTTCCcCTttCCCctCctctCcccctcTTCtCtcctCc	BBAGBGGEDD?GEDEGGGFEDFDFGEDDFDFGFGBCFDGFFDDDGFCGEGFCGGGEFEFFCECFGA?AE	C	39	T	30
2	55155957	C	32	tcCccctcCcTcTtctctTccccctccccctc	C@5BBAGBGBFA:GBGBGFBBCCBHCCCCDDB	C	22	T	10
2	55186229	T	28	CTTCTCTTCTCcCcTtTtTcCTcCtCCT	DDCFFGEFGFGGFGDEEFEGEDGEEEEE	C	14	T	14
2	55191897	G	94	TtTttTTtggGGTgtgtgggGttgGgtggtgtTttttGgggtgtgtGgTttttttgttgtggttgGtGTtggggtgTgtgtgttttggttggtt	B?9@B??CA@@>CCECFBBB=GGBEBFCCGCGBGGGGECCBGCGCGEDFGHGHCHDHHDHDDHHDEGEFGDDDDHDFDHDH9HHHHC@AC?;@@	T	51	G	43
2	55404883	T	40	TTTCCTtCCTtCCtTTCcTtttttCctcttCCcTcccccC	GGGDDGEDDGBDD@GGDFGFEBFECGFGFFCCGFGEFFCA	C	20	T	20
2	55490819	G	87	GTGTtGTTGTTTGGGGGTGGTGGGGTTTTGTGTtGTgTTGTTGGGgTttTTGTTgGTTGgtgtTTGgTTtTTtTGgGTggGGggggt	GFFFEBFGGGGGGFGGGDG:GGGGGFGFGFGG=FFGGGGFGD>GFGGFFFDFFFCFFFFGDGFFFFGFEEFDFFEFGC?BBBB??AC	T	44	G	43
2	55589434	T	68	TTTATTTATATATTATTTAATTTTTAAATTAAaTtAAATTTTtAATTtTTTATtAATTAAtAaATaAA	BEFEGFGFGEGFGGFGGF:FGGGGGFEFEFEFGFFEEBCFFFFEEFFFDEADEFEDEFEDEFDCB@?B	T	39	A	29
2	56611552	A	90	gGggggaaaAaaAAAaaAAAAaaaaaaAaaaaaaAaaaaaaAAaAaaaAaAAaaAAaaaaAaaaaaaaaaaaaaaaaaaaaaaaaaaaaa	A:>B>BCA9EDBFEFDDFEFFDDDDDDFBDDDDDFDDCDDDGFDFDD:FCFFDDFFDEDCFEEEEECEDBEEEEDEEEEEECEEEEFCCE	A	84	G	6
2	58316814	A	41	GaAGAAAGGaaGGGGAaaAGaAGGaggGgAgagagGgaAAa	E<=FEDEGIFFGHGHBGGEHGEHFFGFGGDGGGGGGCGD<<	A	21	G	20
2	60688968	A	58	AaAAAAAAAAAAAAAAAAAAAAAgAAAAAAAAgAAAAAgAAgAAAAAAgAAggAAAAA	<DCFD?EEBF6FGEE@>F<:@EE8FDBEBEEE8EEEEB9DECEBEDDD<DE7?CBA=A	A	51	G	7
2	65299330	T	203	ATAaaAtaaaatTaAAATTAtatTATataTTatTTataATAtTTAaATaTAAaaTTTtAttTaTAAttaatatTTTTAaaAAtataAAtATatatAttTAtTAAaatTtatAtatttTTtaataTaaattaAATaaatTtATATAtaTAtttaaAaaataAAatatTattAataaAtaaTaAataaAAAaTTTaaaaattaaa	>>:AC>BBACBA?BA=DCDEDFEEEEEDFEFFEEEFEFEEEEDEBFCEEEEEEFEEFEEEDEFDECEE=EEFEEEE@DGFEDDFEEEEEDD8EGEEEEDEEEAEGG>EE>EDE=FFFEEFGDCEEEFEEEGA?DFGGCE@C<EEEFGDEFEF>BCGGBFDEDGFGF:DBFDHBB7DFGG<GDEEFGDBDEDDCGFGFFEDCEB	A	112	T	91
2	65299766	T	145	TttctCctTCccTtcTTtccCCTcccCTttCCctCTTtTttcttTCTTcTtTCCtTCTttCcctcCCcCCTtTTCcTCTTctCCttcTTtCccCttccCCtttCttTTCTcctCcTcCCtctcTCTCctctccCtctccctCctc	A@AE@EGCEGFFGCG>GDGGECGGGGGGDDGGGDGGGBG><GDDEGGFGGEGFGEGGGEEGHHEHGFFGGGEEGGGGGGFEDGBEEG8:EGGHGEDHCFCEEEFEED@FCHHE=HEFFFBHDHFF=EHEHCHHFDGDGEDBA@BC	C	74	T	71
2	69705999	T	42	TcTTTTTCCCTTTCCtCCTTCCTCCCCttTTtCTtCcCCtTC	GEGFGFHDDDFGBDCFC@FFCCFCCCCEFFFFCDFCFBA@CA	T	22	C	20
2	70188676	T	96	CCCtccTTCtcttttcccttTttTCTtcTttTCtcctcccttCcTtTtcccccccctcttTtttctCcTTctCTcCtcTTtCtCcTcTtccCCTTt	@A?C>@EFEGBF>GGBBBGGFGGEG@GBFGGEFG=BGABBGGGBBGECB;BBBCC?HBGHDHGFCHF6DBCHFDCBCCDDHEHECDCE7BCFFDDD	T	51	C	45
2	71190545	G	25	aagagagggaggGaaAGaGGgAGAg	CEEDFEFFFEDFCEFFBDBBF@BGF	G	14	A	11
2	71297982	C	242	tCCCTCCCcTCtCTTTCCCTTtTTCccTTTTttTCCttcTTTTtCCCCccCCCTTTtCTTTCctcTCcTCcCcttcTCtTTCctCctTCCCCTCCttCCccccTtcCcCCCttccCTCCttcTTTctCTTCCttTcTttccCTtCTCttCtccTTtccccCtttcctttCccccTCctTTTcccTctTCCTTtTctCTctcctCCttCtctTccccCcccCTCCcctCctCCtttTcctTtt	CA8BA=CDAFFFGFEFFFFFE@FECBB>FFEGGFGGGGBGGGFGGFG9BBEGFDFFGGEFEFBABFFAFGCFCHHCFFDFEECHGCHFFFEEFEGHHGFCCCCFHCG>GFFFHCCGFGFGHBDBFCHGEDFFGGECFHHCCEEHFEE;HEHCCEEHCCBCEHFGCCCHHFCDD@EFCHEEECCCECH;EEEEHECDFECHCCHFEHEEHCHEBCCBECCCFD=FACGEBGFDCA:C:8AC@C	C	128	T	114
2	71300516	T	46	tCTTTTCTtTCCCTTCCTTTCCTCcCcCtCTTTCTTCTTtTTCcCt	EDGGGGFFEGGGFFFFFEFFFFFFAFGFFFFFFFFEFFEFEDBAAC	T	26	C	20
2	71360144	A	114	AACCCCAAACAAACACACCACACCCACccaCAaACCAaACCCAcCAACACCCACAACAAcAAccAACccCAACcAACCAAaaCAcACaaaccaCaCACcAaCcCACaaCcaCac	>EFBFFFFEGFBFF:FFEFFGEFEGEDHHEEFEFGFFEFGAFFHFFFEFFGFFFFEFFEHEEHHEEFHHFEEFHBBEFEEEDEEHEEEC@GH<ECEEFBEEFGF>DBAB=>ABC	C	58	A	56
2	71742892	T	46	CTccccttcCttcttcCCcTcCCtTtCtccTccTtcTttcttctct	9CB;8BGBBGGGBGFBGG9FBDGGGGEGCCDCCGHBGCACHCCG=A	C	24	T	22
2	71755380	A	63	GAGAGGGAAaAGGGGGGggAGAGGGGAAAGAAgAAAAAGGGgAAAAgAAAaAgAGAagGAaaa	H>H?GHEEEGE=HHHHHDCEHEHHHHEEDFDDDDDD@DGGGDDDDCDDDDGACDFEDCEA=?D	A	34	G	29
2	71762232	C	161	tCTccCTccccctTtttttccccCcTccctctcCtTTtTCCctctcCTtccCTttccTTttcTTccccTtctTtTtcccctcctctTTTtccCtccctccccttctttTCtcttTtccttttcttCctcTtccccttcctccttcttttcttccCtctttc	C??=A@BDBCCECEEEDEECCDCFCFDDDDDEDGEFEEFFFDDDDDG;?DDGFEEDDBGEEDF<CDDDFEDE;EFBDDDDECDDDEFFFFDEEED=?EDEEEFBEFEFFGEEE?FFEAFFCFEDEGEFEFFEEDEF5CEFEED<DCEAEEFFEEE9E;A=B	T	82	C	79
2	74153905	C	30	TCCCTCTCTTTCCCCCCCTCTCCTCCCCTC	FFFFFDDEEEEFFEEFFFEFE5EEFEDEB@	C	20	T	10
2	75113572	G	110	AGgaGGAGaGgagGAaAGAaGgggGaAgaAaAaGGgGaggAaggGGggaGAGGGaGaggggAAGgAggAgGaaAggaAaggGGggAagagaAgggAaAagAGaAaAagGA	??9@>@DDDEFDFCFDFEFDBFFFEDFFDBDFDDEFEDFFFDFFEDFFEEEEEDCEEGGGGEFEEF9GFGEEEEGGEF7GGAECGEEBDEDEGGGDDEEFEDEEDCAABA	G	60	A	50
2	75113789	C	163	GGGCggGGCCccgCgcCCCcgGGCGCgcCGCCcGCCCCcGGCGccgggCCCGgCGCCCccGCCCcCCcCGGGcGCGCccCCgcCCCCCgcgggCcCGCCGCGCGcccCGgcgGGcGcgGGCGCgCgCcccccCcCGCcgcGGggCGgCGGggccccggGCCGg	@>;>BB@BDDBBCDCBDDDBCA=DDCC>>CDACCDDDD<CCDCBBCDCCDDCCDBDCDCCBD>D>DDCDCB;CCDCDCBDDCCDDDCCDBCCDBCCBCCBCBCBCCCCBDCD<BCBCDABCBCDCDCCBCCCCCCBCCDCBBDDBAD>ABCCBA;>>>==ACA	C	94	G	69
2	75928300	G	44	GGGTGGGGTTTGTGTGgTGTTGGtTTTGTgGTTtGgGGtTTggg	EABFDA?EEFFBFEFEFEEEEDDEEEEDEGDEDCCCAA@?ADDB	G	24	T	20
2	79254101	T	203	TTtTTtTTTTTtTtTtTGTttGtTTGgttGGGGGgTTTTTGGGGGTTTGGTGGttGgTTTgtGGGTGGgGGTTTGTGTTTtgTTGTtGGTTgtTGtGGGTTTTgtTTTTggGTTgTtTtGgTTTGTTGGTtGGtttGGTgTTGtGGgTGTTTTGtGtGTGtTGgTTGGGTGTTGGTGTGTGTTGTGGtTGTTGGGtTggTGGG	=ADCDECE>EEEDDEEEHEEECEFFGFEEHGHGH8EAEEEAHHGCEAEHHD=GEDH7DBEAFCHHEGF?HH?EEHEHEEEFEEEHEFHGE<GF@HFGBHDDEEFFEEDD=FGDEGDFDFG?EDDGDDGGDFGGEFEGGDGDDGFGEGDGDDDDG=GFGDGFDGGDCGGGDGDDGGDGCGDGCDGCCEFEHEEHGGBD7DCAAC	T	115	G	88
2	81423277	T	40	CCCCctTCtctTcttCTcTtcttTcttccccTtttcCtct	AB<?BGFGGBGG@GGGGBEGBGGEBGHCCBC8HG:CDHCA	T	21	C	19
2	85549868	A	179	gaaaaagGGAgaGagaAgaaAAAAaAGAGAGGAGGaagGGaaggaaaAaagGAagAGgaaGAGagAAGAAGggAgAGGGagaGaaaaaAgGAAgGGgaGGgggGAAAgaagagGgaaAAGGaaggaagaGAGggagGgaagAaGaaGgGaaaGagGggAaGgagGgaggagagaaagGg	ABCCCCABDADEHEBFECFFEDEEFEGCHEHF=GHFFCHHFFCCFFFEFFCHEECDHCFFHEHFCE7HE?HCCEDEGGHGDGGGGGFGEDHDDDHGDGHGDDD<EDEDFGDGDFDGDDDGFF?DDGGDEGAGDDGDGDGEBDHGGGGCGGHGGGDGDCDGGDACDCGDDGDEBDCC>;<	A	91	G	88
2	85549874	A	172	aGagaAgaaAAAAaAGAGAGGAGGaagGGaaggaaaAaagGAagAGgaaGAGagAAGAGggAgAGGGagaGaaaaaAAgGAAgGGgaGGgggGAAAgaagagGgaaAGGaaggaagaGAGggagGgaagAaGaaGgGaaaGagGggAaGaagGgaggagagaaagGgGgAGg	?;ABCCEDEDE@FCFGFGFGFFGGDDFGGDDFFDDCFCDFBFDFFEFDCGEGDFF5CFGFFFFF8GGEF>FEEDDDFFFGFFGGGGEFGGGFFFFFGEEFDEBFDE@FFEEGGDEGCGDGGGEGFGEEGEEFEE=GEEFFFEGFGGEEFEEGF@EGGEGEEEEEGEGEABC=	A	86	G	86
2	85573049	G	69	ggGggGaGgGaGAGGGaaGagagAggagGAaggggaggAgGgaAaAaGaggagaaggAgAAgAaaGaAa	A=BBCEFECEFEFEEDFFEABECFCDFDDEGCCD8FCDEDDDGF<FCEGDDCDGGDDEEEEDEGGDGDF	G	38	A	31
2	85662650	A	29	aGaGggggGgagGaGGaGAAgGAGGAgga	CBDCFFFFCFEECDCBEBGGGBGBBGG?=	G	19	A	10
2	85808737	A	171	GGAGAAAAAGggaAAAgGaaAAAgAGAAAAggAGgGGAGAaGgAGGGaaaGAgGGAAaagAaAAGaGAagGaAaGgagGGGGGAAgaaAAAAAAGGAaaGGGagAaaggAAGGagGGAaaGgAGgaAAAgaaGGGAAaAAaAGAAagggAaaagaGgGGgaAGGGGAgGGa	B=CDDDEFEEFFDFEFDEDCFEFFFECFFGFFFCFEDDEFEEFF@EEEEEEFGDDFFDEGFEEEEEEFEFDEFEEGEGEDEEEDEGEEFFF:FFDEFEEDEE=GEEDGGEEDDEGDDEBEBGECHEEEEGEEDDDEDEE@EEDEEEFGGEEEEGECFDDGEDDC9B>B@@=	A	93	G	78
2	85826721	G	149	aAgaGgAGaagGgGAAgAGAgAGgagAGGgAgGGaaaaaGAGAGAgggaAaaAaAGggaAAAGGggaaAGGGgAggGGAGAagGAGggaagaAggGAggAAGAaaAagaaggggaggAAgagaggggAGaaaAaggaagaAaaaGagaa	DAAE?CHCFECBCCHGCHCACHC@FCFCBCHCCCFFFFFCHAHCHCCCCHFEAFFCCCFHGGCCCDFFHCCBDH7DBBCBHGDCHCDDGGDGE9DBHDDHHCHGGFGDGGDDDDGDDGGDGDGDDD>G@HGGGGDDFGDHGGGG@B>=D	A	76	G	73
2	86259443	C	115	TCTCCcCTCccTTCtTtCctCtTTcCCTCTttccccCtTTTCCctTCtcCCCctCCcTCtcccTCtTCtTcttccTcTtctCCTtCccTCctccTctcTtcCTCCCTCtCCCtct	@A<<@DCFDDDFFDEDEDDEDEHGDD?GDGEEEEE?DFGGG9BEEDDFEDDDEFDDEF:FEEEFCDECFFEFCEDFEFFEACCFFCEFECEFEAFEFEFFECFCCBEBFCCC@?A	C	65	T	50
2	86433240	C	123	CtCCCCCCTCTTCTCCctCCCCTccctctTtCCTTcTctcttTcCcTCtccTccTCTCttCcCctCcCtcCcttccCCcCCTtCcTctcCcCccCCcccctTTTTctcCTcTTtTccCTCCCT	<CD7DFFFFEFFFEF?DE@GFG:DDDEDEAEFEFBEADFEFEFEFEEFFEECEEFECGFFFDGDFGEFFEFEEFEEEEEFAEFEEEBFEECEEEFFEEEEFDEEE@EEDEEEEFEEEEDFD=A	C	77	T	46
2	86705565	T	30	cCttcTCCCCTTTTCCTCTTTCCCCTTCCC	CADDFBG:DFDDDDFFDCDDDFC=FDCBC?	C	17	T	13
2	88484808	C	72	CCAcAcCCAAAACCCACCCAAAACCCaCACAAACCCAaAAACACcAACCAcACCAAcAACacCCCAAaAAAc	=DHCH9DDHHHHDCCGDDD;HHHD=CECGCGGGCCCF6GGGCACDGGCCGEGC?EGEGG@DDDBACB>C?CB	A	37	C	35
2	95952641	A	127	GggaAAAggGgagGAgggggagaaagGagAgagGAggaggaagagGaaAgaaaGaaaGaaGagAaGAgagagaAAGgaaGggAaggggGGaggaaAAgAagagAgagggGgAgagggaaagaggggg	?CBDCEDBCCBFBAGCCCCBFBFFFCCFCHCFCCHCCFCCF9CFCAFFH>FFFCFFF;FFCFCHFCHCFCFCFFHBDFGCDDDGDDCDABGDDGGGHDHGDGDHDGDD8BDGDGDDDGGCDGDDDAA	G	69	A	58
2	95976305	T	66	TTtttTTTTTTTTTTTTTTTTTTTTTtTTTTTTTTtgTTtTTTTgTTTtTTtTTTgggtgtTTTTT	B@CAC>?AB?FDE9FFFFBFE<E<FBFD?:=EEEEF9E>EEDEE9BEE9EE8DDE6D>@A;DDB??	T	60	G	6
2	97359236	C	35	CAcCCCCCCACCAAAACCCCCaAcACCCCcCCcAa	AHDDDCDDDHDDEHGGCCCCCFGEGCCCCEBBCD=	C	24	A	11
2	97544089	G	35	GGGGGCCGGcGGGGGCGGCGGCCCCGCGgCGGgCG	CC?@CDDCCEBB@B:CBBC9>C<CCBCAGC@?BBC	G	23	C	12
2	97568453	A	81	aGAaggGGAaggGAaaAgAgAAAAAgggaaggaAaaggggaGGgagAaagAagAgaggaaagAgggaaAagagggAgaaag	BBBDDDECFDEDGFDDEFFDFFEFDFFFDDFFEFEEFFFEEGAGEGFEEGFEGEGEGGE=EGFGDGEEFEGEGEGEGAEDD	A	43	G	38
2	98274784	G	170	aAAAggaAaagAaGggagaGAGAAaAgaaGaAggaAaGAaggaaAaAaGAAggAAAaGGgGAgGggGGGGaAGggGaaAaaGAAaGaAGAGaaaGagAggaAGaagaGgaggaAaggAgggaGaaGGgagaaaaaaagggGGAgGAgAGAaaGGaaaaGGGgGgggAGGG	?=CAA@BBDD=5@BDBEBACHCFHFDCFFCFHCCDHFCHFCCFFHD;FCH@CCHHHFCCBCECCDDCCBCG=>D;BGGHGGCHGGCGHCHCGFGCDDHACGHCGGBGCDGDDGHGDDGDDDGBGG?BDGDGGGGGGAD>EBBGDBGDGBGGFBBGGGD?@A@>???B>?C	A	89	G	81
2	98354139	G	306	TGTTTTTTTgTGGTTTTgtgTGTgTGTttGtGggTtgTGGtTggTggGGTggggttgtgTTGtgGgtTtTTgGGGTgtgggTGGttTGGttttGggGgGTGTTGGTGGtttTGTGgTttTgtTTttGGGttGTtttgttGTTGttgggGtTGGgtgTGGTttGTgTgggtGGgttTTgttttggGGTTggGgtgtGtgGttttGtgTTgtTTtgtGgGgTggTggtGTGGGGgggggtTGgtTGgTgGGGTTTgTGgggGggTTtggggggtgTGGgggtgtgTTGttgggtTTgttgGtttGggt	<>@>=====B=?B=BDDE5FCCEFCFEEDGDHEEDEFEHHEEFEEDFFHEFFEEDEEEFEEHEEHEEEEFBEFFHEFDFEEFHIE?EIHDDBE;FEHFHEH@EGHEHH;EEEHEFEEEEEF>EEFFGH>DDHEEEBGEFHEEC=FFFGHEEGGGEFDHHEFFHEGEGEFEHGGFEEEGEEFFGFHHEDDDHEFGFHBFGFF<DGEAECG<DCFGFAAGGDGF@GFFHDGGGGGGFFGFDFEBDFGDGGGADDDFDGGFFGFFDDBGGGGGGEFDGGFFFFFFGDDFFBFFD@BCB=<@;A9=CBC>	G	159	T	147
2	98828389	G	111	AAGgAAGGGGGGAGGGGgAAaGGGGAgAagAAagAGGAAGAAAgGaAGggAAAgGaAGAAGGaggAaAAGaAAAgAaGGGAgGaagaggGggaAGggGggaaGaggAGgag	CE;BC;;AACCA=@ACAFHGFB;CCHFHGGHHFGF8BFHBHHGGCFG:FCHHHGBFF<HFBBCGGGGBE;GD>GGGHBBBGHBGGGFGBBGGGGBDCBGGGFBGECD;CBC	G	60	A	51
2	99154229	C	26	cTCTTTCTtCCTCtTTCCCTCCTTTc	GGDFFGDGECCF@EFFCCCFCCFFFG	T	14	C	12
2	101010082	G	146	CccccGcCccGcgggggGgcccGccCGgCCGCccccCgCCGcccCCcCCgcGgccGcGcCGCCGcccgcGcggcCgGCGGGgccCGCCCGcCCGGcgCcGcGgccGGccGccGCcgggCccGGggGGCCCgGccGcGcgCgcccCg	CCC?<??BABDBCBCCCECBB>ABBGECFGEABBBBFCEGEBBBGFBGG=9EBC@EBBCFDFFEC=CDCECDCBGCEGEEE@CCFDEFFECEGCCCDBCDBDDCCDDCCDCCCFADDDFCCDDDDDDFFF@D;CDCDA@A?9>;?A	C	86	G	60
2	101598677	C	169	TTCCCCCTCTCTtTTCCTTCTCCCtCCTCTTTTTTTCTTCCTCTCcTTTTTTCCTCTTTtTTCTcccttTCTtTTtCCCcCCCttcccCCCCctCCtCttccTCTCCcTTttCCTCTcctCcctCttcCTTCtTtTCTCTtcCCtcTccCtcctTTcTCtCcttTCCCt	=;EGGGGEFEGFGEEBGEEGEDHHGGGEGEEDEDEEGEEGBEGEDCEEEDDDEFEFEEEHEEGACCCHHEGEHEEHEGGCFFGHHCCCF?FFCGFGHFHCCCDFDFFBDDHHFFDFDCCHFCCHFHFBFBDFHDHDFCFDGCFFHCCCCEFBBHEEADCEB>CCAA>B@	T	85	C	84
2	101627925	C	72	TCCTTCTTCCTCCTCCTtCCCTtTTCCcTCCtCcTTTTCTCtTccTTctTccCCTtccTCcCctTccCttct	EDDG<DGGDDEDDECDEHDBDGHGGDDCGDDHCCDFFGCFCHFCAFFBHFCACCFHCCFCCCCGDBBCF@>E	C	38	T	34
2	101635369	G	213	GGAaAGgAGgaGAGgagGAGGAAGGGGgAAAAAaGAGgGAAGGGaGAAGGgGAAAAaaGGgGGaaGGaAAGAAgAGGaAagGAAGAGaaGAAAggAGAAAgGAAGggGGAgGAGGAAGAagAAAgAGGAAGAgGAAgGGaGGaGGgGAAgGgAAAAGggGgAaggGaggAaaaaggAgagaaGaAGGGGAggagaGagaggagaaagGagagG	==?B@ACBDFDFEGFDFHCHHEEGH=BFEEEEEDH?IFGDAH;HDHEEGCFHECEDDE7GFHHDEHGEBDHEDGEHFEDEF:EEHDHEECEEEEGEGEEEFGEEHFGGHEGGEHHE;HEEGEEDGCHHBEGDGGDDGG?EGGEGGGGBDGFGDDDDGG?GGDEGGGDFGDEEEEGG?GEGEFGEDGGGGCGGEEDGEGCFFCCDCBDD=A?:A	G	112	A	101
2	101652733	G	30	GggggggaAAgggAGaagggggaaagaaAa	@FEEEFFDHBDFDH<DDFGFDFEEEGEEGE	G	17	A	13
2	101656726	T	130	CCTCCCCCtCCCCcCTCTTCTTTTTtTcTTtTccCttTcCTctccctTtTTcttcccTcTtCTctCtcCttCTCCttccccTttTCtcccTcccCTTCCTTtTTCtcTttttCtCttCTTCTtTttCttC	B>9@FEFFGFFGFBGFFFFCFFFEFGE@EFGFCCFHHFC=FCHCCCHFHEFCHHCCBECFHGFBHFFBFHHF:FFHGCCCCECHEEFCCCE?BCEEEE=EEHEEEABEHHHGEHFHHFEDFDFEDC>9@?	T	70	C	60
2	102632582	T	31	Tttttttaaaaattaaatatataaatatttt	@BBBEEEFFFFFE=FFFEFFGFAFGF@FFFF	T	17	A	14
2	102959646	A	186	AGAAgaaaAAAGGaaAAaAgGGgAgAAGGGgAAAAGAGagagGGAaGAgAAaAGGGgAaaAaggGAGggagAAaaAaGaagGAGgGAGGgaAAgGGAaAAGAagAAggaAAGAAagaGaGGAGGgggaaaGaAggagGagagGGAaaagGgAGaAAGGGGAgGGGgAgaAAGGgaAAAGagagAAA	<A@8A>BCCC>FHEFE>FEFHHFEFEDHHHFEEDEHEHFFFFIHFCHEDDEFEHHHFEFFEFFFGEHF<GGEEGFDGHGCGHEHGHCHHGDBEGGHEGECHEGGDDGGGDDGDDGGGGGGG?GGGGGGGGGGDGGGGGGGGGGGDGEGGGGDGEDDGGFGDGGGGFDGGACGHEEBBBD;?@9CCA	A	99	G	87
2	105977761	G	77	GgAAGGaGAGGAggGgAgAGAgAGaAGGgAaGaGGggGaAaaGGaGGgAaAggggggAgAGaaaaaAAggaagGgAg	<ACC==D;FBBFBC@CHCH@HCHCFDCCCHFCFC@DDCGGGGBCGB?DHFHDDD6DDFDGBGFGHHDFDDGFCBBD?	G	43	A	34
2	113308622	C	58	cccttctTtcttccctcctcttttcttcttcctttctccttcctcctctccctccccc	C@?ABCBBCEDDFFFEFFEFEEEEFEEFDEFFEFEFFFFEFFDFDGFFCGGFFGGGGG	C	31	T	27
2	113346512	A	49	acACAaacAaAaaaCaACaaAcaAcCcaaACaaAacaaAAcCCACaaCc	?>B@CEC@HEHEEECEHDEEHDEGEAE=FGD><GADE<GGECCG@A?A<	A	32	C	17
2	113763575	A	93	AgGgaGAgAaaAAaGGgagGgaGGagaaAGGaggAgaaggAGAAgAAAGGggGGGgaaGAaGgAaaaaaAAgGAagagaGagaAaaagGgGag	D?<BFCHCHFFHHFCBCECCCFBCFCCFCCCFCCBDAGDDH<HHDFHHCCDDCBCDFGCGGCCGGGGGGGGDBGG6GEGAGCFGGGGDACCD?	A	48	G	45
2	113785202	G	248	AGGGAGaaaGggGGGaGGGAGaGGaAAgagGAAGggGGAAaaGGGaGAaAGGAGAgGaggaAGGggGGAagaGGaaGGaaGagGGAagAggAGgggAAGgAaAgGagGAgaAGAGGGggGGAagggGgAGaaaGAgGGGGGAaagaGAggGGAgAgaaagagggaggaGAggggAGAAgAgggGGggggaggagaaAaGagaAGggAgaAGgGggAAagGaaaaAGgagGaGgggAggaAgggggAAa	BC>?;CCCCFFDHHHCGHHDHDHHCEDFDFGEEHFFGHEDDDHHHDFDDEHHEHEFHDFFD;GGFFHHEDFDHHDDHHEDHDFHHEEGEGFEHGGG@EHGEEEGGEGHEGEDGEHHGGG@HEEGGGGGEHEEDHDGGHHCHEEEGDHEGGHHEGE>EEDGEEGGEGDDGDGGGGDGDDFDD<EFFEFBGE<EEGEEDAGEGFDGGGDGDDGGGGGBDE=GE>EEDGGEGFEG8GGCFFDDF@CBB@?:	G	146	A	102
2	113940839	G	177	GCCGcCcCCcCgggGCCGGGCGCggCccccGCggCCCGCGGCCCGGGCcGcGCCCGgcGCGCCggCcCcgGcCGgggCGGcgCgcccgGgGgCcCgcGGggCgcCcgcccCGGCgCCGCGgggcGGCgcGCcgGgCCGcCCCgcCGCcCCcccggGcgGCccCGGCGCGGcCcGccg	=@AB?EBFEAGCCCEF7EDEFEGCCGBBBBDFCC>GFEFEDGGD?EEFBE@EGGFECBEGDGBDDG9FACEBGEDDDGEECCGD@CCDBDEDEBGD7EEDAGDBFBDCCCEEDEDFEDFDDDDCEDFDBDECDDDFEDCFFEDCFDE?F>CCCDDDCCDE6?>CCEDCB@>A>C>@B	C	96	G	81
2	113994417	G	39	GgtTgttgtTtttTgttgggttggtgtttGgtttgttgt	>ACFF=D@E<DEDGFEECFEEDFDDFFFECFF9DFFEGB	T	24	G	15
2	119748143	C	141	CCGgGcGGGGCCCCGCCcCcCGCGgcCcCGGcCCGCcgcgcCGgCGGGccCGGGgGcCGcccGGGCggGgGcgCCCGCGCCGccCGGCGCcgggcgcCgcGCggcGcGGcccCCGcCgcCggcgccGCccgcGccgcGGcg	:CCEBDCCCCDD<C@EDD;DDC@>FDDD?CCDDCBDEFDGD@CEDBCCEECCCCFCEDCEEDBBCDG=CEBEGCCCBCBC<BEECA;:@CBGG;BGACGD@CGFEBCB>EEECCBEBFEBFFCDEDBDD;BB?@>B>>@?C	C	76	G	65
2	120125053	C	60	GGCccccCgcggcGcCGCCCcgGGGCCGCcCcCgGCCGGCCGGCCGGGCCCGcCCCCGCC	BB??@CBFCBCCBGBGDGGABAAGGGGGGBGCGDFG<FFFFFCFFEDFFFFFCFFFFFEF	C	37	G	23
2	120125058	C	60	ccCtcttcTcCTCCCctTTTCCTCcCcCtTCCTTCCTcTCCTTCCCTcCCCCTCCCcTcc	CEGEDEEDCDGFGB=DCBEFGF=FDGEFFFFAFAGF;EEFEEEFFFDEEFEEEEED?ABB	C	39	T	21
2	120303820	A	39	TtttaAttatTttTAaTAatttAaataaAaatattaAat	?AAA;BBDDDFDDFEDGFDCDBFDDEEEFDEEEEEEEE@	T	20	A	19
2	120830627	T	33	TTTTTTGGTTGtgGttggTtTTttgTTtgttGt	@DFDEFE:FEDCFDFF<GEFEEFEGEDEFD@BA	T	23	G	10
2	120889173	G	30	CGGCCcCGCGgGCCCccGCCCCGCCCGggC	GHHGCEEHFH>GFFFEDGFFFFGEFEE@9@	C	19	G	11
2	121740505	C	47	tctTtctttttcccttttttcttctcctcctccttcttttccccccT	?C?B@=CEEFFBBBGGGGGGAGFBGC@HCAHC:HDCHFHHCCBCCCC	T	27	C	20
2	122006700	G	46	GccggGcGGcCGGggGCCggGCgcgGCggGCGggcCCcggggGgcc	<?<CBCBCCBDCCBCCDCCCCDCBDCDDCCDCCDCCC?9DDDBDC=	G	29	C	17
2	127951458	G	125	gGgGAgaAaaaAGgAAgGAgaagggaaaaaGGggAagaaaaggAaaaagggAgaggagaGggaGgAGAAaaaGgAAaGGGgGgGaaAAaaaggggAAaGggaAgggAagGgAggaAaaGGgaaGG	@?BCDEFDF@EEGEEFFGFEECE?FFFBFFBFEFDFE<FFFEGEFFFGFFEEGGFGGFGGG8GGGFFFFGGGGGFFGGGGFFG:FFEDGGGGGFFEEFFFFAEG>GEGGFFEGFGEGDFFFGGFB	A	63	G	62
2	127951459	C	122	cCcCTctTtttTCcTTcCTTcttcccttttCCccTtctttccTttttcccTctcctctCctCcTCTTtttCcTTtCCCcCcttTTtttccccTTtCcctTcccTtcCcTcctTttCCcttCC	C>>@CBHEG>FBFBGABGG=AGGBBBGGGGGGBBGGBFGGBB?GGGGB9CFBD?BHBHGCHGCFGFFHHHGCBEHGGG8FBAHFFBHHCA>CFFHECCHFBDAFHACBFCCHEGGFFAHHEB	T	62	C	60
2	127951570	T	37	ttGGgttggtTgggggttgTgtGgggttgttggtttt	BCH7DBEFBEEEFFFFE:FCFEHGFFFDAFFFFGEFF	G	19	T	18
2	128081682	C	26	ccACCAAcCCaCaAACcCAcaAACCC	FFFGGAEGGFFFEDCFGFDGFA?BC?	C	15	A	11
2	128087651	C	62	tTCttttccctcCCTctCcctTcctccCCtTTcccTctcCTCtctTcctTtcCtttCctcct	AA?BEEDFFFEEDDGFEDF?AGFFDFFCDEHGGFFGGDFDGDEEFFGAFFFGCFEFCBFFGA	C	33	T	29
2	128370200	G	30	gaagGGgGggGgGgggagagaggAagagaa	?BEAACBCCCCC6CCCFCCDGDDFGDGD@A	G	20	A	10
2	128409337	G	42	GgggggggGggggccgggcccgCGcGcgcgcgccgccccggg	BCBABCCDADDFFGG<FEGGGEFEGEHFHGAFHHAHHHHCFE	G	26	C	16
2	128409338	C	40	ccccccCccccaacccaaacACaCacacacaaaaaacccc	C?=>>>ABABBFFABBFFFBHFFFGBGCGCGGGFGGCC=C	C	24	A	16
2	128477084	G	31	CCGCCGCGGCggGCCcGgCcCccCCgggcgG	FEEEFEGEEGFFEFFEDFFEEDEFFGFEDBA	C	17	G	14
2	128480973	G	103	agAAAGGAAAaAgGGGAAGGGAGGAaGaAGgAAagaaagaAAAGggggaAaaaAgGgagaagaGGgGGaagaaAgaGaGgaagaaaaaGgagaaaagagagag	C?@??ACDEEDDEEDDEFEEEFAEFEAEFEECFDEEEEFEFBEEFEEEEFFBF<6DFFGFFFFD@FDDFFG@FFFFDFDFFFF:FFFFEGFCFFFFCFFFFE@	A	58	G	45
2	128522383	T	171	CTTCctctCccCcTTcctctcTTCcTTtTCTcTTCTCccCTtttcCTCttcTtTCTTccTcTtccTTTttTcCTTcCCtCTtcCTTTCCCCTTTtcTCCTcTTTTcctTTTTTTTCCctctTccTCtcCcCTTTCTttTTTcctcCcccTCcCCcTCCTTTTcTttttTtt	DBBCBFAGG>BGBGFBBGBCBFGGBGEGGGGBEGGGHAAGGGGFBG;G:H@EGGGGFBBGBGGCBGGFFGACFGGCFGEGGHCGFGGEGGGGGGHCGGGECGGEGCCHGFFFFFFCFCHDHFBAFFHCFCFFFFFFHHEFFCCHCFBCCEE=FF=EDFCCBC>?CA?:CCC	T	94	C	77
2	136873549	A	34	ttAaatTtaTaatataTtTaaattAAaattttaa	C??5BCGEFGFFEFEFGDGFFFEEFFGFFFEFHG	A	17	T	17
2	137814477	C	124	CcggGGCcgCCccggcgggCCgCcCCCcGCccGcgggGccgcccgCcGGCGCGGgCCCccccccgGGccGccgcCgcGGGGCcCCgggcCgCgcGGgCCGgCGCGCCcCggCcGCCCCcCGgGC	AC?B=5<DDCCDDDFDFDFDDBDDDDCDDEDDCEEEFCEEFDDDFDECCCCDCCGDDCEEEEECFCCDECEEGEDGEBBBBCECCGGGDCGCFEBBGCCBECBC9@CECGFCBBC@BB@@>>6?	C	71	G	53
2	141457985	T	81	ATTTTtATTTTaaAATAAtTtATTAAtTTaaattatAtaaAttAttAAAatTATATAtATTATTaTATaaATTTTTAAAAt	BB=@DGEEEEEFFEEFEEGEHEEAECHEDGEGGHFHEEGFEHHDHGDEDGHADDDDDHDDDDDDGDDDEFB9B?@AA?CCE	T	43	A	38
2	144345121	G	27	GGGAGAGGAAGAGAGAGGAGGGGGAAa	GGFFGDFFEFFEFEFCFEEFDDCBAB<	G	16	A	11
2	152299764	C	27	CCTTCCcTTCTTTTTTTTTcCtctttt	BEECGGFEDGEDDCECDDCGFFGDEA;	T	18	C	9
2	152322095	A	124	aTATttttTtaATaATtTaTAATTTTTTATATatAAAAaAATaATaATTTtAAaTtATTTTTtATAAAAAaatATTtTaAAAaAATAATTAtaATAatTatTTaTTAAatAaatAAAaaTTATt	C>>BBBDDCDDEEDEEDEDEEEEEEEEEEDEEEDED?DEEEEEEEDEEEED9EEBEE=EECDECDDDDDDEEEDCDBDEDDCEDDD>DDDDEEDDDEEDFECDEDDCCCDD:CCBBBA@9=<?@	A	64	T	60
2	153000337	T	27	TAATTTTATTAtTAATAAaaTTTTATT	FHHGGGCHGGHFFGGFGGGGFFDFGEF	T	16	A	11
2	153483257	T	28	ttcttctctccctcttttttcctttttc	AA?FEFBF;FFFEFEEEFFFGGCFFEFG	T	18	C	10
2	157425972	G	60	GagGAAGAAAaGaGgGGagGGggaAgGGAAAGgggaAgaAAgAGgGaAGaAaGgggaggg	BA?@EEDFFDEEEEFEAEEDEGGFFGCDFDFDBGGFEGEEEGDDGDFECFEFDF5GEEE@	G	34	A	26
2	158401137	T	41	ttTctctcttctctCcttttctcTtcccttttcttcttctt	B>ACGBGBGFBGBGFBBGGGBG<FHCABHGHFB@EBHHCHG	T	26	C	15
2	160087535	T	98	TGtGTTTggTGTTTTTttGgTgggTGTttttGgtTGTtTtttgGtttgggtggggggGtttttgtgtgttttttgtgtggtgtgtggttgtttgtggt	DAC<?BCDGEEEGGGGDDGFGEFFGGGEEEEGFEGHHEHEECEGEE9FEFFGFGG5FFFEFFEGFFFCFFEEFEGFF;F:FGEFFEEFFG<FFFFG<?	T	57	G	41
2	160707075	C	34	cctccccctttctttcctttctctccttctcctt	CCFABBABGGGBGFG@CGFGCHCHCCHHCHCCFH	C	17	T	17
2	160843623	T	35	cCCCCCTCCCCCTCCTTCCTCCCTcCCTtTccCcC	GGGGGG?GGFFGFGFFFFFEFFFFHFFFDFFGBBB	C	26	T	9
2	161797513	A	101	GGAGGAaGGAAAgAGGgaaAAAAgggAgaaaGGagAaAgaAaAGAggGGGAagAaaaGagggagaAgaggGaaAagaaGAaAggagagagGaAAgaAGgGa	CB>AB@B@DBE=EFGG>DCFFFFFFFFFDDCGGDFFDFFDFDFGFGFGGGFEGFEEEGEGGGEDEFGEGGFECEEGECFECEGGDGEGEGFEDDCABC?CB	A	55	G	46
2	162091836	T	44	TCCCTTCCCTTtTCCTCTCTcTcTCTCTCtTCCCTCTcttCCCt	=ABAEEGGGEDFDFFDFDEDGDGDFDFD=EDFFECFCGEDCC9:	C	23	T	21
2	165349463	T	32	TCTTCTCCTCTCTCCCTTTCCCCTCCTTTTCT	GGGGGFFFFFEFFFFFFFEFFEEECFFAA?>:	C	16	T	16
2	165586466	T	30	CCCCTCCCCCTtCTTtCcTCCcccTCTTCT	GEGGEGEGGGDHFDCFF@DFFCCCDFCA>A	C	19	T	11
2	166626606	G	29	AGAAGAAGAAGAaGGAAAgAGgAGAGGGg	FGFEGFFGFEGEFFFEEEDEFFEFEFFED	A	15	G	14
2	167137119	G	60	AaGaaaGagGGGGaagagGAGGgAgAaAaAggggGaaAGAGgggggAaaagGgAAgaaag	@CBBBDEEDGGFGEEFEFGFHGFFEFD@FFGGEFGAFFGFCFGGFFEFFFFFGEEGFFEF	G	31	A	29
2	167140955	G	78	AGGGAAAGAGGGAGaGAAAAGAAAAGAGGGGgAaAAAAGAaGAaGGGaGGGGAaaggGAAAAGAAGgaAAAGGgGGGG	@?CBHHHCHBCDHCFCDHHH?CHHHCHCBBAGHGDGGGBGGBGGBBBGBBABGGFDFBGGGGBGGBGGFFG=>A<AC?	A	40	G	38
2	167297887	A	69	GAAAAaGAagAgaAAaAGagGAAAagGAAAgaGGgaGgAaAAaggGagggaAaggaAAagagagaGaaG	>>EDEDHDDFEFD?FDEHDFHEEEEGHEDEGEH:GEHEEEDCAGDGAGGGEDEGFEDDCGEFEB9FEAD	A	41	G	28
2	167301338	A	63	GAGAGAAGaGAaaGAAGGGggAGgAaAaAAaAAaGgGgagGGAaAaAgaagGAaaaGaAaGGa	@AABGEFGEFFBCFFFG8GEFFFFFFFEEFFFEFGFGGFGFFEFEFEGFFFEEFFFEFDEFDB	A	37	G	26
2	167322522	G	26	agaaAagagggggaGagggagaaagg	BFDDGDFDFFFFGE?EGGGEEDEFG<	G	14	A	12
2	169690729	T	71	TCCTTCCTTCCtCCCTTCTtcTTCcTCTTtCTCcTctTTCCcTTTcttttccCtcTtCCTTtCcCtTTctc	>GGECGGEEGGEG8GDEGEEHDEG8EGEDD>C=HDHBEAFF5DDAHEC7CFHFCHDEFFDDEFHFDC;C=@	T	38	C	33
2	169763148	T	200	CCCTcTCTCcTTTTCtCCCTCCTCCTcCTcTCcCCCttcCTCcTTCCccCTCTCttCttTccCCttctCCtcCTtcttTTTCcCcttccctCcttcctcttttcctcCCCtCTtcTCttttTCcttttctTccTcctCtTcCcCcccttcctCcttcCcTcctcCTccTCTttCtcccttccccTTCTcTtCCTTttctC	ADB?>B@BB>?AFFFFE>GGGGEG@GBGGBGGBGGGEEBGGFAGGGHBBFHGGGGGF?GFBBGGGGBGGGCBCFG;HGFFAGCGBHH?CBHFCHHCCHAHHHGCCGCGGFHGGHCGGHHHHGGCHGHHCGGBCG?CGFHFBFC?CCBFHC@IFCHHCFCFCAHBFFCCFFFHHFHCCBHHCCCCFEFFBGGBCDCB@;AC	C	109	T	91
2	170003432	T	130	TGTTGGTtgtgttTTGtTGgGggGtgGTGttGGtTTGggGttttTggggGTGggGTgTTTggtgTgtTTGtTttTgtGttTtgTgttgggtGtgTGTGTggGGttgggtGTtGttGgTgttGggTTGtgt	DB@@A@CEFDFEDGGGEGEFGFFGEFGGGEEGGEGGGFFGEEEECGFFFGGGGGG:FGGGGGFGEGFGGGFGFFGGFDFF@FGGGBFCGGFFFGECFEFEGFFEFGGGFFFFFF@FGEGFEFEFD?CA9>	T	66	G	64
2	170099895	A	131	ACACCCAAAACCAAACAACCACAAACACCCAACCACAACAaAcaCCCCAAACAACAAAACCcCaaCACAAAacCCcCCACCCACCAACAACCCCACCAAaAaCaAcCCAACCCAaAaCACAACCccAAAAc	C@EADGFFFFGEGFFGFFGGFGFFDEFFGGFF?GFGEFGFFF@FGGGGFEFGFFFFFFEFFC=GGFEFEEEGCFFCEFEFFFEFFEEFEEFFFFEFFEEGEGFGECEFDDFEFEFEGEDGE?CB<==BA?7	A	68	C	63
2	170175334	T	121	TCTTCccccTCtTCCTTtTccCCCCtTtCCCcTTtTCTTCcccTTcCtTTcctcCCTTcTttCtCCtctTCccttttTccCCCCTttTCttcTctctccCTcCtctCcTCCCTtttctCTC	?CDCFFEEFFFEFGFDEEBFFGEGGEFEGGGFFGEEF@@GFFFBFFGFEFGGFGFFEFG=FFGFGFFFFFGGGEEEEEFGFFEEFFFFEFFFEGFEFGGEEGFFGFDGEFFEDDBBB@BAA	C	63	T	58
2	171242865	G	74	tgtgttggtgtgtttTGgttTGtgGgttgggggTTgGggTgGtggGgGTgtgggtggttgtgtgggtttggttg	AACABCGEEEDFEDDAEFEEEEEFEFEEFFFFFFDFEFFFFEEFFEGEFGEGGGFGGFFG@GFGGGFFDGGD;B	G	42	T	32
2	171570488	C	36	GgcgcccgCcGgGgGgggGCcGGggGCGGcCGCgCC	BCBCBBBCGBEDEDDDDDDFCDD?DDFDDCEBC?BA	G	22	C	14
2	172216969	T	57	CTcTCctCTCccTTCtCTTtTctttTCtcctTcccTcctttttctTTtCTcTcttct	?CFFDFEDGAFFDGEEEGGEGGFFFGDFGGFGFFGFGGFFFFFGFGFF?=HFGDABA	T	33	C	24
2	173686798	A	33	aggaaaaAaAGgaggggAgGaGggAaAaagaag	CAEEFFEHFHCFFFFFDHFCFAGGCGHGGGGFE	A	18	G	15
2	173861340	G	164	AGGgAAGAGaAAAggAGGGGGGAAAAGAGGGAAGGggAGAAaAAaagaAggAGGaGagAGAagAAaGgGAgaaGgaAgAAGaggGGGgAGgaGAGaAAagGAaaAAAggaGaAAAaaAaGGgagaaggAGGgagaagaagagagGGGgaAGagGaAAagaaAaa	@@?@A@DDEFDDDFEDGGGGGGFFFFGFGGGFFGGFCFGDFFFFFFFEF<FFGFFGFGFGFGFEFFGEGFFGEGGGFGFFGGGGGGGGFGGGGFGFEFFGG7:GFEF=GEFFEEFE@DFF7GGDGAGGBCFGGEGGGGGGGGGGFFFGGEFGGEGDDFFBBB>B	A	88	G	76
2	178257664	C	70	CCTTcTTCctctTtTTcTtTTCtcttcTtCCCCCCtcCcCCCTTCTtTTcTTCTttCtCCCttTTcCCTT	=AF<DGGDDEDEGEF?EFEBGDFE9?EFFDDDD97FEDECDDGFDFFFFEFFCFFECFCCCEFFFEBDEC	T	38	C	32
2	178528728	C	106	CgGcCGgCgcccGcccGCGCGCgCgCcCccccgCggCgGcCcGGgCGCccCCcgcccgGGGGgCgcgggggCgCCcccgcGCgcgGgcgCccgccccCGgcgccgg	ACBCAA?CDHGFGGGGG@GGGGFGFGGFGFGGFFFFGFGGGGGGF<GGEHDGGFGHHGGFFGGFGHDGGGGGGGGHHHGHGFGHGFGHGF>HGHGFHFEGGFGA?B	C	59	G	47
2	178682655	A	127	aAGgGGGGGggAAagaAGAaAGgGagggAAAGGGAGAGgGAaAAaAAgAggaAGGgAGAAgAGGAgaGGGGggggaAGGaGgagaGagaagaagaagGagGaaaaagaGaagAagaaAggaAaaaag	B=CBEA@DB@CEEFFFEHEEEH@HFFFFDFFHHHDHEHFHEF=EFEBGEFGDEGGFEHEDGEGHCGGHHHGGFFGA?HGGH<GGGHGGGGGGGGGGEFGGDGGGGDGGGGFEDCGGEDGE?EEFFBB	A	64	G	63
2	182374328	T	50	TAATTTTTAAAAAAAAATATAtAtTTaATATTTtTTTTTATaTTTTTATa	AEEEE>ED@DEEEEEEEEEEDBDF>DGDDDDDDFDDDDDDDGDDCEDABB	T	29	A	21
2	182374534	A	42	gagGgAgggaaaaagaaaaGaagaggaagggggaggaaggaa	ADBBCHBCC6FFFFCFFFFCFFCFDCGFDB7DDGDDGGDCDG	A	21	G	21
2	182413259	A	35	AGAAAAGGGGAAgGGaaGGAAAGAGagaAaaGAAA	FDEFFFDEDEFEDECGFDDEEEDEDGDFEGGDBFC	A	21	G	14
2	183053658	C	207	GGGGCCCCCGCCCcgCGgCcCCCCGCCCGGCGGCGgCCCCCGcGCCGGgGCCGCcGCCGGGcCCCCGgCCgGGcCgGGGccGCCcGcgggCGGCGGgGGccCgGgCGCCgcgCGGGCcCggCGCcgCcccGGcgCGcccgGccccCGCcgCGggcGgcCCCcGgCGCcccgCGCGCcggCGCggcGgCGCCGgcGGCgcCGccCGgg	>A@GGGGGCGFGGFDFGFGFGGGE9GGGGGGGEGAFGDGGGGGGAGFGGDFFGGGGGGGGGFGGFDDGDGGGFAGDGGGGGGGGGGFFFDGGGGGFGGGFGGGGGFFFFGGGGE?;FGFGGGFFGG>GGGFFGEGFGGGGCGGGGFFFGGFFGGGFGFFFCGFGFFFGGGGFEFFFGGDFFEGGGFECDBCDADBB?BA>CBAACDD	C	111	G	96
2	183793653	A	28	gaggggggagaaaaaaggaaggggagaa	CAAFFEDFFCFFFFFFGEGGGGGGGDG8	G	15	A	13
2	183848114	T	106	TTTcCtttTTtTCCTttCCTTCttTCTcctcttTccctcCCCccTTctctcTctttctttcctcTctcTcTttttcctcttctttccTCCtttccttttctcttct	B>B=ADEFFEHAEGGGFDGGGFGGEFEBBGBGFHBBBGBHHGBAGCBGBGBGBGGGBGGGBBGB;BGBGBGGGHHBCGCHHCHFHCCGGGHHHBCHHHFAD@?GCE	T	62	C	44
2	185798504	A	83	cAACcccaaCaCaAAcCCacCAccCAAcacCCacCccccCcAccCAccAccaAcccacaCacacaAcCcaacccaacaaccac	AA??CEGDDGCGDFFGGG<GGCGGGFFGDGGG?GGHHG:GH<HHFFFHFHHEFGEGBHDFB8EHEBCFHEEHHDEEHEEGHBD	C	51	A	32
2	185801747	G	57	gggGGgaGAagggagaGAagaGaGagggagggggaggggaagggaggagaagggagG	?CEGHFDHADFFFDFCHEDFDGEHCDFGCFGFEGCGGGEEEGGGDGGEGDEGGGEGF	G	38	A	19
2	186625770	A	26	GGaGGAAGGGaAgaAaAgAAGaagga	@EDFGFFGGGEFGBFEFGEEFEEEB@	A	14	G	12
2	186629191	T	33	TGGTTGTtGggTGgGGGTgTTTGGtGTGTtGTT	EHHEFACEHGGECBHGFCGDDDGGEGDGDFE;@	G	17	T	16
2	186657089	C	42	AcaAaaACccaaaccaacaCaAacaAaaaaAacaAAAaaCAa	C@CEDEHDC@EEEDDEEDEDEFEEEHFFEFFFEFCDGFFCGF	A	31	C	11
2	186661673	A	172	GaaaAggAAaGgAGgGgGgggaGaggaAAaaagAaAAAAGAGAgggAAGgggAaagaGGgGGgagggAAAaGaaggGaaGaaAAGGgaggaAGagGaGaagAAGAagGaaaAgGAggaaaAggGgGaAggggGaaaGGGGGagAGGgagAagGggGaaaaaGAGGAAgggAg	AAAB>BBAACGF6HFHFFEFFEHEEEEEEEEEFEEEEEEHEIEFEEE?HEDFEEEFEHHFHHEEEEF?EDEHFFFFHFFHFFEDGGGFFFFEFFGHFHFEAEEHEFFGFFFDFGEFGEFFEGFGFHFDGGGGFFFFGGGGGF?DGGFFGDFFGFFGEFEFFFCGFDABB=@?	G	90	A	82
2	186664473	T	39	TTcCCTTTCTCTcTTCcTCcTTTCTCTtTTTTcTtcTtT	GGBGEGEGGGGGCGGGAFFCCFEFFFFHFFFFBDD?DAA	T	25	C	14
2	186664963	C	78	aaccAcCCACAaAcAAcAAACcaACccaaACCcccCCaACcAaacCCcacCCccaCcCccACACCCcACaAacCaacc	CCDG:FEDH@HFEFHHFHFIDFFHDFFGFHDDFGGDDDDDFHGGGBCFGGCCGEGCFCHAGCGCCCDGCGFGFBF@??	C	46	A	32
2	186665432	G	106	GaGGggAAAGagAGaggaggGAGaAGGgGGagaggGGgaGAgGaAaGGagaGGaGGaGgaAGAAGGAagGagGaGagGAAGaGgggAaAAgGgaAAggAGagAggg	A@9<BBEDEECFFEDFFDFFEFEDBEEFEDDFDFFEEGEEFG?EFEDEEGEEEEEEDEGCFEFECDFEGDAGDECEGDEDDADGGGEEEEGDECEEFEEDDGDE=:	G	62	A	44
2	186667121	T	73	TtCttcCccCttTCcctccTctccctCCCTCTTtcttCCTTtcTTTCTCCctCtctTctCctCccCttTCccC	BCB7AFEFEGEEEGFFEFFFFEFFFEGGEEGEEFGFFFGEDEGEEEGDGFGFFF9FDGFFGFEAGGDEBBA@@	C	40	T	33
2	186672897	A	36	gaGGGGAGgAaaAagGaAgGagAggGgAgaaAgAGg	CDFGHHEHFDDDEDEADDFGEGDEGDGDGEDDGCD@	G	20	A	16
2	191184475	A	121	AagAaAGGaAAaagAGgAGAaagAaAaagGagAggaggAAagAAaGaAaGgAAAggGGGaAAaAgGGgGaaGgggaAaagaGGaaggaaggAaaaggAAgaGaaaGaaaAaGgAaagGggg	@BBCEECBEHHEFFF<FHCHAEFHFHFFDCBFHFFFFFHHFFGCEBGHGCGHEC=CCBCGG@GBGCCD:FFCGCGGGGFFGBCGGGGBFGGHGGGGG:GGGBGGEBGGDGGBGGEGF@DD@	A	69	G	52
2	196636358	G	32	TGTTTGGTGGtGGGGGGGTTGTTGGTTTGGGg	>EFBEEDFEDFDDDDDDDDEDEDDDEEDCDB;	G	19	T	13
2	197021372	T	46	ataaatTtatAtttttAtatttAtTataTataTaataattaattat	A:BBDECDDDDEEEEEEEEEEEEEEEEEEEFFEFFDFFFFFFDFFD	T	26	A	20
2	198263146	T	56	TTCTTTCCCCTTCCTCTCCCTTCCTCTCTTTTTTccTTCTCttCCCTTTTtCTTCC	GGGGGGGGFFFDGGGGGGFFFFFFFFECFCFFEFGGFFFFFFFFFFFEBC@A>B??	T	31	C	25
2	198283305	T	70	CTtcTTCTtctTcCcTctTTccTcCcttttcttcctCcTTttcttcTccctctTcctCcttctctttctt	?<BEC>BEDEEEFGAEFEECFFFF>FEEEEFEEFFEGFEAEFFFFFEGGGFGECDGFFGFFGFFFFFDDA	T	39	C	31
2	198362018	T	47	cTcCccCtCTCTTCCCTtTCCTCTTTTTTCCCTTcTcTCCTTTCCCC	CBE?EF=EDEDEDFGGECDFF<FDDDDDDDFFDDGAGCEEDBA>BC?	C	25	T	22
2	198953816	G	62	gaaGgAaagaaggaggaaaGagaGaAAgGaaagaaaAAaGgggaGgGgAaggaaggAgaaga	CCB7CFFGFFEEF?FFFFFCFFFCBHGFCEEFCGFFGHFCFEGGCGCGHGGGBGGGGGEG@D	A	34	G	28
2	200713751	A	34	aacccCaccaCaccAcACaaacacaacaacacca	@<8FFEDGGDGDGGC;EEDDDHEHEEHEEGEHGD	A	17	C	17
2	201437048	A	59	aaGgagAAGagaAGagaAGGGGGGgGAGGGGAGAAGAGGgAgAGaGgAGGGagGGgAGG	DEGEEFFFGEFDCGEEDFGFGG>GGFEFGGFEEEEFEFFFEGEFFFCEDEEEFDD<A??	G	37	A	22
2	202122995	A	87	AAGagGaAGAaaAAGAaGAGgAaaAGAAgaAGGgGaaGAGaAagGAaAaaaGAggaAaAaAgAgGAAgGGaGAAAAgaGaGaAAAgG	BFFCDGDFFFDDCFGFDGFGDFDDFEFEAAFGGFGDD>FGDFEGGFEFEEEGFEGEBEFED:EG@EEGFFEFEEEEFDFCFDDEBE?	A	54	G	33
2	202152162	T	27	TTATTAAtTtTTATaATAAatTTAAAT	DGFFFEEFC>FFEFFEFEFCBDCAAC?	T	15	A	12
2	202245244	A	38	GGAGAaGaGGAAAGGGgAAAGGAAGgGAGAAGAaAGAa	:GDGFDGCDGFFEGG>GEFFFFEEFEFEFEEFEEEEEB	A	20	G	18
2	202412322	A	39	TgaAAgAGAgGggAaAAgaAaAaaGgaaaaAggGGaGGA	5?CCHFH>HF:FFHEHHCE@GGGGAGGFFFGGGB>EB<?	A	22	G	16
2	202508005	A	38	CcccCAaCacaaccaacaacaaaaaCaacaacaaaAAA	@ADD69E?AD@FEEBDEFFEFDFFEBEFEDCFFE=B7B	A	24	C	14
2	202589257	T	44	ctctcttttccttttttttcctctctttctctttccccctcttc	CAAADAEEEDDEEEEEEEDDDDEEDEEFDEDFFDEECDEFBGFD	T	26	C	18
2	202633582	A	72	gagaAGGGaAGGAGgGagGGGGgAgAGAGgAAgAGggAGaAaagaGaAgAGGAGgGGgAGaaAaGggaAaag	BBABFEEEFFEEFEF9FFEEEEFFFFEFEGEFGFEGGFEGFGGGCEEFFFDDEDGDDGEDFGEGCGGEECCB	G	40	A	32
2	203831640	A	43	AAATATTAAAAATAATTaAAAATTTaATATaTTATaattTTAa	?DFGFFFEFFFFEFEFEGEEDEFFFGEFEFGFFEFGGFDDCCB	A	25	T	18
2	204116660	A	58	TATTAATTTAATAAAATaTTTAAAAttTATAAAAAAataTATATTtTATTtATTTTTT	CFFFFBFGFFFFFFFFEDFE?EEEEFFEEEEEEEEEGDGDEFEEEDCDCCBB:BCAC?	T	31	A	27
2	204322298	T	86	TCtCCcCCTcTtTTTCtcCTCtTCtcCCTTTCTCCCCCTcttTTCTCCcCCcccCcCtCcCctcctTtTtcctccTtcCcctTttC	B8A8<DDDGCGEFGGDECEHDEGD@FDDGCFDGDCDDDGFFFGGDG@DGDDGFGCGCFC<CGFGGFFGFFEGFEGFFGCGGFFCB?	C	49	T	37
2	206364791	C	29	CCcccCggCcGcgcggggcccCccggccc	D>?CFGFFDFGFFFAFGGGFGFGGGGFB<	C	19	G	10
2	206610502	T	311	GGGTTGtTGTTTtGTtgTTGtTTGttgtGGgtTttGTTtTTGgGTTTtggGGGtttGtTGGtTGTtTGGTgGTttGTGGgtgTTTTTtggtttTTTTgtTGggtGgTgtggtggGgTTGtgtGGtgttgtGtgTTTgGtttTTgtTTgtGTgggtgggTTtGttggttggttggtgtGgtgGtgtgTTgttTTgGGggttgtgTTTtgtgGgttgGttgggggtgtgtgtttttgttggtttggttTtgtGtggttgtGGGtGGGGgGTtGGGTgtTgGTtttttGttgtTgttGtgggttttttggGtgg	<>>@?<B?<BBAD?FFCFEBFGGCGGBFCCCGGGGCGGGFFCCCGGGGCCCCCEGGBGF;CGGBGGECCGCCFG?CFCCCGCGGG?GGCCGGGHH;GCGGC@CGCCGCG?CFCC@CGGCGCGBCGCGHDGCHCCGGCCFHHGGCGGGDFBG?D?HDDDFGH:HHDDHGDDF@DDHDHCDHDBGCHDGGDHHGGACCDDHHDHDFGFHDHDADHGDBHG<<CCDHDHDFDCHHHGDGHDDHHHDAEHFHDHBHDDFHDHB8BH=BBBDBFHABBFDIBEBFHHHHHBHHCGFDHHB>DDDGGGGAEA?=;AA	T	169	G	142
2	207169731	G	142	aaAAGGGGGGAAaAgAgaAGAGAgaAAaggGAGgagaaGgaGgAaAGGAGAAGaAGAGggGgAggGGgaGAAgAaAgGAaAGaaAGGggAGgaAGGGGGGAAAAAGAAaaGGAgGagagGAgaGGaGgagAGGgGAaaGGGa	CAA=B<C?FEFBCFFFFDFGFGFFDFEDFFEFFFDFDDFFDGFFDBGGFGEFGEEFEAGFFEFGGGG7EFEFEFEFEEEEFEEEFGFEFFFGEEFFFFFFEDEEEF=EEEE=EGFEGEFFEGDFECEFDFEFFFDDA?BBAB	G	74	A	68
2	208478055	A	118	gAggGGgaAgGGaGGAGGGagaGagaAaggAgaGaAAAGAGAAGAAaAGAGaaaaGgGGGAAggaaaaggggAaGaGGaagGGGgAAgGAAGGGGAAagAGAAAAagGAgaAAgggGA	AABA=FCDECEGFGGFGGFFC8GFCFGECCFCF@FFFEGFFFFFFFGFGFGGGGGGCGGGFFDDGGGGDDD@EGFGFFBGDCFFDDEDFEEFFFEEEG:EFEEEEGDFDDGECA>>A?	G	60	A	58
2	210889961	T	60	gtGgggtttggGTtttggtggGGGggtggGTggggGttgtgggGgtggtggggttgggtg	CCCAABCFEEFHDEEEFFEFFHHGFDEFFCEFFFFHEEEFGGFHGEGGFGFFGEFGGGFG	G	41	T	19
2	211540507	C	103	ccaAaAacACcCCcacAccaaaaAaaAcAaaaAcCCAaCAaacaACccAAcCCaAAAcCaaaaaaAACcacaCCcaaaaCaacacacCCcccACCcaaccaaA	BADDEDED>GDGGDEDFDDEEEBEEDFDFEEEFDGGFEGFFDEFFGDDEEEFGFFEEDGEEAFFFEEDEDEDGGEFFF<BFEEFFEEFCEEEEFFEFFEDEFD	A	58	C	45
2	212576980	T	53	tcttctttccctcttccCtctcttccctcCctttttccttctCtcccctcttc	CC?@DBAEGFGCGDDGGGDGDGDDGGGDDGGDDDBDGG?DGDGDGGAHEGE9H	C	27	T	26
2	213886454	A	40	ATTAAAatAattttTAataatatTAataaTatttttttat	ABEDEDCDFDDDDDEFDDDCDCDFFE?EEGEEEE8EE<==	T	22	A	18
2	214012405	A	153	ACCAaACCCCACCaAAaACACCAcCACCAACaCcAACAcACcCcccCCcAcACCaaAcaccACACaACAACACCcACACACCCcaCCaAcAaaAaCCcccCccaaCCACacAcAAccCACAAcACCAcAAcCCaaCCCcCAAcacAAACAcAa	AD<ADDEGGGEFGDFFDFGFGGEGGFGDCBGDGGF@GEGFEGGGGHGGGFGFDGADDHAHHEG=FEFGFEGBGGHFGFGEGBGHEFFEEBEEEEEGFHHHFHHEEFFEFEGEHEEHHAEFEDHEFFEHEEHFFDDFEFHEEEBAGECCBAC?B	C	84	A	69
2	214727221	A	86	CAAcCCAAcCcCcaCcaCAacacacAAcCAaAAaAcACCcCCCCacaaAaccacccCCCaAAcaaAAaACaAACcaCaacCcAaCc	DAFDDFFEDGDGD;GDEG<9DFDED>?EGFFFFEEEBGGEGGGFFECEEBEEFDEEFFFEEEFFFEEFEFFE:FEFFAFEEDE?B>	C	44	A	42
2	214727367	C	35	GGcCccCCGGcccgCcgggcgcGCCgCgccgCgcc	D@BBECGGGGDD:F>DFFBDFEGGGC6FDE:FGED	C	21	G	14
2	215634055	C	38	cCCccCTctcctcTtccCttcctcttttCtTcCcctcc	CB@BBGEBFBBGBGFBAGHHCCHBHHH89GFAFACHAA	C	23	T	15
2	216272819	C	27	CGCGGCGCCGCGCCCGGGCGGGGCCGC	DGGFGGFGDGGFFFFFFCFFFFFCCB?	G	14	C	13
2	216298084	G	194	AGGGAaAgAGAAGAgaAGAaGGAgagAAAAGGAgaGggAaAgGGAAgGGagaaGAaaGAGAAGAagGaaAGGggAGGggGaAAgGAggGGgGaAaggggggGagAaaAagaAgAGgggAAagaagaaAgaggAaAAgAAGggGgAgGGAGaaaaGGaAaAaggAagaaaagggaagagGAAagGggAgaggGag	B>;;;CDEAAGF;AFCH=H=C@HFDFHBHHA=HDD<@FEDHFACH;FDCDFADAHDDCBCHHCHDFCDDGCCFFHCCEFCDFHGCHGG5BGCEHEGGGGGGAEGGEEHEFEFGHCFGBHHEGEEGDEHGEGEHEGHG?GBGGBGGGBBGBEE<DABEGEGEGGGEGECEEGGGEECAGBGGCDBGEFA=A<=@@	A	97	G	97
2	216298230	C	34	tTttctctttctttcttttTttcctctctttctc	??CCCFEDDEFEEEEEEEEFFEC?FGEGFG:GFE	T	24	C	10
2	219082330	A	75	gAaaggaaaGgAGaGAAAAAGAGAgaGAgAAGAGgAaAagGGGAAAGAAaAgagAAaAaGAAgGAaaagaaagag	FEFFFFFFFGFFGFGFF?F?GFGFGDEEGFDGEG?EGFGGGGFEEEFEEGEGEGEEGE9?EDGFEGGFGGEB@DD	A	47	G	28
2	219140288	G	52	CgCGGgCgCCGggCggcgGccggggcGccccgGGgcggggcgcCcgcCcggG	AACBCCDCD=CCC@CCBCCBBCCCC<CCBCCD@CDCDCDDCDC@DDCCB@<?	G	30	C	22
2	219144149	G	30	gAgaaaaAaaggggggggaggggaaaaaga	C>AEFEFEFFFFFFFGGFGGG;GGGGFE=<	A	15	G	15
2	219232354	C	31	AccAccCcaccaacccaaccAaccaACAcCA	=>>C?AF@FBBFF8BBFFCCEGCCGDFECCA	C	18	A	13
2	219250003	G	260	CGGGCgCcgCCCCCCGgCCGGCCCGCCCcCGGGGGGCGCGGGccGGGCgGGCGggCGGGGGGGgGgCGGCGgGCCcGCgCGCcCGCGCCGgCGggccGGGggcgcCccGgCCgggcgcGGGcGGcgCgGgccgcGggcCcGcggccgggGcCggcCCGGGcCCGGGGCCgCGCCggcCgGcGCgGGCCCGcgcCCGGcGGcccCGccgCgggcccCGGGGggcCGCccCGgCccgGCggGcGGcgCCccGggccGCCggg	@@@@:DAEEEEFFFEEEGFEAFFFEFFGDGEEEDEEEEGAEEDDCDEGDEEFEFEEEEEEEEEEEFGEDFCFEGGDEFEFEGDFEGDFFEGGCFGE;BBEGFEGEFEAEFGGGGGEFEEEEEABDFGGE9EEFEEFFEGEEEGGEEBF6ED?GE:GGAEDEEEDDDDEEGEDFEGCEEFDEDEGDADFFDEGDEDDDEDDEEDFDEEEEGFGEECFDDDDFFDFDFEEFCFEEDFDEFFECDCABCB@?ABB@=@A8>DD	G	140	C	120
2	219252377	C	67	TCtcCTTctcTtcTttTccTCtctcCtcttccccTttcctTTctccTTtctctttccctTttttttt	DA?>?FEEECGDCGDEGADADEDECC=CEEEEDDGEEDDEGFEFEEGGFDF?FEEEEEBFFBFED9<	T	40	C	27
2	219256026	T	60	TttTttttTTttttTttTTTTTTTTTTTTTTTGTTTTTTtTTTTTTTgTgTTTTggTgTT	ACC>BC>EC<FFGFEEBEE7EEFFFDDFDFDE9FFEFEFBBEFF>EE=E@EEEE:CA>AB	T	54	G	6
2	219259270	G	43	AGGAAGGGAGGGAAGAGAAAGGGAAGAGGGGaAGGAGAGAGGg	>CGEEFGFCGGGEEEE=ECEFFFEEFDFEFFEEEEEEEG?BCD	G	25	A	18
2	219294684	C	44	cCCccccccccCcCCCCCCcCCCCCCCcgcgggggggggggggg	C@<<>?98>@:E?GGFG@F@F>GFGGF@D;8>?DCD9?9BA=?;	C	29	G	15
2	219501133	G	181	gaGAaAAggAAggAaAAAAGaaGGGggaGGaaaAAgAGGAGAAAGAaaGAggAGaGaGGagaAAAgAGGGAAGAAGAGGGAaggaGgGAGaAGAGgAAagGaGAAaGAGAAaaGaggAaGAagagggAgaGAagAgggaaaaggggAaaagaaaaaGagGggggggggaggggaagAaAAg	CA@?>=BDDDD>EF@FFEED<EEEEFEEEECEEFDF=EEFEEFFEFEEEFFBFEEF?EEEFEFFFFFEEEAFEF9E9EEEEEFEFEGEFE=FEFEAFF=FEFEECFEFEEFDFEEAFFF9EEGFGGGFG89EFFEEFFFECFGGFGEFF:GBEFFEDFFDFGFGFGFGFDGGFFCECCBBE	A	95	G	86
2	219509618	C	115	caaaaacccccaCcCcaaCAAccCcaAaCcCCACccacACacaacCCCcaaCAcAccAACaccaAAAcAaccCccACaAaCacaacaCCACacCAcCcCACAacacCCCcCAccc	CCC>?CECCDCEECADEEA?FCDGACF>GDG@DGDDE>F>DDEEDGGGAEFGFDFEEEAFFEEFEFF?DDDEFDEEFFE<G=EFEEFGFDEGEFEEEEFBFDFDF?BFEAB:>>>	C	67	A	48
2	219545309	T	287	cCCCTtCTTTCtCCCCCTtcTTTCTTttCCcCtCTCCTTTtcTTTTctcCcTTTTCTcCCtCTCttTCTCTCCCTttTtcCTTCCccCTttCCTCTctCCTTTCcTCTCtctcttcCCcCctcTCccCCTccTTctTccccCTTCtCcCcttCTCTCttTttTtcctcTTCcCTccCTctCTTTttTCTCTTTcCCTTTTTTtTTtCCttTCCctCTcttTCCtTCTTctccCctcTtcCCtcctTtcTCcTTTTCtCcTTctcCTCcTCCcctTctcTCttctttt	?>?<@B?ACCCEDDDDDGEFFFFDAFEEDDFDEDGDBEGEDFFGGGFEF;FFGGHEHFDDEDGCEDGDGDGBDDGEEGEGDGGADGEDGEEDDADGEDDDGGGDGFDFCFGFGFFGCDGCBFGGDGGD7GFGGGGFGFFGGDGGCBCGCGFFCFDFCFEGFFEFGGEGFFCFDFGGCFGFCFFFFEFCFCFFEGCCFFFFFFFFFECCFFFCCGFCF>FFFCCFFCFFGFGGCEDFFEGACFEGFFFFFCFFFFDCECGFFGFFBECFGCCEDDECB@DA@>DB@CC	T	148	C	139
2	219609995	G	63	ccgcgccgccccgcgccccgcgcgcgcgGggcgcccgccgcgccgggcgCgcggcgcgcggcg	ACCACC?=:=>==9A<A@>CA>BCBCBCCCCBCBBBC??CBCBBDDCBDDDC>DCDCDCCDA?	C	34	G	29
2	219890955	C	38	TctttTtCcTCCTCCTTcccTctccttccctccttcct	=>DDE;EDDCEGEEGEEDDDE@FEEF9EEEFEEFEECF	C	20	T	18
2	220037444	G	54	GggGAAAAAggagagaAaGagaaagaaggagAggAAaGaagaggggAaaGaaaG	B??CDDFFDCBFCFCFFFEFCFFFCGGDDGDFDDFFF?GGDGDDDDEFGDGGG=	A	30	G	24
2	220041455	C	34	TTTTCTCCCCTCCtTtCtCTTTCCTTTCCTCcCT	?GGGDGD7CBFCDHFHCGCFFFCCFFDCCEC>@A	T	18	C	16
2	220083279	C	102	ccCTtTCtttcTcCCCcTCTctCtttCttccTttTTTcctttCCCcTcttcTtCTtctTttTtCcCcCtCTctCttTCctcTTcCcttcTccCtcttTcttc	???>?ECCDCG?GDBDGFDGBDCDDDDDDGGGDDGGGGGDDDDDDG>H=EHFCDGEHEGEEG:DHDGDEDFHECEEGDGEHFFHCFEAIFHCCEHDEEHEED	T	55	C	47
2	220118531	G	66	cGgGCCgcGGCGGcCgcCCCGGcgcCGGcCGGGCgCccCGCCcgGCCCggGccccggggcCggcgg	A;CEGGFGGDEEGGBFCDDGGFGGGGGGGDGGGGDFHGFFDFHFFFGFGEFGHFGGEGGHDEEA=D	C	34	G	32
2	220136351	G	150	gAGgaGAGggGGgAgagaaaAgAGgagagaagggAGGAaAgGgGGgAAAAgaGaaAagGgGggGAaGGaGAaaGGaaaGAGAAGGGgggGAGAGAGgAGaAGaGaaGAGaggaAaAggGaAgGAAAAGAGgGgGGaaGgGgAAGaaGAGa	@>:BEECECBGGCEBECFFFFCFGCFCFCFFCCCEG=GFFCGDGGCFFF:DFGFFFFCGDGDDGEGGGGGFFGGGGGGFEGFEFFFDDD=EFEFEFDECGEEHFGGFE>G@DGEGEADFGEDFBEDE?EFEEDBEFFFBEACBCB?AA?D	G	81	A	69
2	220168607	C	101	tCctcCCTCtcCTCtttcCcctTCtccTCTcctTTtctccCcttTcctccCtCttcctcccCCcccccCccctcctCttctttctttccttccttttttcc	CB>C>DFFEGBGGGGGGBGBBGGGGBBFFEABGG@GBEBBGBGCGBCHC;=7GHHCBHCCBGGCCCCCGBBBABC@GFHCHH?<HGH@CHCCCGHHHFE;?	C	57	T	44
2	220168616	C	92	CTCtttcCcctTCtccTCTcctTTtctccCcttTccCtcctCttcctcccCCcccccCccctcctCttctttctttcctccttttttccctc	D?=?CADCDFEGGEFFGGFFFDGBEF:FFG>BEGFGGCFFEGEFGFEFEFGGGFGFGGGGDEGGEG@EGFFEADFFGDFGGFFGFFFFGFE@	C	52	T	40
2	220197321	C	64	CCCTCTCCtTcCTCTtTCTtCTTTCCTCctCCCCTCcTTTCtCTcTTCCCCTCCTTccCCTcTC	BGG=GEGGFEBGEGEHEG;HGEEEGDDFCHFFFFDFCDDDFHFDCDDFDFFDFFCD@ACB>;CC	C	36	T	28
2	220197424	C	127	tTtctcCTctCTTTTTtCtcctcCCCccTTTcttTTCCTTTtTcTcTcTTcCtTCTCttCcCTtctcCTTtttcCccctTtCCccTTttCtCtTttTcttcCtCtCtCCcctTCTccttCCccTTcT	CAB?HBDDBGGFFCFFDFGBBGBF>?BBEFFBGBFCF9EFEGFCFBF9FE?FHF?EGHHGCGEGCHCGFEEEG<E:CCHFHFFACFEGHFHEHBBFECHHCFHEHEHEFCCHEFDC=HHFFB@BB;A	T	69	C	58
2	220402671	G	41	gGtTGGTGTGGTGGGTTGGTTGGGTGGGGgGGtTTTGTgGg	CAGGCAFBG?CGCCBGGCAFFBBBFBBB@DBBGFDA=C;CA	G	26	T	15
2	220416942	G	66	ccccCGCCgcgggggccgcGggccgcCgCCccGccgCGCcCggCgcccgcgcCcggccGccccccc	C?<>??<BB@BCBCABBCBEC@BBCBFCG@BBFBACGEGBADBFCCCCD5DCGCDDCCECC>CB>>	C	42	G	24
2	220417228	G	56	TGGGTGTGTTGGGtGTTGTTGTTTGTggTttTGTgttgTgTtggGGtgTtGGTTGG	FEDEFEFEFFDEEHEF<EEAD;EFAFCDEGHFDEDHHDEDEGCD=DGD>GDDEDC>	T	29	G	27
2	220422774	A	152	GgAGGAgaGAgAAGaAAaAaaaGAgAAGGAgAAGaggAAgAGAAgagGaGAAGgAGAAGGAgaAggGAGaAaGAGAgaagGAgAaaGAgAAAGGGGGAAAGGGAGaAAaaGAGaaGGGaAGaaGAaaaAaaGGaaGgaagagggAaGaGAAG	>ABBAGDFC?CHHCFHCF=FFFCHCIIBCCCHHCFDDHHCHCHGDGDCGBHAC>HC@HCCHD:HDDCGBGHGBFCHDGGDCHDCGGCFDGGGBBBBBGGGB>BGB6GGGFBGBEGBBBCBBGFB5GGGGGE@BGDBDDGCGB@>D;<?CC@@	A	85	G	67
2	222307534	G	155	TTtTTGGTGGGtTGTGTGttTgttGGtGtGTggTGTTgTGTgTTTGttTtGTgTtTgGtGGTTGgttgTGTGgTggtTTGGTtTGtTGgGTgGGtGGgggGtGGTGGGggGtggttgggTttTtTGTTTtggGttTtTgGgGGGtggTggGtttt	C@DEFEEFEEDGFEFCEEGGFCGGFEFEGEFCCF?FFDFEFCFFFEGGFE:FCEHFCEHDAFEEDHHBFEFEDFDDHFFEEFHFEGFEDEFDDDHDDDDDDHDDEDDDDDDH>EIHCDDEHHEHEDDEEHDCDHHDHDDCDCCDE?A@?>ACABC	T	78	G	77
2	227659840	T	45	ttttTtttTTTTTTTTTTTTTTTTTgggggggggggggggggTTT	C?FFDGFGBAC:;BE@FEEEEEDAE9@D8D?8CCCD9C9AADDBC	T	28	G	17
2	227659846	T	40	tttTTTTTTTTTTTTTTTTgggggggggggtgggTTTTTT	?CB8=EFFDF;FADD7EDEC>9::8=D@B?;D@9EDEDDC	T	26	G	14
2	227872182	G	64	agaaGAagGGagAGaGggAAggagaaGgaagAagAGAGGGaGgaGgggggGaagggaaggggaa	A@DCBHDF=BDFHCD?DFHGAFDFDECFDDFHEEHCHCCBDCGEBEEGGGBEDGGGEEGGFEA@	G	37	A	27
2	227886773	A	70	AAAAAGagAAGaGGAaGGgaGAaaAGGAGAaAaaAAAGAaGGGAGAaaAAgAGaggAGAGGgGaaAGGGA	ECE:FDFCFFBFE@EFEDDGEEGGFEEFEF:FDGFEEDEGDDDEDEGGAE<EDCDBEDEDDCDGGFAABA	A	41	G	29
2	227896976	C	45	CtttCcttcTcTTtcTccttctcttCctCCTTTtTtcTTCctttt	>BBCDCEEDFDFEEDFDDEEDEEFEFEFGGFD@FFDEEEFFFFE@	T	28	C	17
2	227954599	G	68	GGggAaggGGAGAAgGgaGGgAAaAagAaaggagAaagGggaGgGaAgggAgaGAAGagGgaagAggg	B=ABCFCCEAFDFE6ECFE@CFGFFFCFFFCDE=FGGDE?DGECDFFDD?ECGEEEDG@DDGFDDB>?	G	39	A	29
2	228102723	G	98	GcggGCggCCgCcGgggcCccgcGCGccGGgcGgGgcgcCcgGGccCcgccggggCCGcgGCGgggcgcgcggGgcggGggGggcCGggcGggggggg	6:A;>?CCBBCCACCCCADBBCBCACBBABCBCCACBC9EACCCBBDCDB?DDDDDDCCDCDCDDDCDBDCDDCD=:CBCD;DDCCBDDCBD@DDDCD	G	62	C	36
2	228220528	T	28	cCTtTtcccTtCtttttcctCtcttctc	BFEEGEFFFGEGEEEEEGGFGEGEFGF<	T	16	C	12
2	228783479	C	124	AAACCAAACCCACAACaCcAAAACAAAcaCCACaaCAAAAcCCcCACcACACACaCAAAaAacCaaCAaCAAACCCAacacaCCCAAAaacaCCcCaaAACCACCCCCAccACaAacCAAacaa	B>DCDDHHBEDFDIHDED@HGHHDHGHDEDDEDFFCHHHHADDDDHDBH8GDHCFCGH<EG?ECE>BGFCGGGCCCGFEFEECCCGGGFFE>CCECEFGEBCFBBCCDH@DD9BC=9@AABBBB	A	68	C	56
2	230092889	C	73	tcTCcTttTTtTTCctTtTccCttcttCttTtcttCTttcttcCCTTtcttcccctcctttcttcttcttctc	CC@?>B>ABFGGGCBGGGGBBDGGBGGDGGGEBGGDGGGBCGCDDFGHCDHBCC?FCCHHHCGGCHGCHHBHC	T	45	C	28
2	231067532	C	47	ctTcttttctccttttTttctcCttccttcCtttttctttcccttcc	CC>DFFEEDDDCEEEEFEEDEDFEEDDE?DFEEFEEEFFFEDEEFA?	T	29	C	18
2	231223813	C	129	TcCCTTCCctCCcCcctccTtCcTTtCCccTtTTCcCCCCCCcTcCcTCCttCCcCtTCtTCCttTCcTCtccCCtctcccttCTcCCcccCccttcTccttCCCCCtTCccccTctcctctcctcttc	=>ADGFDDBGAD@DBBGBBFGEBGGGDDB@GGGGDBD>DD>CBGCDCG>DGHDACDHF?HA8DHHGDCGDGCC@EHCHCCCHHDGCDDBCC@CCHG7F=CHH@CCCCHFC?CBCECHBAFCF??C=A;8	C	83	T	46
2	232263127	G	188	gaAaGaaAGgagggGAaGGGAAAggGaGGGaaggagGGaaaagaggGggGgagGAgagGgggAAGGGagAAgaaggggggAGgaAAGGGGAaGAAAGAGggaggaAaGAAggGgaaaagggGaGGGGgaaAaGAggaggGaAGaAAgGgaaGGGGGaaggGAAAAGgAgGAAgggAAaagggggagAA	BC<B?FGG>EEFEFCGEC57HGCCDCFCCBFFFFDFCCFF@EBCFFCFFDECB5HFFFBFGFH;?CCFFHHFFFFFFFG>G@C@HHCCBBEECAHH=HCGGEGGFHG=GHFFCGFEGGGCGBG>BB@GGFGFBGGGGGGBEEBGGGGBGGEBBBBBGGGGAGGEGBGFDAFFFFEDEBA=A@;??AAC	G	107	A	81
2	232458818	C	48	TtcCtTcctTcCttctTCcTTcCTTctTctttttttcctcttctCTcc	B?>CDFAAG8BGGGBGGGBEGBGGEBGFBGCGHHEH6CCCGECHFFAC	T	28	C	20
2	233322875	C	122	CCCTtTCCTTTCTTtTCTTTTTCCTCttTcCtCccTtcCTTCTTCTTCTCCTTttTCTcCCCCttCTctCcTtCCTTCCTtCCtTTTtttctCCtTcTTCTTttCTTCtcCttccTTCccCt	@=EEGFGGFEFGFEGF>EEBE;EF@FGGEB?HGBBEF?CEFFFFEEEGFGGFDGBDEFBFEFEHHGECHECEHFFDEEFEHFC9EEBHHHCGEEAECEEEDEH=FEDFHCFHHCCDED?=AA	T	69	C	53
2	233385202	C	26	CCTTTCcTTTCCtCTCccTcCcTCCC	DBGGGDCAE5DCHCFCCCFBCCEBCD	C	16	T	10
2	233408283	C	281	CcTTCCTcCCCTTtTTCCTcCCCtTTTCCTTTTCCTTCTCTTTTCTTCtCCCTCCTTCTCCTTCCTTCCTTTTCTTCTCCCCCTCCCCTTTcTCTtTCTTCTCTccCTTCtTCTTtccCCCTCCTCcctCCCTTTCTTCcCcTTCTtcCCctTTcctcCTTCTCTcCCCcCCCTTtCCCcTCtcttCTcCCTcCTTtcCTtTCCCtCCCTCTtTCtttctcttCTCTCccTTCTCTTTCCCCtccTCtttttTCTTTTcTTCctcCCtcTCTCtCtTCtCc	ABB@@@BBBDC8FEGGCCGDDADEGGGDDGGGHEDGFDDDGGGGCG=DEDDDGDD<GDFDAGGDDGGDDFGGGDEFCGDCDCBC8DDDGCG?GAGFEDGG@DDGEEDFGDFGDFFFE8CBDGDDFCDEFDCCFGGDEGCDCEFFCFDECCEFFFEEFE@FGCECF@CCCECCCFFFCCCAFB>FGFCFFCCFECFFFECFFFCCCFCCCFCF@FCFFEDFEEFCFCECCEFFB;CFFFCCBCEEEECEFEFEEBFEFEEEEBDEDAC;CDCCCBA@D@>CB	C	144	T	137
2	233835088	T	121	cttcTCCTTTTTTTCTTtCtCTCCtcTCCTTTccTcCTcCCTTtctTCCCTcTtTtCCtTTcctTCTCTccttTTTtcCcCCCTCTTTCcCtcTCttttCtTTTttcCCtCtTcttccTcT	ABBB>GGEEE=EECGED>GEGEGGEFFGGEEEFFEF8EFGGEEDFEDGGGEGEFEFGGEEEFGFEGEGBGFFFEECCFFGFFGDCDADFFFEFDFFFFFFFDDDFFGFFFF:D?CFFECCB	T	68	C	53
2	234054936	C	181	tCtccTTtcttTTCCCtcTTCctCctcCtttTTccccCtCcCCcctCCtcttCCtctccctcctcttctTtctttcctcTcctTtctCcctccCctTcccccTCctcctTccccttttTTTccccTCtttctccCcTctttTcCTCTccCCCCctccCTtCcTctcCcctttcttTtttTt	A=BBB>@A>DFFE:DBEFGGDFECFEFDEE=FGFFFFDDDFDEFFEDEEFDEDDEG:FEFEFFEEEEFEBEFEEDFFEFGFGEGFGFDGGCGGDGFGGGGGGGDGFFGEGFGGGFFFFGDGFGGGFDBFFGFGFDGFGEF@AGCGCFCGCC@CGFHGCFFCGFGEGCGGFFEFAEFBA=DB	C	97	T	84
2	234067089	A	53	gggaGGggggAaGgAgGgggAaaaAggggaggaagggggGgGaagGAgaaaga	CCDDFGFEEFEFGFFFGFFFFFFEBGGF?FGGEEGGGGGGGGGAGGEFD>GF?	G	34	A	19
2	234078582	G	37	AAGAGGGGAAAAAAGAGGGGgGAGGGAAAAAAAagGA	BCBGCCB<HHCHGHCHCCBBGB=BBBGGGGGCGDEAC	A	20	G	17
2	234590616	C	54	caaCCCcCCcaCAAcCCcACCaacAaaaCaCaacacacccccCacAaccccaca	BADCDBDDDDEDHCDDDDHDDAEDH=EFDFDEDEFEA?EEDEC9EGDEEDDBC@	C	32	A	22
2	234676413	T	43	TcCTCCTCTCTCCCTTTTCTCCTTCCCCTCTcCTTCTTCTTTT	BBDEDDBDGDGDDDGFFFCECCFF@CCBFCFCC@FCEEBEDDE	T	22	C	21
2	234698097	T	44	CTCCTTccCTTTTttCtCcTtCTCCCTTCtCCcTcTCTtTCcCC	DGDDFFCCDGGGEFHDCCCGHCDCCBFFCHCC>=CFCE:C@>A@	C	23	T	21
2	234702520	C	43	ttcttttctctccctctcttcctcTctttttccctctctctct	CBCCEFDCBCECDD9DEDEEDDEDEDEEBEEDDDDBEDFEFEF	T	24	C	19
2	234713681	G	41	TTgTGtGTGGGGtggGTtTTGGTTTTGtGGTTGgTGGGtTG	5FCFEGEFAEEEHDDEDFEEDDEEEEDHDDDEDDECAB>C?	G	21	T	20
2	234738472	G	33	agAaagaggGaagaaagaaaagaaaaggaagaa	AAFDDFCFF;DEECCDFDDE@GBEDEEGCD@E=	A	22	G	11
2	234740985	G	69	gggGggAaaagaagagGAaggggagGgAAaggAGagAagaaggGGAgaaggaggggGaggAaGgGggag	C=A9A@DFFFCEFBFBCHFBCCCFCCCHHF7CHCFCH=CEECCCCHDGFDDGDDECBGDDGGBCBDDG>	G	42	A	27
2	234775675	G	114	TGTTTTGGGTGGGgTGGGtgGTtTTGGGGTtTTGGTtTTGGTGTTTtGtgTGGTTGGTTGTGTtGGTGTGGGTgtGTgGgGggGGTTttTTtGTTTTTtGGTTgTGTGgTTttt	C@@E=FDEEFEEEF@FEDEF9EEFFEEEEFEEF?DFEFFEEEEFFFEDFFEDDDEEDEEDEDEFDDEDE6DDEFFDEEDFDGGDDEEFFEEFDEEEEE;DDEEFE<DBCCBAA@	T	61	G	53
2	235950391	C	179	TctTCTCcTtcCTTtCTCTTcCTtCTttTccTTCTTTcttTctctTcTtTTCttCtcctctCCCTCTttttcctCtCtCttTtTtctcCctttTttccctcCtctcTcttTccctttttcccCCCTCCtTCCCtttTTCtccttTTccccttCcctttcCTCtCTcctctttttTTtcc	DCCB<?<=AE@BEEHCE?@GBDGFDG;FGBBGGDGGDBGGGBGBGGBGGGADGG@GBBEBGEC?GDGGGGGBAGDHDGDGGGHGGCHCC=HHHGHACCCH?DGBHC;CGHGCCAFHHHHCCCCDDGBCHFCCCHGHFFCHCCHHFFCCCCH9CCC8IHCCFCHCFCADCHHGDEDD@>@	T	102	C	77
2	235951819	A	64	aaagGaagaGGgAAaGgggGGgGaaAggGGGGAagaAaGaAGAaagGAagaaggggaAAgagaG	?CCCEEECFFGCEEEHCCCBHCHFFEDDHHHGBGDGEGHGEGEGGDGBGDGGDDDDGDDDGEFE	G	33	A	31
2	235962210	T	65	CtCCCtTtTtCCCTTCtCTtCcccCTCCCTCCccCCtcCtttCCTtTCTcCCTCcCcccCTCCCc	@B@DFDEEFEFGGECFEGE>GGGFGD?GGDGFGGFDFGF?@FDFDFDFCGEF;EGFECDC;@C?C	C	42	T	23
2	236433161	G	100	AAAagAGgaaGAAgaGggggaaAaaaAagagaaagaAAAagggAaggaggGGagaGAaGaaggagggGagggaagAagAGaaaGGAaaGagAaaaaagag	@CCC;@>ADFBHGBFACCCCFFHFFFE5CFCFFFCFHHHFCCCICCCFDCCCFCFC:ECGFCDFDD=CGDDDFFDHFCGBGGGBCGGHBGDGGGGFGDG>	A	57	G	43
2	237123384	C	28	cCccCCAaAACAcaAAccCccaAaacCA	BGABFGFFBFFFCGFECBGDBFD>@>@C	C	15	A	13
2	237395443	C	33	CCCCGCCGCGGcGGGGCcgCccGGCcgGCGCCc	CGGEEGGGGGFD:GGEFEGFEEFFF@FFFEDB@	C	19	G	14
2	238247734	C	57	GcgggGgGggCgGggCgGGCgcCCccgcgcGccCgCgcccgccgggCcggccccccc	DBA<GFFFEEFFHFFGFHHGFFFFFFEFFFHFFAGEGGAGGG;GGGFGAHGBCF9FB	C	29	G	28
2	238250839	G	35	AgGgggGggAAggagagggaGaGaaAaaagaggga	DBAFFFC5FG7FFFFFFGGGCF@GGGFFGHGGFE?	G	20	A	15
2	238453986	C	46	CCTCCTCCCCTTTTCTTcCCCCCTtCctTTttcctTtTcttcCTTc	?DGDDGDBDDD=<FDGGEDDDD<GFDEFFFFEDEFFFFEFEECDAB	C	23	T	23
2	238494494	C	26	TTTTCTTcTTTTTCTTCCTCTCtTGC	CGGGDGGEGFFFECFFCCFCFCBC=?	T	17	C	8
2	238636606	A	27	gAGGaaaGggggaagaAaaggagaggg	>EFGDCDGFFFFDDFDFCEEGEBEGEE	G	15	A	12
2	238664884	T	33	ttTccTcCTttctcCttcttccttccttttctt	BAACDEDEEEEDED@DEDFFEAFFEEEFFFAEA	T	20	C	13
2	238668802	A	182	AAAAAGAGAAAGGGgAGAGgAAAGAGGAGAgGaAgAaAAGAgGGAagAAGAgAGAaGGAGGaaGGGGGaagAAAAggagGAaAgAGGAAgagGAGgGAgAagGGAGgaaGGGGAAAaaGagGGGGAGGGGAGAGAgAGAGaGaGAGAAAAaaaAAggGAgAaGAGAAGGGgaggGGaGAGAG	CDDG@CHCHHH>CCFHCH>FHHHC@CDHCHFADHFHCCHBHECCH=FHHCEGHCGECCECCEECCCCCEEFFHGHGGAEBGEHGGBBGGAEGC:BGBGFGAG<BGBGEEBBBBGGGDEBEEABBBGBBBBGBGBGGGBEBEBEAFAFFFFEEEFFFGBGEEA?@?EC>==A>@?>=>ACACC	G	92	A	90
2	239007850	T	109	TTATAAtTTTTTATTtTATAtTTaTATTtAatTTtAAtTTATtTTAAATtTATtaTttaaaAttattaTAattTAAAtAAtaTattAtaTtaAAttTtTataTttaTAT	CEEEEDDEEB>EEEEEEEF8DEEFDCEEEDFEEEF@E@EEEEEEEEEEDFDCEFFDFFAGDDFFGFFGDDEGFDDDDEDDEEBGFFDFDAFGCCFFCFDFEFDBA@B?C	T	67	A	42
2	239054504	G	94	GGGTTgTtGtgTTgTtgTTTGGTtgTtgtttGtTGgTtTtgTGgTGtgggtgTGgtGtgtGGtgtgGgtggtTGTggTttGtttgttttTGttg	AC@@AC@DDDEE;F=EFFFEE;FEFEEFDEE?EFEFBFFDGF?F:AEFFGFG=EGE9FFFDEFFFF>G@GFADDEGGEFFD>9FFFFFEEDFF?	T	52	G	42
2	241439809	C	54	AAAAAACCACcAaCAAACCCCAAAAACCACCAAAAaaACACCCACCCCCAAaAA	GGHHBG?DHDC@GCHHHDDCC?HGGGCCGCCGEGGGFG@GBCCGBAA@?@@@C?	A	32	C	22
2	241700318	C	67	CCCcTCCTCCctCcCCCTccTcctctcttcttcCcccTtcctcctCttctttttctCttcctccttt	A==@B@?CCDDECDDDDGDDGDDBDE=EDDEDDDDDEGDDDE;EFDFFEFFFFFEFCFFEFFEEFC>	C	38	T	29
2	241702561	T	40	TtTTAATAtAaATATTAAAATtATAtAATATTATTTAATA	EEFF:FEDEEFEFEEEEEEEEFEEEFEEEEEEDD:BABC?	A	20	T	20
2	241815307	C	98	CCCCTTCCCTCCTCCCTCTTTTCCTTCCCTCTTCTTTCtTCcCTTCCTtCCCcCCCCcCTtTtcCTcTTTTTTtTCTTTCcTTCctTTCCccCTTctC	BBDD@FDDDGCEHDDDG?GGGGDDFGDDDGBGGDGGFCHGDCDG8CCFHCCCCC8CCCCFHFICCFCFFFFFFHFCFFFCCFFCCHFEBCBADGF?E?	C	51	T	47
2	242179134	G	191	AGgAgAAAGaaaAAgGaaaGGGGaGagAggaggGGAgAaAggGGAGAAGggGggAGggGgaAaGAAgAAaagAaGAAGgggAAAagGGAAAAgAagAggAgaaGaagaGGgaAaAAAaagGgGAAGAagaAAGAAGgGAAaaGaGaagggGGagGAGgGAaGAagAGAaAGAAgAagAAgAaaaGAGaaGG	A;BA<BDFBEE6HHF7DEECCBCECEDHEEEDECCHEHEHFFDCGCHH>FACFFHCDECEEHFCHHBHHEEEFECDHCGFGHGBFGCBHHHBFH@EHGGHGFDCFFFFCCFFGFGAGFBGAFBGG=HDGFGGBGGBG@GGD8BD=FFGGFBBFGBG>FBGFBGFGGBGFGBGGFGFFGGFF9DD5B==A@C	A	102	G	89
2	242396033	A	42	GGGGGGGGGGGAGggGGGGGGAAGAGGAGGAGGGgAGgAGGA	=BCCADCBACCHCFGABBBBBGGBGBBGBBGBBBGGBD;=CC	G	33	A	9
2	242402061	T	74	TTAAtaaTTtttAttTatATataaataaaTttttaatAaaattatatatttaaatttattaattatttttaaat	BB==EDDECDDDEDDEDDCEADDDDDDDEEDDDDDDDEDED?DEEECEEDEEEEDDEEDDEEEBEAEEEDEED?	T	41	A	33
2	242659067	G	56	agaagAggaAAggggaGgaGaggaAggaaGaggaAgAGgagaagaagaaaggagaa	?BFGFHFFFFGF<FFFCFFAFFFFHGFF@CFFFGHGHC=GGGGBGGGDB@GGEGBA	A	29	G	27
2	242680375	C	43	CTTCTCtCTCTTCCctCCccTCCcCCcCcttctTctCTTCtTC	B9A9E?EE@EEAAGGFD8GFDFFFFFGFGFEGFDEFFDDEA@C	C	25	T	18
2	242684115	T	58	CTTTCCTCCTCcTTTCCTTCCTCTCcTTCTctTTCCTCTCTCTCTtcCTCTCCctcCC	DDEEGDEGGDGC8EEGEEEEEEGEE=DCFDCGDDFFDFDF<FDFDHCFDEDC9>B>BB	C	31	T	27
2	242757820	G	78	aaGaaaGaaaaaGggggAaggGggaAaagaaagaggaAAaGggAaGgAGGGaAGAaGGagaGggaaagAAgaAgagAA	BC;FFFCFEFFECCCCCHFCC?CCFHCF@FFFDFCDEHGGCDDGGCCHCCCGG@HGBBGDE?DEHGGCGGDGGDG?C?	A	43	G	35
3	2671119	A	68	AAAAATTTTATTATTtTtTTtAATTTTAtAtTTTTAAATTATatAtAaTATTAAttaTTAATtAAAAT	DFFEFFGGGFFFEGGFGEGFFDEDFFFEFDGFFFEEEEFFEFFAEFEAFDEEEDBAAACBCBACA<?@	T	39	A	29
3	3078814	T	236	TTCTCCCCCCTCCCCCTTTCtTcTcTCCCTTCTTCTCTCCTTCCTccTCTCCCCTCCcCTCCtttTTTTCCCtTTTtTTCCTtTtcCCCCTTccCCtcTCtCcTtcCCTTCTTTttcTTCCCCTTCtCTccTTCtCTCccCctCCCTCTcTTctCTTCcttccccCtctTCttccTCTTtcTCCTttCcccctCCcTCTtCTTTCctTCCCctCTCtccccCCcCTTtCcccctcc	@CEBE5GGGFEGGGGBEEEGGEBABEEGGEEGEEGECEGGEEEGDBCEGEGFGGEGGCGEGGHHHEEEEGB?HDEEHDEG@EHEHCGEGGEEC;EGHCEGGECEGCGGDEEEEEHHCEEGFFGCEFGFCCCEEFHFDFCCECHDFFDFDADCCHFDCEDHHBCACFHCHD?HHCBDDDDHADFFDHHFCCCCHFFADFCHFDDDFCGDFEFCHDCFHCC?CDEBFDDDB>><=B><	C	131	T	105
3	3078840	C	268	TTCTTCTTCCTCTCCTccTCTCCCCTCCcCTCCtttTTTTCCtTTTtTTCCTtTtcCCCCTTccCCtcTCtCcTtcCCTTCTTTttcTTCCCCCTTCtCTccTTCtCTCccCctCCCTCTcTTctCTTCcttccccCtctTttcTCTTtcTCCTttCcccctCCcTCTtCTTTCcTCCCcctCTCtccccCCcCTTtCccctcctcTTtTcTtcctCTccccTcTTTctCtcCCCtTCccCCCCCCctcccTccTTtCCCTTCCCtcc	CDA@=<ACBCFDFDDGCDGCGDDDCGDDDDGDCEEEGGGGDDEGHGEGGD@GEGECDDCCGGDDDDECGDEDDGEDDDFGDDGGEEDGFDDD8BGDDFDGDDGFDEDGDEEDDF?DDG8GEGGEFDFGDEFFEEEEDFDFGFFEGDG=FEGADGFFDEEEEFCCEG@EFDFFFCCDDCCEEF@FDFEEEECCECFFFA:DEEEDEEFF?FEFFDEFCFEEEEFEFCFEFCFECCCFFCDE?CCCCCEFEEEEDAGFEBBBDAAAAA@<	C	150	T	118
3	4562667	T	56	TGGGGTGTTTtTTGTGGTggTTTTttGTTgGTGTgTTGgGGGTGTGTtTtttgTGG	AGHGHDHDEEFEDHEH5DGGDEEDFFGCDFHDFDHDDGBGGGDCDGDFDFEEB>CC	T	31	G	25
3	6828364	A	164	AaaGGAAGAgagAAaGGGAGAAgggGGGgGAgagGAGGAaGaaGaAAAAaGAGAGAgAagAgGGGaAAAGGGAggGGaAGAgAAaGAaAaGAaggAGAgAgAaGGaAaGGaGaaAaaaggAaaagaGagggaggaaAaaaAgGagaGGGAaaGggaaAaaAgga	@AD>@DE?GBFBHHFCCCHCH=CCCCCCCCHCF>CHCCHFCFFCFHHGHFCHCHCHCHFDHDCCCGFH@@CCHDDB6GHCHDHHGCHFHFCH<DDHCHDHDHGCCGGGBBG;G?GGGGDDGGGGBGBHDDDGD@GGGGGGGDBFDG@BBGGGB9CFCCA?@?8?	A	90	G	74
3	6903297	C	239	CCCccTCCTtTCCCtCCtctCTCTTTCTTTCTTCCTCCcCTTCTcCtCCCCttCtCTTCTCTCcTTCCTTCCCttCTCcCCtCTTtCTCCttCTTtcTTCtttTCTTCTTTCtcTTTTTCTCCtTCcttTTcCccctttCTTTCCCttttCCCCcctCCttTTcTcccctCTCCtcTCCtccCCCCtcccCTCCctcctcCCTctttCCtcctcTTtTTcctttTcccccctCTccTCc	ACCAA>AFFFDAEGGGFGBGBGEFFGG<GAGBGGGGEGBGGCEFBGGGGGBGG8GGF<EGGGGADGGGGFGFFFGGGGCBGHGGGHGGGGHHCGGHCGGDHGH;FGGGGGDGHCGGFGFGGGGHEFBHHFBBFCCCHHAFFFFFFFHHHHCFFDBCHDFIIEF@ECCCDIFFFFHCFDFHC8FFFFHCABFFFFCHCCHCFCFCGEHFFHCCH@EEEEFCCGHEEB??@8>BAB85A?>	C	127	T	112
3	7456675	C	30	cTCCTTTCCCCTTTCCCCTCTCTCTCCCcT	?GD>GGGDCCC<FFC@CCFCFCFBFB:C?C	C	18	T	12
3	7620828	G	141	GagaAgaGgaaGAgaGgAaAaaAaGgAGgaGgggggaGaaaAGagaGGgAaAgGagGAgagagaaagGAGGagAAGAGGggaAagAGGgGAAaAgAAgAaGGggagGgAAAGgAgagAggaAgGggAAGGagggAAGAgag	=??D>7C:<EFCDCEECFFFFF@FECFECFECCCCCEEFFFFEFCFEECFFFCDFCEFCEDGDFFGDDDEEGCEFEFDBDAGFGCFEEDDDEGDDDEDEGDDDDGDDDBEEDDEDF@?DCGED@DDEEDDGDD9CCB??B>	G	74	A	67
3	8686368	T	304	TCTTTcctTTCCCCTCCTTCTCTcTTCTCtTCTTTtccTCCTtCTTccTTCCcTcccTTTTtCCCTTTctTTCccTCtTTTccTTCTTCCCCtCTcTTCtCCttcCTTttCcCCCCtcTCTcCCCctcCcctCctTccTTTCtcTTCtttTCTCccttCTcttCTTtcTTTTtctTtcTCCtttCCttCTtcctcCTTtccTccTCcctTTCTcccTTtTCTtTCtCTtTccCTTcttcCCCtTCttccctctCCttCCtTcTTtcTTCtttcTCCcTttcTTTTttCTccCccCCtcTTcccc	CA@?>CEBDEB9D@GDDGGDGDGGGGDGDCGDDGGDGGGEDGDDGGGGCGEDGGGGGFFGGDEDDGG=GDGGCGGGDDGGGGGG=DCFD>DDDCGGAGDED@EDHDGGEDDHDDDDEGDDCHDCCHEHDHHEDDEGHHGFEDEGDGDBEEGDGDHHDEDGHEEDGGEHFEGGEHEFDHFCCEEECCEE?DCHHEHCFF?HEGGHFCHHDFFCFHHHEEEFCFEFCECEEFH?CFFHEEGCC9EFCEEHHHEHECCEECCEFHFFEHFFC?EEFEBCGFEDHFFEEDDCGFGCEDAA@CCC;@;B	T	159	C	145
3	8940765	T	28	ctccttTcctttcccccccCttcttttt	C?@CFDFCCEEEDADDEEEGFFEFFEFF	C	14	T	14
3	9796384	G	116	AGGGAGAGAaAGGGGgAAGGgAAAAgGAAgggAGAAGggGgAggGAaAAGaaaagGggAAgaaGgGGGaAgGgGgAgagAgggggaAGagaggAaaaaagGgaGGAAAGgGaaAAG	C8<;B=B9@CDCCBC6HHCCEHHHHEC=HFEDHCHHCFECGHEFAHFHHCBFBFFBFEHHFEDCFCC@FHFBCBFEFBFGEGFGGFGBEGFDDGF?=FFGBGFBBGGF?D@B>CAC	G	63	A	53
3	9831680	G	45	CccgcCGCcggCggcccgccccccgccCgggGgccgccggggccc	>ACCFFFGFFFGFDGGGFGGGDGGDGGGGFFGGHGGHGGGGBHHG	C	27	G	18
3	9834905	C	38	ctttTtctCCCcCCCCCtttcCTcctcCccccctCccc	A@AC<D?HCCDBDDDDDGGGBDGBBGBD=CCCCEC=?@	C	26	T	12
3	9870414	C	64	CTTTCTTCCTCTTTCTTTCCCcCtCCttTCtcTttTcCTtTTTccCCCtcccttTCTctcTCTT	CGGGCGHDDGDFGG>GFGCCDDDFDC@F;BFEFFFFEDGFFFFE?CCCFFEDEFFCFEFCFCCB	T	35	C	29
3	9988175	C	86	TtTtctCTtCcCctcCtTCcctcTTtCcTTcCttTTcCcTTTTttcCccTTcCTcTtttCTttCTTTTCcttCTcTccTtctCctT	@C?B@A>5FBDDDDDDEFDDDEDGGEEDG;DDDEGGDDD8GGFEFEDAEEGEB9EFFFFCFFECFFFFCEFDCFEFECFCDE@=>C	T	49	C	37
3	10442779	C	84	tttttTTctTtttCCttTttttCTTctcTCtTtcCctctcctCtcTctccTctttccctcccttcctTcttttcTtttccCcct	A?C???:CDCDADEFD;FDDDDFEFGDGFGDFDGGGDGCGGCGDGFGDGG@HEEEHCHDHGHBEHEEFHEED<HEE@FEHEHB@	T	50	C	34
3	12856856	A	133	aaagGgGgagagGGgGAAGAgGAgaaAaaGGaGAAAAaAGagAAGaAGaGaGagAGAAgGgaagAAagAAAgAaaggggAagAgGgagGGAaaagGgagGAgGgGgaAagaGagaggAaaggggGgaGaggGg	CBDCBCABFBEBBCBCHFCHCCHCFFGFFCCDBIIHGFDCFCBHCFHCFCGCGCHCAHDADGGBGH>DGBHD;GGDDDCDFDFDBDFDBBHGGGDBDG?BGDBDBDGFHCGBDCG:DGFFCDDD@DGA@@>AA	G	69	A	64
3	13383650	G	146	ttgtggtgTGTtTGGgTgGGTTtGgTgGttGGgGttgGgtTtTGgggtttGGtgTtgGgtTttgGGtGGgtggttggttTgtggGggTTtgggtttGtggtttttggtgGgtgttgtttttttgggTttgttggggtgttgggttg	AC@C@A>@>ACDD8ECFBDDEFGEBCCEGGEECEGGCECGFGFECCCGCGEDGCFGCECGEGGCEEGECDGCCGGDC?GECGDDEDCBAHDC?HHHEHDDDHGEEDDHDDDHDGHDHHHHGHHDDDEFFDHH@DDDHDHHCCBE@<	G	74	T	72
3	13395579	C	127	CCcACCACcaCacacAAaAaAAAAAcaAACAccaCaacAaCCacaCacCAAACCAaaCccACAaCcaAAacAaAaCccaaccAccaAacacAccccAaaacacccaCCCacCcaaACaAaaaacAAa	A@C?<?GDBEDFBFBHHFHFCGGCGBFHHDHABFDFFBAFDCFBFDFB9HHHDDHEFDBBHCHFDCGHHGCEGHGDCCGFACHCCEGG@GCCCCCCGGGGCHDBCG8CCGACCGGGCGGGDFC?DDA	A	71	C	56
3	14174427	A	114	aTTAAAAAATtaTtTAAAtattAaTAAtaAtAAAATaTAAaTttTaAAataATTTtaaTtTTTtaataTaaAatAaatattaAtAatTTtAtaAATatAaattaAtAatAaaaa	CFEFFFFFEGDDGDGFFFDCDCEDHFFDE?DFFFFGDFFFDGEEBEFF=EEFGGGEEEFEGGF6DDC@FEDEEEEEEEEEEECEEEDFFDEEEEECEEEDEEDEECEDCC?9@A	A	66	T	48
3	14939198	G	26	gGAAGaaaAagaAagagaagaggaaa	A>BGBFFFHFCAHECGDGGDGDDGDG	A	17	G	9
3	14958865	C	27	TCcTttctctcTttCTCctcccccttc	EDADGGBGBGCGGEDGDCDC@BCCIH@	C	14	T	13
3	15455717	A	65	AaagaAGAgGAgggAAagggagaagGGaagaAgggagggaaaggaagaGaaagaggggggaaaga	CCA??>;;ACBEFFEFDFFFDFDDDGGDCFDFFFFDGFFEEEAFEEEEGDEEGEGGGEFGFFFFC	G	33	A	32
3	15476011	C	102	CcCgcccgCgCCCcCgCgCCgcgCCgcGcGCccGcCcCgGGCcGCCcGccGGcCcGccgccCcCccgGgcCcgccCggCcCgcgccCGggcCgCCCccCggg	8B>ABGEEDEDDDFDDDFDDFFFDDFFCFC?EFBEDFDFCADFCDDBCEGCC>DG<GDCEGD<DGFGCGGCG:GGCGGDGCGGGBGCBBBGCGCCCGGCFFD	C	67	G	35
3	27204052	G	82	GaggGAGAgggGgAAaagAGgGAGgAaGAGAGGAaAaaAaAGaaggGgGagaAAGaaaGaaaGAGaGaAGGaaagGGaAAAA	@CEEHCHEFFFHFEEFEFDIFHEHFEFGDHEHBEGEGFEDCHFGGGFGGGGGDDGEGFFHGGGDGFGGDFFFFA?GHE@<AC	A	45	G	37
3	27427521	A	94	AGAaaAGaaGaaggagGAaGgAaggaGGGGgAGGAGAAagAGgaggAAagAgAaaGgaaagggAaggagaagGaaagaggggagaGaaagaggg	BA?B>BDDDEDDFEB:?EAGFFCFDDGGGGFFGGFG?FDFFGFDFFGFDFFFFEDGCDDDG:FCEGGCEE=EGEEDG=GAF@EGEFEEEECGA?	A	47	G	47
3	27442336	G	74	aAAAAAAaGGGgGAGAGaAGaAGAgGAAGaaGAaaAaagaaGagAgggggaAaAagGaGggaAaAAGgaaAgag	??>>EDDFEEEFE9EEEFFEFEECFEFEEGGEFGEEGGGGGECGEGDGGGGEGDGGAFDGGFDGDDDGGGD;A?	A	44	G	30
3	28520417	T	42	AttttAAAAaatttaAtTttaatTTaatTaAAAatTatatat	EDDDDHHHHDD;DCAHDGDEEEEGGEEDFEGGGEEFEEE>EE	A	21	T	21
3	29529907	G	39	AGAGGGAAGAGAAAGAGAaGGGAAGaggAAAAGAAgAGa	C:FEEE@EEFDEEEDE@EGDDDEEDFGFEDDECEDECB?	A	22	G	17
3	30713126	T	53	ATAAATTAAATtTTAaTTtTTTAttatattTTAAATtATaTTtatAATTTTtA	;CDEEFGFFDEFGGFEGDED6GEAFFFFFBFEEEEFEEDDEFFAFED=FG>=?	T	32	A	21
3	32766905	A	39	AGGAAAGGAAGAGGAGGGAAAAAGAAAGAAGGAAGAGAG	FGGFFFEGFFFFGGEGFFEEEEEFBEEFEEFFDEDBBAC	A	22	G	17
3	33075695	A	35	gggggAagaagaAGgGGaagaAgggaAGAAagaGa	CBFFEHFEC;FFGCFDCF=FGHGGGGHAGGGGGB@	G	18	A	17
3	33174156	T	74	gggggtgtggTtgGTtgttGgggGtTtgtggtgtgtgtggtGgttggtggtggggtggGggggtTttggttttg	A:GFEEDEFFGDFCGEFEDCFFECEGEFEFFEFFFDGFFGFB6FEGGFGFEGGFGADGCGG?GFFFFGG>DEEA	G	44	T	30
3	33194990	C	220	CCaCCAACAACAaccAACAAaCCaACaaAacCcCCcaaaCAcCaCCcAcCACCAACAACAaaCACaaCACaACAacCaaACCcacCaACcACACCCcaaaAcCaacacCCCcCaCcAACACaCAcacacccCCcCaCAaccACACACccaCcACaCAcaaccCCaaAccAACacaaAcAcCAAcaacCcacacCCAcaaACCcaaacaAaCaCCAAaCac	A=?>?CGDC:DEFFFHHD:HFDDFHDFEHFFCFDDFFFEDHFDFADFGFDHDDHHDFH7HFFDHDFEDADGHDHFFDG>HDDFFFDGHDGHDGDCDGDG9HEDBGFFGDDDFD9DFHFDHDEDGGGGGGGGBCGCFBGEFBGCGCDCGGFCGGCFCGGGGHGCCCEGGGGEC<F8FGGGGCGGGGGECGGFGGCCFGGGFCC@EFGGEGFBCBBEC=?CD	C	114	A	106
3	33195284	G	244	gaGGgAGGgGAAAaggGAAAGGagAaaAGAGGgGAaGAGagGaGaaggaagaAgGGAaaAaAaAGGAAGAAAagGAagAGGgaggGAAAaggGgAgaGaGGGGagaAGggggaaGAAaaggaGGgaGgaagGAgaaagAgggGGgAAAaaAGAGAgGAGaaAgggGGgaaagAaAaaGAGaAaGAGagGaAAGAaGGGGaAGGgAGAGAAAGaaAAGGgGGAAGggGgAAggaagaaAAgggGg	AC=;AA>9B@DDDFCCBGHHACFBHFFHCHCBCBHFCH@FCCFCFFCCFFCFHC@CHFFHFIEHCCHHCHFHFCCHFCHACC:CC:CHHFCC@CHBEAGBBCCGDFHCCDDDGGCHGGGDDFCCDGBDGGDCHDGGGCF8DDCCDHHGFDHCHAGCBGBGGGDDDCBDGGGDGGGGGBGBGGB?GBHEBGGGBGGB@BBGG@BCGBGBGGGBGFGGBBDB>GGBDDBDGFCDEEBGFFB?=<AA	G	123	A	121
3	33418734	G	141	GGTTGGGTTTgTgGTTTGGTTGgTgggtgtTgTgtgTTTGTTGGGGgGGGTTggTtGTTGGGTTGtTgGTtTTgtgGtTGTgGTGGtTttGGTgTtgTTGGGTgtTTggGgtgtGTGggggTGtTgttttttttTgGGGtg	=?DECC=GGGFGFCGGGCDHH=FGFFFFFEGGGGFGFFGCGGCCCCGCBCGGGFGECGGCCCGGBFGGCEF@FGFGBCFBFG>GBBFEFFB=FDFFGFFBABFGFFFGGBGEGFBFBGGGGEBBFGFDCAA><?D?CA?CD	G	71	T	70
3	33600582	A	57	CCCaacCAcAcACAccaACcCAaACaCAacCcACaACcAAaaCAacccaaAcCAcac	ABGFFBGFBFBFHEBBFFGBFFGEGGGFGCFBEFBEF@EEGGFEGC@CGGBCFD@C8	C	29	A	28
3	33866868	A	31	AgaggagaaGagGgggaagagggagaaggag	CCCCFCEDDGCDGFFFDDCDFFGEGEEGGEG	G	18	A	13
3	35785296	T	47	CCTTCTTTCTTTCTTtCCTtTCCTCCCcTCTTtCCCCTCCCcTCTTT	E<EEEECCGEDDFDCFFFCFDFFDFFFGDFDDFFFEECEBB@>>A@A	T	24	C	23
3	37407489	A	73	GGgaGGAGGAGggaAAGGGgaGGAAGgGgaAaggAAGGGGgGGGAAgGAGggGagagAAgAGAaAGAAAGGAg	BBFEGGFHGFGEEEEBGFGFFGGFFGDFGFEFGGE5FFFFGFFFEEFFEFDGFFFEGEEGEFEFEF?DEFC?D	G	44	A	29
3	37778481	G	112	GgCCcCGcggcggGcGcgCGCCgGccGggcGGCCCgCCgggccccgGggGgggcCCcCGgggcCCcgcCcGcggGgcgGGgcccggGccgccgCccgggCccgCgggCCcGc	:@=A?BCCDCBBCEAEBC:EFFCEBBECCBFCGGFC?GDCBBBCBDEDDDDDDCFGCGD>DD?GFB?CECDCDDDDACDD=>CCDDD>CE<C7ECC?BDFCCDFDDCGD>B8	G	57	C	55
3	38087024	C	77	TtCCTCCCCcTTCCTTCCtCCTTcTTTcCCCCcCcCCTCTcttCtctccCTcttcTcCccccccTcttcTTtCCCCc	CFBDF=DDDDGGEDGHDDEDDCGCGGGEDDDDEDEDDGDGEFFDFEEE@CFEBFEFECEDEEEEFEFBDEEDCBBA?	C	48	T	29
3	38438457	G	40	GAAGGGGGGAaGGAAaGAAAAAAAGAGAGAAGAAAGAaGa	CEFEEEEEEFGEEFEGEEEEEDEEDB@EDEEDEEDDDGAB	A	24	G	16
3	38601556	T	32	CTTTTCCTTTCCTCTCtTCTCCTCTTCTTTCt	DGDFGDDGFFCCFCF8BFCFCCFCEEBDDD??	T	19	C	13
3	38647642	G	25	TtttgGTGtTgttgTgtgttgtgtg	>BECCHCHGFCGGDEDH@HHDHDIB	T	15	G	10
3	38768247	G	126	GGGAAAAAgaggAGAagAGgAGGagGGgGaAgaaagaGGGGAagggAAAGAgGGGAGGaGAAaaGAGaAaAggaagaaagGaagGgggGaaAaGAaGagGgGaggAGAgggAaGagagggAaggga	B@=?A?B?BF>EEEFEECEFEEDEEEEEEE<EEEEFEDEEDFEEEEFEFEFDEADFEEFEEFFFEF:FFFFGFEFFFBEFDFFFDFDFEFFC:DEEDFGDFAGHGED>FEFDFDFFFGFGCB??:?	G	67	A	59
3	38802251	A	41	AgGAaaaaGGggaagaaagGGggAgggaggggagggaaggg	@AFEFFFFGGCCFFCFFFCGFCCGCCDGDDDDGDDDGGDDD	G	25	A	16
3	39107993	T	26	GGTGGGGTGGGGGGGGGTTGTGtGTT	HGEGGGHEH@GAGGGGGDDGDGFFAA	G	18	T	8
3	40251392	T	98	ctCTccCTCTCCCTtTCtCcTTccTCTTttTTTCtccCCcCtCtCtTttccTcTcctctCtTCcTctCCtCTTttttTtctTtttcctctttccTCct	@AACDDEEFGFGFAEEGEGDGG<DFCBGEEGGGGEDDGGDGEGFEEGBFEEFEGEEE<EG>GFEFEEF=FFFFFFFFFBEFFFFEDEEEEFFEACB>=	T	53	C	45
3	41279440	A	47	AGAGAGGGGGGGGAGGGGGAGGAAAAGGGAaGAGgGGAGAAgGaAAA	BGFGEGGGGGFFFFGGFFFEFFEFEEFFFEGFEEFFFEEB@BBA??B	G	28	A	19
3	42202061	G	26	gggtGttgGgtggtgTTgggggtggt	@@BBCBCDGDEEFBFEEGF=F@FDEF	G	17	T	9
3	42244321	G	107	AgAGgGAgGGggGgAgAAgGGGagGagAAgGAaGggaaGaggGAagaGGGgagAagAAgAAaGaagGaggGAGgAAGgaAaAaGaGaAGAGagGAgaAgGagaAagg	FA5??AGCBCCCCCHCFHC>CCCCCFCHHCCEECCCFFCGBBCGECGCC5DGDGGDHHDHHFCGGCBGDC9GBDGGB>GEHGGBGBGGBGBGD=GDGFDAF@DCB?A	G	58	A	49
3	43591405	T	26	tctcCctcTccttccccctttttccc	CAEDGDE>FDAEFCEEEEFFFFFEED	C	15	T	11
3	46001063	G	102	aAgAAAGGAggGagaAGggGgaaaaggAGGGgagagGgggagaagaagggAggaAgaagAGggagaaggaggggagGaAaggGaaaaggaaaaggagaagag	CDDFFFEEFFFEDFDFEDFEDDDDDFFFFEEFDFCFDFFFEFE>GEDGFEFFECEEAEGEEGGEGEEGGEGGBGEEDEE>GEDEEEEGGEFFDEFEGEDB8?	G	55	A	47
3	46026259	G	44	AAAGGGAaGAGGAAgGaGgGGGGgGGGGGGAAAAGGAGAAgGag	@EEHHGDEHEHH>EGGEGGDGGGFGGGGGGDDDDGGDGDDEABD	G	27	A	17
3	46717931	T	50	TCccTttCtctCTttTCctcttttttCCcctcttcTctccttttcttccc	D<<=@DG7GBGDFGGGDBGBGGGGGGDDBBCCHGBGBGCCFHHH>FGCBC	T	28	C	22
3	46718298	A	56	gaaaaagaGgCgaaaaagagagaggGggaGgGGGGaGAAAGAGGaAAgaaGGgaGA	CAFFFECFBA7CFFFGGDGDGDGD@=:DF@DB@BAFBGFGBGB>GGFBE;?AAC>A	G	28	A	27
3	46943028	T	29	ccccctcctttttcTtTctcttccCtcTt	C?@BBFABBGCGGBGGG=GCG:CCCGCFH	T	15	C	14
3	47047373	G	140	GaGGgaAagaaaAAgGgGGAGGgGGGAAgaGgGgGGaGgaGGGAGaagagaGAGAGGgAGGAaAAgGGAAGAAGAGagAAAggGggAAgAaGAgGggagaAgGAAGGggaagGAAGGAgAAaagAaAAAGaaAGaAGAGa	>C;=@CBCAEGFFHCCCCCACCCCACHDCFCCCC?CFCCFCCCCCFFDGDFCFCGCCBHCCHGHDDCCHHCDFCDBGD9HDDDCDDGGDGFBG>BDDFDHGDBGGBBDDGGEBGCBBGDFGGGDEGGEE@CCE@BB:BCD	G	73	A	67
3	47050633	T	50	ttTTtTTTTtTTTTTTTTTTTTTTTTTTTTTTgTTTTTTTTgggggTTTT	BDA;FAEA<G<;FD@FB;EF@F;BDEEDED7E:DBDDE>FDDC?9?C=??	T	44	G	6
3	48419897	C	93	cTCCcTTTTCCCcCcTTCccTCccTCTtCCCctCTtTcttcccTcTtcccCtcCCTTCtttcTttTttctCttCcctTcTccTCCctCTtCct	@@?=ACCEFGGGBBBEEFBAEGBBEEDGGGGBHFEGECHHACCDCEHCCCGHCGGECGGHHCAHHDHFCHFHH:CCHDCDCCDDDBHFBFDAD	C	50	T	43
3	49064126	C	299	CctTTCCCTtTTTcCCTTTtttcctTCcTTctCTtccttTcTTCTTTtTtCTTcCCCCccccctTTtcTTCCttCtCctCCCccTTTttttTttTTTcCTTTCccCTtttTCTCtcCctcccccCcCCccTtctcCTTTCCCctcCCTTtTCcTtcCctCctTTCTccTCCTctccccctTcTTTTttCCTTcTCTttTCcttTctctTtcccttTCCccTTtctccctttTtccCCttCcctcCttCtTTcTtTcTttccttTtCTtcCTctCtTCctccCCttCCCTtctcctctct	AC?A?>>@FDEFGGCDGGGCDCGBDGDGGGGDDGDGGDDGFGFDGGGDGADGGGDDADGGGGGDGEDGGGEDDDDDDGDDDDGGGGG?DDDGEDGGGGDFGGDGFDGEEDGD:DDHDH:GGHGHDFDDHGGEHEHDGFF?DDGEHCDGFDBDHGEGD<EDGDGG7GAGFDDGHDHGHHG:GHGFGFEECCEGGFDFEEGDGEEFG?H@FEGHGEBGCCHHFF@HEHHHACEFEEHC>EECDHEBCEECDFFHF@FEFEEHHEEFECFEHCFFDCEFCGEHHCCDDCC@D;<=CA>E=EB	T	156	C	143
3	49450449	C	75	CTCCCCTCTTCTTTTTCCCTCTTTCCCTTCcTCCCTTcTTCTCCtCCCTcCCCCcCTTCTTTCTCcTTCTTCcCc	<FGGFFGH;GGGGGGFGFGD<GGGGGGGEFEFAFFFFEFGF@FFDFFFEE;FFFEFFFFFFECECDCEDECA@CB	C	42	T	33
3	49689210	G	59	GaggaGAaaaGGaagGggggGaGgagAgAGaAgAAgAAggGagGAGGAaaAgAaGGgGa	BBE@EEEEEEDDEEF8DFFFEE8F<GEFFE8FGFEFEEAGDFGDBDDCDFEFEFCBA@B	G	32	A	27
3	49719729	G	38	AAAGGAAGAAAAGGAGGGAGAGAAAGGgAGGGGAGAag	BAFGGDFEEFEDFFEEFFDFEEEEEFFDDEGGGF>ABA	A	19	G	19
3	49720393	C	217	CCGgggcccGGggCggGgCCCgGGcggCcCCCGgGGcgcCCCCGCgcccGcGccGCgCgGGGCGGGCcgCCgCCggCccggGcGCCCCCgGgcccGCCcGCGGggGccCggggGcCGGcgCGCgCCGCGggGcCgGCCGGCccggcCgCCCCgGcCGGCccCGCCGGcggGGCgCGGCcGcCCCCGgccCGGCCcGCCcGcGcccCggCcggGgcgc	D?@ABAABBA=CFGDDHDEEGDHHDFEGDGGGHEHHCEDGGGGGGE>DDFDHDDHGFHFHIHEHHHGDFEGFGGGEEDDGFHEGGGFFGGHGCEEHFGEHFGHGFHEEGGGEFHEGHHEFG@GGGGHEHGFGEEFGCFGEFEEFBBFFEDDFGGEFGGFEEFGDFGGEFEGGFGFGGFDGEFFFFGFEEEFFEDEFEEEFCEAAB@B@A?>>C@BCA	C	113	G	104
3	49736199	G	96	GaAGGGagAGGGAAAAAaGGGAGGGAGAaGAAaAgGAgAaggGgagAAGgGGggGGaGagAAAgGAaGGagaagaaAgAAaAGGAAaaagAgaagg	?FFCCBFCHC:DIHH@FFCCBHCCCDCGGCBHGHDCGDHFDDCDGDHCBDBBDDBBGBGDGFGEBGGBBGDGFDGGGDGGGGAAGFGGFDHCFC??	A	49	G	47
3	49753003	T	53	TTGGTTGtGTTGGTGTGGTGTTTGTTGTGTGGTTgGGGTTGtTTTTGTTGTTG	BGCCGGBGCGECCGCGCCFCFGFB@FBFBFBBEFDBBBFBBHFFFFBEE<A?@	T	30	G	23
3	49898000	A	135	GAAAGGAGggaGAggGAAgGggGAAaAAAGGaAGAgagaAgaaGaaGagagaggaaGGgGaggaaaGAgaaaAgGGaaAAAGgggAGGgaGgggGGaAgaggGgggAAaaAgggggaagagGgAgAAAggagAgg	BBD?=>@;ACDDDEFEBFEDFFEFFDFEECEDFAFFDFDFFDDEDDDDFDFDFFDDEEFE@G;CDDDF;EEE@GEEEE>EFEGGGEEEGEEGGGEDEEEEGGDGGGEEEDEHGHGGEEECGDGEGEEEGG?AA??	G	73	A	62
3	50197097	C	149	cCTCctTcTTCCTCCCCCTCcCTTTTTTTtttTTcCTctTTCTtTTTTcCCTcttcTTtttCCTTCCcTCCCcTtTtcttCcTCCTTTTTtttTTcctCTCCCTttCCttCTCtTtcTCCCTCccCtcCCcTCtttTccCTTCccTcTT	?>DACFGAGGDDGDDDCDGDBDGGGGDGFCGHGEBDDCHGGCFHG<FGCDDGCHHCGEGHH7DGGDBCFCCCCGHFHCHHCCFCCECFF:9HHC@CCHCFCCCF>HCCHGCFCDFFAFCCCFCCCCHCCCCFCHHHEC=CEEDA?D=??	T	81	C	68
3	50374568	T	25	TTTCTCCTCTCCTTTTTtTCTTTTC	GEGCGDCFCFCCFFFFEFEA9@CCC	T	17	C	8
3	50402309	C	145	CCGCCCCCCCGCGcCGGcGGCCgCgGGGCCGcGGGCGGCGccGCcGcCGCcCGCCggCgcgccGcCcgcCccCCCggCCccGCCGGgggcggGccCgcCGgcccgcCCgGGgcGgggGCcgGccCccGGCgcCggcGGgGGGCGG	@?=BCBBDDCC:CFDCBFCBEDFEFC?CDDCFB?CDCCDCGDCAGBGDCDG:CDDEG7GGGGGCGCGGGAGG@BCGGCCEGBCCBBGFDHDGBGCCGFCBGEEFFFCC@BBGGBGBGBCGGAGGC8ACCDFDCDCC?=::><AAC	C	77	G	68
3	50425177	C	31	CacaAaaaaacccaaaaacaAaaaaaaaAcc	<BDEHE?EEEDDE?ECBFEFHFFFBDEFGEA	A	23	C	8
3	50645793	C	107	CcGGgGGCCCCCGGCGcCCCCGGcCCcCCGgGGGGCGCCCCgGcggccgGcCggCCGCCGCgCGCgcGGggCcGcccCGCCGCccCcGcGgcCCGCCcgCGccgGCG	?D@CECCDDDDDC6DC>DDDDC>FDDGCDCGACCCDCDDDDDCGGGGGEBGDGDCCBCCBCECBCGFBBGGCFBGGGCBCC9CGGCF@FBGGBBACBFDC?AA@:AA	C	61	G	46
3	51273773	T	149	TTCCcTTTTTCTTCCCCTtcCCTtTtCTCTtTCCCCTcCCTTCTtCCCtTttcccCTcCCTCtcctccCTtTTTctCTCCCtCTtCtcccCctccCTcCTTCccTCCttCcCttcctTttcCTccCTTtCTtccccCctccTCCcttTt	@ACFHCEEEEGEEGGBGEDGGGDDEDDEGEDEGGGGEGFGEEFEDFGGDEDDFHHECDDGEFEHHEHHGEEEEEHEGEFFGEGDEGEHDHFHEHHFDHFDDFHHDFFEEFHFEEHHEDEEHFCHHFDCEFCEH<FCDDBDECAAC?=?B	C	81	T	68
3	51469107	C	26	cCtcCctcCTTCCccctccTTCcCcc	C<AGDGDGGGFFGHHFEHHFF=GFHH	C	19	T	7
3	52538739	C	149	TTTTTtCTcTCcCTTTTTTTCCTcCCTcCCccCCTTTTCCTCCCTTTTTCTCTtCTTTCcTCCTTTCCTcTTttCcTCTtTTCCTcTCCCTCCCTCCTTCTcCTCTTtTTCTTcTTCcCCCTTTTCttcTTTCTTCTTCTCttttTTtC	BDCEFGCGAGCADGGGGGFGDDFBDBGBDD@BDCG>GFDDGDADEFGGG8=CGHDGGGDCGDDGGGDDFCGD:HDCFCFHFFCCFCFCC@DCCCFCCFFCFCCFCFFHEFCFFC8FCCCCCFFAFBHHCEEFDFEBFFAAAC>BBDD@A	T	85	C	64
3	52546820	C	79	TTTTttTttTTccCtCTtcTTctCCtTcCtTTtTTCttCccCCttttCcttcTtCcttTCCTCttttttTtttTTtTTC	B@BBDCDEEEFDDFEGFEDFFDEEGEDDFAF;FAFE?FFEEGDEFFFEEFFE;;GDFEEFAFGFFDFFGEFFFEEFEEG	T	54	C	25
3	52554749	T	75	ttttTTTTTTTTTTTTTTTTTTTTTTTTTTTTTTTTTTTTTtgTTgTTTTTTTTTTTgggTTTTTTTtgTTTTTt	CCCD=AAEFFF=FFBFFDFEFFFEFFB=BEEEFEE;EEEBE?DEE7EEEEDEEEEEE:A<EEDEDDC7<ABCC<5	T	69	G	6
3	52558904	A	146	ttATAatTTTaTTAaaaTATTtAAtaaaTTTataaATTtAaTaTtaTAaaAttTATataatATTTtTataaAtaAattTTTtaTtTAAtATttAaaTataTTAATttaaATTAATtTAtaAAtAtttTTtaaAaTaaTAtAaTtTt	CC?A=DEEF>EEFFEBEFCFCEED>CEEFFFEEEE>EFEFEAEAEEBFEFFFEFFFFEBFF:DEFFFFFFFEFFDFEEFFFEFFFDFFEEDFFEF5FFFFEEEEDGFFEEEEEEEEEDFBECFEFFFEDFFECFCBFEDEC@:?CB	T	78	A	68
3	52559167	C	39	CcccCcCCCCCCCCCCCCCCCCCCCCCCCCCgggggGGg	?C<?@@GCFFEFFGDFFFEEEFFEFEEDFEDDCC8CBA;	C	31	G	8
3	52643307	A	47	AGGAAAAGgGGgAAGGGGaAAggaGgAAGAGGAaGGAgaaGGAAGGG	CHHED6EHGEEGEEHGHHEDDGGEGGADGDGGDEGGDGCEFFB?C?@	G	26	A	21
3	52721305	G	93	GAGgGGGGAAAAaGgGAAAagGGAAAGaGgGAgGAGGAGAggAAAGgGAaGaGGAAaaAgAgGGaGAgAAagaGAaGagGaAAaAAgAAAAag	@F8AABCCHFFHFCCCHHHFCABHHHCECDCHDCHCBHCHD@HFHBDBHGCGBBGGGGGDGD>BGBGDGGGDGBGFBGCBGFFFGDAC@@BDA	A	50	G	43
3	52740182	C	84	CGGCGcGGGCcGcCCGgccGcCgcccGccCgCCCGgGCcccGcgcCCcgCCGCCgGCCGCCGCCGCGGcCccCGCCcGCGCgGG	AAGGFCGGFGDDDGGFFDDFDEGEBDG<EGAG7GGFGGEEEGEEEEGEFGFGFFCFFFFDFFFFFCFFEDEDFFBFEDCEB<AC	C	51	G	33
3	52867595	C	50	aACAACAaAACCCCACAACCCCCCACaAAaAAACcccCcCAAAACAcCcc	EEEFF:EDDFGE7?EGEEG8FGFFEFFEEEEEEFEEEFEEDEDDCB>ABB	C	26	A	24
3	52883748	C	93	cCTCTTTCTTTCCTCtCCttTCtCCtTCCTtCtCTctCtCCTTTTccCCctCTTctTCtCCtTtcTTCCCCTTTCccctTCCTTTCTTccTCT	GFBFFFEFFFFGGEFDGFDDEGDGED;FGFEFDFDGEFEGFF=EFGHFEGEEEEHE?EEEEEEEH?EAEFFDEEFHHHDCEDDDDDCCB@A?@	T	48	C	45
3	53263200	C	93	ccgCGcccgcgcGcGgccCCGCcggGggcggCGcgggccccgggGGCgCCCcCGGgCCCCcgCgCGcGcgCCGgGgGCGCCGCCCccCccgcG	?CA=>EEEFCFCCDCADDDD=DDEFCFDDFF>ADFEDD@EDEEFCCDGCDDEDCCFDD>DEFCFCBEBEGCC=G=G>C<CBABCCEECBA=@A	C	51	G	42
3	53806817	G	86	GGAGGAGAAAGAAAGGGGGGGGAAAaAGGgAGGAgGgAaGGAGGAGGAGAAaAGAAGAGGaaAAAGAGAAAAGgaaggGAAGgAaa	ECFE=FEF8FEEF:DEDEEEEEFFFGFCD<FDDDDDDEGDDEDDEDDEDEEGEDEEDEDDFGEEDDDCEEECDCEC@AC>AB=?C5	A	44	G	42
3	53921028	T	65	TtgggtTTGGgTGtGGTgTGGtGGTtttGgGTTtggggTTtgttttggttGtgtgtgttgtttgg	CCACCE@FEEFFEEEEFFFEDEAEFEEEEFEFFEDGGFF;EGFFFFCGFF;FGFGEGFFGFFFGD	T	34	G	31
3	54157710	A	36	aaatttTtTataaTAtATTaataattttttatttta	CFGFGFEFFFEFEEEGFFFGFGFGHH:HHFFI9FHG	T	22	A	14
3	54905666	C	70	ccTCttTcctCttctCtCtTCCcctTctctTtttcTTtctCTccttttCcTCtttccccttcccccctct	DD@BAADGGDGCDGDGDDDDGFGGDEGDGDEEEDGEECFCFEHGEEEEGHBFDEEHHBHFEHHGHHHEH?	T	36	C	34
3	56591178	A	31	AggGAGGGAGGaGgAgggGGgaAGAGaAAGg	8EFG@HHHEGBDBGDGGGGGGGDG6GAAA@A	G	20	A	11
3	56658481	G	158	CCCCCCCGCGGCCGgCCcgCcGGGGcgGGGGcCcCGCCCGGGgcGccGgccGGCCCCcGCCCGGCcGGCccccGGcggcCcgCGcCCCGggGGgGGcCGCCcCCgCgcgGcCGcCcgcgcGgCccCcCGCGcCCCCcgccccGgggggcGCGCcGGgg	?A?:AEEGGGGGFFFGGGFGGGGGGGFGFGGGDGGHGGGG:GFGGGGGGGHFGFFFGHGDGGGDEHGGBHHHHGGHGFHGHGF?GGGFGGGFFGGGHFFFF9FFGFGHFFGFFHFFBHGHFGFBGFGFFFFHCFFCHGHGHHEEDBBACB@BA@??B@	C	89	G	69
3	56694877	A	85	gaagAgGaAAgGgAAaGaAaaAAggggGagagAggAaaAagggGGAggGAaggaGagAAAAgagaGaAGaaGGgGgaagAgaGag	?CBBDGFEFEFGFEFFGFFFFFEFGFFGFFGFEFFBFFFGGAGFGFGFGFGGGFGGDEDEEGFGHFGEFGGFFFFGFGGEGGB;@	A	43	G	42
3	56703746	A	44	CCCACACACacCAacAACAcACCcCaCccaaaCcccacaAAaAc	A?=DEEGEGEHDDCFEEGEHDF:HFEFHHECEFHHHEHEDDDDH	C	24	A	20
3	58138528	G	89	gaaggaaggAAggggAaGagAgGaaGgaaAGgagAagaggGAgagagagAGggAggaaaGgaaAggagagagaaagggggagaggggag	>BCACCDFFFGEEDBHEBEEHF?EEC:EECCDEEHEFE<E?HFEDEEEFHCCEEFGEEE7GEEHFFEFFGCGFFFEGGGEFDFFFFFAD	G	49	A	40
3	58410748	C	66	tttTcTCTtcCtTCTttCtctCtCcCcTCCtcccTtTttTtctctttctctccctctctccttttt	C@@AEC9CBEDDGDHBDD>GDDD>CEGEDDDGGCGEGEEGCGEGEE5GEG;HHGEHDGFHHCECCA	T	38	C	28
3	58635197	G	26	GggGagGAGgaGAGggGaGGAaGgga	DDFHEFHEHDEGDHFFHFGGDDGGF@	G	18	A	8
3	59738064	A	30	AatAatAtaTTtttTtATtTTtaaataAtA	BCDEFGAGFFFGGGHFFEHFFCAGGFGDEA	T	17	A	13
3	62319048	A	28	AGGAgaggAGGaAAggagGgaagAgagg	@CEFFF5FFGGEF?=FFFGGGGGFEEG>	G	16	A	12
3	63596277	A	92	aacAAaAAcCcaaaaacAAaccacccaAaacaaAccCcaCCCCacacaaaacaaccaccccaccaAAcacAaaCaCcaacacaAccccccac	?AD@DC=EFGFDDDDDFEEDGGCGGGDEDCGDDEGGGGDHGGGDHEGDEEEHEEHHEHHGHEHGDEEHEBEEEFEFHEEGEHEDHGHGFB:E	A	48	C	44
3	64184676	G	29	AaggggGaaagagaggaGgAaggagGGag	CC?==@BGFFCFCFCCFGCFFCCF:GGGD	G	17	A	12
3	64518994	T	116	tTcCtcTCctTTCcttTTcTcctttCcTtcCtccTcctttTTTTctcCttccccCCtTtcttcTtctccttcctttCtcTttttcccctcCTcctttcttcttttttcccctcctc	C@B@F;GCDEGGDDDEHGDGDDEEDDDGEDBE?DGDDEEEG?GHDECDEEC<DDDCEGEDEFDGEDFDE:E;EFFFCEEGFCBFEDEEFEDDDEBDFEAFEDFFFDFAEA?FAA:A	T	63	C	53
3	64527321	T	39	CtCttctctctttcttcctttcctttctccccCtcctcc	BAABBGDGCGDDDGDDGG7DDGHDDEHEHGEGCEHHDHF	C	20	T	19
3	68934434	T	38	TttGggttTggttTGgGGtGtgtggGgtgggGttgggg	9BB>EDDE9FFEEECFAHEHEE7FFGGFFGFGFFBBEA	G	23	T	15
3	73111368	T	45	CtTcttcTCTTtTTCCCctTTTtCCTCTTTCTTTCTCCcTcTtTC	GEEDBEDEGEE?EEGGGE>ECDFFFDFDDDFDDDFDFFEDDE?@A	T	27	C	18
3	73112974	A	44	aaataaTataTTTaAAttAaaattATAaaAatttttaAaaatta	BCDDDCE=DDEDECEEC@EDDDD@EEED>EEEEEEEEDEEE=DE	A	26	T	18
3	78663956	G	35	aaggAgGAgAgggaAggaGagaaaAGgAgaaagaG	CABCDG:EDEADDDE<FDCDECEEEEEFGEEEGD<	A	18	G	17
3	87276699	C	113	TcTTccccCTctctTcCtTcCctCCTCTcCcCccTcTcTTccCCtTcCtTccCttCTTtCTTtctcTTccTcTccccTtCttTcctccTtccTtcttctttctcttcCTttct	@C<????9CFBFBGBBBGGBDBCEEGEEBABDBBGBGBGFCBDDGGBDHGCCDHGDGGGDGGCCFCEGBCE;FCCCCFFCFH=@AABCFF<AF?DHHCFHA=HCHDCDEE?>E	C	58	T	55
3	98376830	T	34	tCcCcTtTCTCTCTcTTCCCtCcTttCtctccTc	BBFDGGDGDGDG?GHGGDDDECHFCECEHEHDCE	C	18	T	16
3	98489915	C	30	gGcccgcggcCgcGgCgCgcgcCGccCGGG	DCDDDEDFDDDFDCEDEAGEGEC;DECBB?	C	15	G	15
3	98520339	G	55	AAGGAGGAGAAGAGGGGAGAGAAAGGAGGGAAAAAAAGGAGGAAAGGGGGgGGAG	HFCCFCAHB8H>HBC:CFCGBHFGAAGBBBGGGGGGEBBGBAFGD@:<>==AAC?	G	30	A	25
3	98531342	A	47	GAgaaaaaaggGaggGagaaaGgaaGgaagagagagggagaaggagg	@ACDDEEEDFECDFF?CFD5DCFCD?GEEGEGEGDGGGEGEEGGD?F	G	24	A	23
3	98536571	T	31	TCTTCCTCCCCTtTTcTCCtTTTTCTctTTT	AGGGAGGGGGGFFFFGFFFFEEEFBDB>BB?	T	19	C	12
3	100295733	A	134	AGAAAaAgGaGaGAAAGaGAgAAGGGGAaGAGggGaaAGgaGgggggaAgGAAgAggGGAgaAGAaaaGaAGGGAggaAAggGaaagGgggagGggGGGaAAGgaAgggaaAGagAaGAaaAGggaaAGGaaag	CBC@<9EFGDGD;FFFGBFFF@BGGGGFDFFGFFGDDFGFDHFDCFF@FD8FFFFFFGGEGDFGF@EE<EEGGGFGGEFFFGFEEDGFGGGEGGDDFFFEEEFGBAEHHDDEF;GEBFEEEEF=FEEDEE9BBD	G	69	A	65
3	100523771	A	51	AaCacccACCcaaaacaccAcaaaaaaCCccACcaAaccaccccccaacaa	B@BDGGGFGFGDDCDFDGGFGDDDCDDBGGGFGFEBEHHCGGDEHHFCHED	C	26	A	25
3	100534633	A	30	GGAGAAGAAGAaAGGgAgaGGAAaaGAgAa	GGFGEDGFFGEEEFFGEGDFFEEDDFEGD>	A	17	G	13
3	100534705	G	37	agAAGGggAGaGgagaAgGaAGGagaaAAaagGGgAG	BAFHCCFFHCECFFFGHGCFHB:GGGG>8FGGB<GFA	G	19	A	18
3	100536252	G	44	GGgGgagGGGgGGAGAAaaGgAgaAgAGgGggGGGAagggagGg	@GFGFFFGGFFGGFGFFGGG?FGGFGFGGGGGFFFEFGGGFGD?	G	31	A	13
3	105258861	A	177	GgggAAAgGgAAaAAaGAAGAAAAGaaGAGgAAAAAAAgaAAAGgGAGAGAAGGgGaaaaGagaaGaaaGAaaAAaaaagagAAgAAGgGAAaaAAAaaAaaAggagaAaaaGgaGAGgagaaaggAgagAGagaagAaagGGAgAaAGAagaaaGaggggagAaaaGaaaGagaga	ACC>@@@BACDDDFEFGFFGFFFFGFF?FFFFFFEEFFFFFFFGFGFGFGFFGGFGEEFFGFFFFGFFFGFGFFFFFGGDEGEFFFFGGGEFEFEFDEGEGFDGGGGGFGCGEGGGFGGGGGEGGGFGGGEFDGGBGFFGGFFE8FFEFEGGHGGFGGEGGGCEGGGFGGGED?BB>	A	112	G	65
3	108081247	G	104	GggGgGgAGgGGgGagGGAgGAAaaGAGgAAGGgGAAaAAAGAGGgaAGAGAAGgGGGGGAAgagAaggagaaggAGggaAAgAgGgagAaGGgaAagagAgGA	7>B<EBEHA@CCFC@FA8EDCBHDC@HCGGGC<ECHHEHHHCGB@EEGCE=GGCGC@CCCHHD>GG:GCEGEEGHGBHGEEGEGB;EEFGE@BGEGEGEGGA??	G	60	A	44
3	108541761	T	36	tctCTCCTctttCTTtTcCCCctTtCCtTCTTtccc	HCH@GDAHBGHGC<FHGCDDDCHAHD>@FCFFHCB=	T	19	C	17
3	111426690	T	40	TTGTGTTGTGTGGGGGGGTTGtGTTTGGGGTTGGGGGGTg	BEDEADECE@EEEEEDDDDDDFAEEED>DDEEDCDDDCAB	G	24	T	16
3	112993367	G	96	ggAgggGAgagAAggaagAaAGAAggAgaagaaGgaGGaagagGaagGgaagAggaaGgaGgaaggGagAagAGagGgaAAGaGGaggGaAaggag	CCCEFECFFCFH>FFDEF:E<CHHEEHFEEFEEAE>DCDDDD7CEDECF;FFAAF@BBF@CFEEF?CFFGCGHBFGAEFGGBE@BEGF<FGF=B9C	G	51	A	45
3	113015553	A	244	CACCACACCAACCCCCacaCAAcCACCCCACCCCccCCaACACAcACcCACcACAaAaACAaAAACaaAACCAAccAAAAcAAACACaaccaACAAaAaaaaaCCCAcccCCaaCAAaaaacaacacCCcccAAaAcacCCCccCCAACcaCccaCcaaccCccCCcACACaCaACAcCaaacaCCCAACAAACccaAccCACAcacAAAcaaacCCAAaaaAAcacAccaaccacCCcccCCa	D?A;EGFGGFFGGGFGEDEG=FDDEFGGGFFDGGDDGFEEGBGFDEGD?FGDFGFFFEF??EFFFEE?FFGGFFEDFEFFEDEEBF?:EEEDEGFE:FEFEF<GGGFEDDGGFFGFFEFEFE;EEFEFGEEEFFFEEFEGEFEEFFEEGEFFEEFFADFEEFEEDDBEFEFEFFDFEECF?FEFFFFEE>EEEFCCEEEEFEFEEFDEEEEFEFEF9DEFEFDDCFED7CB??@:?@>>@=CCB	C	127	A	117
3	113300183	A	93	TTTTTTTTATAATATTATTaTtATAtttTTTTATTTAAtattTTTAAAATATAaTTaaTTTAaATTaTATAAAATTtttTTTATtTTAtTTtt	=@CBE>GGEGHHHHGGHGGFGFHGHEFF=GGF;FFFGHFFEFGAFGFEHFGFBGFFGGFC=GFEFFFFGFGGGGF?E@EFFFGFFEFFBCCCC	T	61	A	32
3	113522544	T	48	tCtccTCcttTtTttcttttcCCTttCtttcTCCtttCccCccccttT	A<ABDDBFDEGEEEEFFEEEGDCEFEAFFFFFCDFFFCGFCEGFF;>C	T	27	C	21
3	119236017	G	27	GTTGGGTgTGGGTgGTTtGgTTGTTGG	=GGCBCGGGB><FGBFFFBFEE@FF>?	G	15	T	12
3	119334986	G	78	GaaAaGAaAAAAGagGAAaaaGgGAAgGAagagGaGgGAaaGGaAgagAAaaaAAggaAgaaAaaaAggaaAgaaaGa	@C?GECHEHHHHCFC>AHFFFCDCH>DCHGDGCCFCACHGGCCGGDFDHHGGGGGDDFEC6GGGGGGDCEGFCB?>:;	A	51	G	27
3	119339010	G	101	AGGgGgAAGgAGGaGggGAGAggaaaAGaGAAagaaGGagaggAGggGggggggAgagagggaaGGGaaAaGgaaaGggaaGAaAaaagggaGgGGaAggg	C?DC@FFFFDFGGFGFFGFEFFFFFFGGEGFFFFEGGG=GGGGEGGGGGGGGGGEGFGF8GFGGFGGGGEGFGGGGFHGGGFEGEGGGGGFGFGEDBBA@E	G	58	A	43
3	120369575	T	180	GTTGTGTTGTTGTTTTGGTTTTGgTTGtTGtGTTTGTTgGGtttTTTTTGTGTTtTGTGTtTGTtgtTGGTtTTGGTGGTttGggtTGgTGGgGgttGGtTTtGTgtgTtgGTgTTgtTTtttgTTTTGgtGTttgtttgTttGTtttgggTgtgtTTTtTtTgtggtGggtgttTtgtg	BD?ACDEEGGGGGGGGF6EGGGGFGGGEGHEGGGGGGGEGGEEEGGGGGG>GGFEGGGGGE8FGF=FFAGFFFGGGGGGG@FGDG:GGGFGFFFFFFGGFEEFFEEEFFFGFFGFEGEFFEF:FFFFEFBGEFFFFFFFGFDBFFFFFGFDFEFFEEFFEFFFGEDEEFA<>BA>A<ACD	T	112	G	68
3	120428621	T	65	TTTCCcCTTTTTCCCttcctCcCCCCttTTcCCCTtCCTCCCTTCTCTTttcTCCTTcTCcTCCc	>=@GFFFFFFFFEFGFFFGFFFGFFFFFFEGFEE=FEEEFEEEEFEFEEEFGEFFEBCCB?;ACB	C	35	T	30
3	120976051	C	77	GGGCCCGGCCCGcCGGcgcGCGCGgCCGGGCCGGCCCGCGcGGCGGcgCGGCcCGCGGGccGGGcgcccGgCCgCCg	EEGEGGGGG?GGDGFGEBCGGGEGGGFGGGEGGGGGGGFGEGFFFFEGFFFFEFFFFFFEEFFFEFEDEFEBBB@>>	G	39	C	38
3	121186543	A	65	gaaAaagaaaggggaGAGaaaagggggaaagagggaggggagaaaggggagggggggggagggag	@@@BDDFCCDCFFFDGFGDDDCFFFFFCDDFCFFDCFGFGDFEEEEGDFEGGGGGGGGEEBGB@?	G	39	A	26
3	121265522	A	69	ccCcAaaaAccccaaaacacaccccaacccacccaAccccacaaaaacccaccccacacccaaaacaaa	A?@@A>BCBDDDDFDDDCEDECDDCDEDDDEDDDECAD?DEDEDDEEDEEEEEEDDDFEEEFFFF@:FD	C	37	A	32
3	121724056	A	27	ACAaCaCACACCACaaaaaaAAAAaAA	G:ED?E>@=>:?;9F5AFE>>>D>;@B	A	20	C	7
3	123010276	G	129	gGAAGggagagaAaggAAAagAGaggGgaAgaAaaaggagAaAggAAAaaaaAgaaaggaGaaAaggAGggagAgaGaGgggaaAaAaggGAgAaggaaaaaaagAagaaAaagaGaaaGaaaggggga	A5BC=AADBGBFGFCCHHHFCHCFCCACFHCFHFFFCCFCHFFCCIIHFFFEHCFFGCCFCFFCG8CHC=CG9HDF@GBDDDGFGGHGDDCHDHGCDFFGGGDGDGGDGGFCGDG9GGGBGFGDDDA<?	A	76	G	53
3	124113929	A	59	TTAATAATTATTTtAtaAtTTTATAtATTATAATTtTATTATaATttTTtTTTTAtAaA	DBFHGGHGGHGFGHHHFAHGGGHGHEHEFGFGEGGHFGFFGFGGFHHFFHEFGEDCD@@	T	37	A	22
3	124412691	G	43	ttgTgGttTtGtGtgggttttggggtgTgtgGGgggtGgtttg	DEEGEGEEGEGEGEFFEDEEEEFFEFDFGEEGGFFGEFFFB@A	G	23	T	20
3	124438329	C	38	cTTCtcCtccctCctttctctcttcctctccccctctC	@=>@CCFDDDDEFDEEEDEDEDFEEEBEDD@EEEFEFE	C	22	T	16
3	124692689	C	198	TCTCTTCCCCTccCCCcTTTccTTcCcccCcCcCctttTtTTCTtTctTTtcttcCCCttTtCTTtcCctctCTttcCCCCCCctCcccCcttCCccCCctCctcctccCTctCccttTTctcttTTtTCccccTctcttCcCccccccCtctcCttCcCTCtCCtttCCccCttctTtccctCccttTctttccttc	??A@?@@?9CC@AFBEC@;EAA?E:GBB?GBGBGBGGGGGGEGFGGBG;HG<GGBEHGGGFGGGGGBABGBGG;HHBDDDGG?AFGCCBF=HHGGCAFGC?FCHCCHCCGFCHG=CHBGGCHCHHGDHGGB@CCG5HCHHFC=6CCCCAFHCHCFHGCCFF<HFFHHHFFCC?HHCHFHCBBHFCCHCEBGDG@>BB7	C	114	T	84
3	124732618	A	131	AGAgaaaAGgAGgggGaaagGgggaGgGAGGggAGGgGagaAAaggGgAagaAAaGAGAaaaaGGGAAGGGGAGgaagGGAGaGgAAgGGggGAaAAGgGaGaGgAGAgagAGAAGGgaAgagGgaAAGGG	BDCAC?A??BBFFFEGDD@F>FFFDGFGEG?FFFHGCGDFCFFDFFGGFDFDFEEG?GEEEEDFFGFFGGGGFG5DEGFFEFEFDEEGFEGGEEEEEFFFEFEFGEFEGEGDFDDFEEEDFDDED?BAA?B	G	74	A	57
3	125786760	G	90	aAGagGGGAAAAGGAGGaGaGgAgGAGGGGAGAgGGAGAAaAaGaGaGggGgGgAaAgAgAAaGgAAggAaGAGAAAgGAGaaGGgggGG	BGBED8CCHHHHCCHCCECECEADAECCCCGCHFC@HCHHFHF;BBFCEFBGBFGDEFGGGGFBFGGGFGFBGBGGEGBGBFFBBDC@5?	G	50	A	40
3	126219086	A	25	aggAaaaaaggAaaGGgggaaaaaA	AAA@BDEDDFFHEE?=GFFFEEFEG	A	16	G	9
3	127703085	G	57	AgaGAgggggagAAggagAAaaaagAaaaagagaaagGaaGGgagAagaaagagaag	BC?=BDDDFDDEGGFEBFGFEEBEEGD?=>EFFDBFFCFDCBGFDCBEDFECCFFFF	A	33	G	24
3	127779306	G	72	GGGAaaGGAAAGAAGAGgGAGGGGGAgAaGAGAAAAGggAAAGAaGgGAAGGGGAAGAGAAAAAAGGGgAGg	BABGDFCCHHGCHHCHCDCFCCCBCEGHFCHCHEHGBGGGFG?GFBFBGGBBBBGGBGBGGGGDE@:>?@@D	G	37	A	35
3	127786675	T	28	GTTtGGTgGGTTTGTGGGGTTTGGtGGt	HEEEHHDDBHEDEGEGGGGDDDFGB??C	G	15	T	13
3	129137025	G	27	GAaAAAAGaGAGGGaGGGAAAGGGAAG	9FFEEFEEGDEDD=GDDDDDB>@>?AC	A	14	G	13
3	129140489	T	101	tctCCtCctccTcttTtcccCCTTcTCTttTTccCTTcTCCTtCCTtTcTcTcTTTtcTTTcTCtTTTTTTtCCTTCcCtCCTtcTCtCttTtTTTCtCTc	B=EEFDFBGBBE@GGFGB>BGGFDCFGFCCEF?CFFFCFFFFFGFFHFBECFCEEEFCE?ECEEHDEEEEEFFEDEECFHFEEHCEEGFHHDFDDDFCB><	T	59	C	42
3	129152089	G	61	gagaAgaGagAGaaaGgaaAaGagagaaAgGaaaGgaaggAagaGgagAaaaGgagggagg	CABCCFDHEDEHDE>HFECEEHEFDGEEEGGDEFHFFFFGEEFFHGFFDFGFGEFFFFDE@	A	33	G	28
3	129252604	C	44	aacaCcccaccaCccaaacacaaaccacaaacaaaacaacacac	C?>CABEAEDDEGCDEEEDDDEECDDEDEEDD;EFFEFFEFDFC	A	24	C	20
3	129266162	C	35	CCCGGCGGCgCGCgCGCCCcGGcgGgcgCcGGcGG	DCDCADCCDF=CCGCBCCCEBAEG<EDFCEB@@C?	G	18	C	17
3	129275619	T	25	CttcccCtcccttcttttccCtctc	DADCDDEDDDDEEBF=F=EDFFE?@	C	14	T	11
3	129303436	T	78	gtTttggtGtgggtgggggGggtgttGtgtGggGgtGttggggtgTttgggGtgttggggggggtggggtttttGgtg	C?=CDEDEEEDFEEA9FEEEBFEDBEDEEEEFEEFE@EEGFEGFFEBFGFFEFFFEEFFFFFFAFCFFFFEFFFCFDB	G	49	T	29
3	130311398	C	70	TCTCCTTTTcctTtTTtTTCcCCTTCTCccTtTcTCttccccTcCTtTtcTcTttCTctcttCtTtttcC	AABGGFFFFDDEFEEFECEFEGFFFGFFAEFFFAEFFFDEEEDDDDDECDEE?DFFEEFEFBD5E@A@=C	T	41	C	29
3	130748733	A	79	gGaagGgaaGAggAgaAgGgagaGaAgaggagaaaaGggaaggagaagagAGagggGggggaaggagggggaagaaggg	A=BBBD<FFEDEFFFFFFGFEFFGFEFFCFFCEFFFGFFEFFFFFFFFFFFFFFFFGGGFGGGGFGGGGGGGEFGEGFF	G	46	A	33
3	130828790	G	26	AAgGaAaGgGgagaaggAgaagagag	;FFGEFEFEFEFGFFG?FFFFFFGGF	A	13	G	13
3	131415307	T	36	TCCTTTCCTTTCCTCCTCcCTTTCCCTCCCTCTCTC	GG?GGGGC:GGGGBFFFFHFEFFFFDEFFFEFFEFD	C	20	T	16
3	133483696	T	83	tcCTtCcCTCctccTTTtTCCcCTTCTTcTTTttTcCcTTCcTTctTTCcccCCTtctTTTttcTTCCCTCTCCcctCtCTcc	CDECEEFEEBFEFFEEEFE?GGE9EGEEGEEEEDEEGGEEGFEEFFDDGGGGCFDCGFDDDDFGDDFFFDFCEGCEDDBB<AD	T	42	C	41
3	133560423	G	52	GAGAGAAAGGAGAGGAGAAGAGAGAAAGAgGGGAaAGAAgaGAAaGAGGGGA	>EHEGEEEHH?EEHHCHEDGDGDECEDGDEGGFDEDGBAEDGDD>GCEED?@	A	27	G	25
3	134226159	C	65	tttcctccctcccccttctttTCtttccccCctcCtcTtcctttccctccctcttcctcctcctt	A@ADD:CDDAEGFGFDDFDDD7ADDDGGGGGGDGGCGHDFGDDDFHH9GFGDGEEHHEHDEHHD@	C	36	T	29
3	134266124	A	52	AAAAGAAAAGAAAAGGAAGAAGAGGGaAGGgGGAgAGGGAAAaggggaAGGG	@@BEHEDEEHEEADHH;EHCDFEHHGGDGG<GGDGDGGGDDDGFGGGGDCE?	A	27	G	25
3	134825512	G	57	cgcgGgcgcCcccGgccgCcgCcggccgccgcggcgccGccggccgggcgccgcggc	CC:A?@?B@FBABECBBC@@CFBCCBB@BBCCDC<DCCE@CADACACACDABDCD8C	C	31	G	26
3	138189031	T	33	CCCtctcTTttcccccCTccCTttcctcctttt	BDGEFEFEEDDFEFFFGDFBGDFFGGFDGEFEB	C	18	T	15
3	140178485	G	178	gGGaggAgGGAAGagaGGaGggaAGGaAAGAaaAaAGAGGgaAGaAGaGAgAggggGGgaAGAAGgAgGAgaaAAAAAggGGaggAaAGAGGaAgAAaAGGgGgAaagGgAagaaAGaggAgaGGGGAaGAaAggaAgGgGGGGAGaAAaGaGgAGAgAGGGaaaagagaaAaGGAGg	CBABABEFEFFFFFFEGGFGFFFFFFFFFGFFFFFEFFHGFFFGFFGGGFFFGGCGGG6FFFFFGGEGFFGGGFBFFFGCGGFGGFGFGF;ECCGFFGF:GFFGEGGGECEGGG:EFGGGEG=FFFFEGFEEEG7GEEFGFFEFEFFDEGEGFDDEDGCEEFEGFEGFFFCC@DC?BD	G	91	A	87
3	141162185	T	89	TTGGtgtTTtttGtTGGTTGTtgTttTgtgtttgtgggggtgggggGTtggggTGgggGGtgtgggtggTtttTttTtttTTgggttTg	?AGGDEEEEECCHECHFEEGFEFEEDEE<FEEEFEEGEFFCFDEFEHC=FFFFEHGFEEHFG7<FF:FGDACFDAEDBFFDDGGDFEDB	T	47	G	42
3	141713823	T	36	CTCCCCTTctCccCCTcTcTCTCCCCCcTCTcCTTT	EFGGGGEEGFGGGFFDGDGDDDFFFFEGCE@FCDC?	C	23	T	13
3	142217537	A	81	GGGAAaAGgAAAgGgAGGGGGAGgaAAGgAAAgGGAgaGAGaAGGaAGgaAAAGGAAGgggGGAgaaAGGGaAGgaaAGGg	@<AEFFHCFHHHFCFDCADCBHCFFFHCFHHHG?CHGFCH=GFCBFGBEEGGGBBGGBGGGBBGFGGGAAAFG@DABB>=A	G	44	A	37
3	143692018	C	65	GGGGGGCCCGGGGCCGggCgCCGcGgGGGGCGGGgcCggcGGcCgGCGCGgGCGgggCCCCgcgg	;?=CBCDDCCBCBCDCDDDDBDCCBDBBBBABBBDCCDDDBBBCDBCBCBDBCBD:CBCCB@<?=	G	42	C	23
3	145938782	C	27	TcctttctCcttTctcTttcctctcct	>ACEDDDDGDEEDDEDEEED@EDFDDE	T	15	C	12
3	148896430	A	72	GgGAAaGAGggggaAAAaaAGAGgGGAaAgaaagaAGGaaaaaAagagAagAGaagggGAAGggaaagaaag	@@?@EDEFEFFFFDFFEDDFEFEFEEFBEF;CDFDFE9A:EDEFEFEG>EGFEEEGF?EFFEGGEEEGEDEG	A	41	G	31
3	149180288	G	28	AAAaGaaAGgGAggaaAgaaAGaaagGa	CFHEBFEHCFCHGGGFHGGEGBGGGG>A	A	18	G	10
3	149374873	G	74	GGGtGTgTTgTGGtTTTGTgTGGGtgTTtGTGTttgGTTTTGtGGTtttTGtTggtgGGTTtgGTTGtGtgGGt	=?CG@GCHHDFCCGGDGBCDGCBCHDGGGCGBGCG<CFFFGB<BBFHGIDBDFD@HDBBFFECAFEBG@D8AC@	T	40	G	34
3	150601401	C	29	TTCTCCCTCTCCctCTTCctCCTTCCTCc	FEEFEBFEEFEDGFDEEFGFFDDC9B?CC	C	17	T	12
3	151090604	G	25	ggaaaaaggagagggaaagggggag	A?CDC@DCCFCFCCCEFFDDDDD;B	G	14	A	11
3	153847582	T	36	Tatttttaaaaatattttaataataatattaaaaaa	AFDEEEEFFFFFEFEEEEFEFGG>FFFGFFGGGGGG	A	20	T	16
3	153972500	T	92	tcTTCcTTCcTcCCCcTCCCCTCTTtTcTccCCtCtTttCCtttCtcCTCtCccTttcTTttcctcctcTtcTcTcttCTccctTccCTCcT	?CAD>BEDFBEBEGGBEFDFGEBEEGEBEBBGGHGGEGGG?HHHFHCGEGHGCBEHGCEE@GACFCCHCDHCDCDAHHFDAAADDCCEDE?C	C	48	T	44
3	154866545	A	38	AACcccacaaccaaacccCaCaccacaCaacacccccc	>ACBAAEBFFBBFFFBBBFFDGCCG6GEGGCGACB=8;	C	23	A	15
3	156983273	A	76	AAAAAGGGAGAGAGGAGAgGGAGAGGaGAAAAAAAAAAGAAGAAGGGGGaGgaGagAAAaGgaGGAGGGGgGgGGa	@FFF@CFGFGFGFGAFGFGGGEGFEFEGFFFFEDEFBDFEEFEEFFCFFEFGEFEGEE7DFGEFEEEFEFFDBBB@	G	39	A	37
3	156983414	T	166	CcCCtccCTCCtttttTctccTCTcCCccTcCtcCcCCTtcctTttCTTtcCCcCtcCCccCTTcccCTCctCTCtccCTCcTTtcTtCTtccttTCttcCCccCtctccttTTcTtttCTTTTTcCttctctTttttttCcTcccttctcctcctcCccccTctc	@B8@DDGFE@EEEDEEEFEFFFGFFFFFFEFGDFDEFFFEFFEFEEGEBEFEGFGEEGEFEFFFGGCFEFFFEFFEGG<FFGFFFFFDGEFGGFF5GFFGGGFGFFGFDGFFEFGEFFEEDEFBAGEFFGFFFEFEGEFFEGEGGGFFGFEFFGGFGFGGGGEFE>	C	90	T	76
3	157188378	C	30	tCtcttccttccccccttcccTcccctctt	C:?AACFGDDGGGGFGDEGGHGGHHHEG<=	C	18	T	12
3	158537443	A	39	GGGAGGAAGAAAGAGGGGAAGGGGAGAAGGGGGGgAGAA	?AGDGGDDFDDDGDGFGFCDGGFFCGDDGCGECB<CCCC	G	24	A	15
3	164739053	C	149	TCcCTcTTCTCTCCcTCcTTTTcCCtTCTTCCCCTCTTttCTTTTCCCCcCTCTctttTtCcCCCTTCCTTCcTCTTTTTtCCTCtCctCtCTCCccctcccCTcCttCCTtCTttcTCTCCCTCTttctCCCTtCtTTcCTttcCCcc	?ECGAD;EG7FFGGDFGDFFFFDGFFFGFFG59EFGF;FFFFEEEGFEGAFFFFEEFFFFGDGFFFE=EDFFEBFEFFEEFEBEEFEEFEFFEEFEEEFEEDEEEDFFFFEFFEFFDEEEEEFEEEFFEFDEDDFDFFEADCBB@A?BB	C	78	T	71
3	167191652	C	26	ttcctCttcCttCTcttctttctccc	CCBBGFGGBGGGGFBGHBHHHCF;@8	T	14	C	12
3	167506967	A	61	AAAAAAAAAGAAAGAAGGGGAGGAGaaGGAgaaAGAAAAaAGaAGgGAaaaGagaGaaGgA	F>HHHH=HHCHD;CCH>CCBGCCH@AGCCGD;GGBG6GEGGBEGBDBGFGGA8C@:??==C	A	39	G	22
3	170825920	G	45	AaggGaAaaGaAgAgAAgAgggaGgAaGGGAagGgAGAGggagaa	AABCC@FDDECEFFFFFFEGGFEEGFEEEDFEGDGEDEDGGEECD	G	23	A	22
3	171087469	G	96	aagagagaGAagaGAggGAaaggaaggaggaagGaAaaaagAgaggaagggaaaaGAggaaggaGgAaaaaAggggaagggaaaaaaaggaaaaaa	CC<BBE@GAGE@DAHCCBHFFCCFECCFBCFFCCFDFFFFCHCFCCFFCCCFFGDBEDCGGDDG6DHGGAGHDDDCGG?BDGGHGGGGCDFGFGFE	A	56	G	40
3	172224303	A	36	AAgAAGGgGaGAgAaGaGAAGaAGAAAAGGgaAaAa	GCFGHCBGCC=HGGEBEBGEBEGBGGGGBBGEFAC9	A	22	G	14
3	172428508	C	27	TCTTTCTTCCCtCTTTTCCTTTCCtTT	E=DEEGDEGFGEFDDDDFFDDCEEA9C	T	17	C	10
3	174814920	A	164	GggAAAaaggaagAAGaaGggaggGGaggaGGagaAagagAGgaaaAgGAAaGGgaaaGGgGGgaaagaAgGGGgGAagaAgagGgaGaAgggGGAGGAAAGgAAgaaAaGGaaAgGaGgaGaggagaaAGaggaaAAGgAgAaaaAaGAaAAgAgagaggGgG	=AA@@??CCCEEDEEHDEGFEEFEHHEFFEHHEFE>EFEEEHEEDCEEHFFEHHFEEEHHFHHFEBFEDEFHHHFHEFFFEEFEHGEHFDGGFHHEHHEEEHFEEGFDEFGHFFEFGFGFEHFFDFGBFDEFFFFFDDGHDGDFFEDFGDFDDFDFFFEF7EB?	A	82	G	82
3	175165201	T	50	tgggGTgtgtGGttgtgTtgggtgtttgttttgggtggtgtggttttgtt	ABFGGEDDFEHGAEFEFEEF6GEFEFEFEFFFGGGFGGFGFGFFFFEGFF	T	26	G	24
3	182880495	C	84	ACCCcCCAaAACcaCCAaCCacAcAccCaaAaCCAacaaAcaCccaaacaaaaCcCCCacaaaacccccCcccaaaccccaaCa	B<=@CDDCFHHDBFDDHFEDFB8BHBBDFFHGDDEGAGGHCGDCCGGGCGGGFDBDDDGBGGDGCCCCAC?CCGGDCCCBDAAB	C	45	A	39
3	183368216	A	266	tTAAATttTtATAtaTATAAtTAatTATTTTTAAaTTttatTTAtAATAaAAAatTataTTATTTttatAttTTtttaATattaAATtaAttAtATTATaattaaAAAttTtTAaTAAaataAATTtAAattataAATtAttaTtAtttTTTTATaaATATAaaAAaTtTATTTtTTttAAttATAtttaAAattATttAAatTTATAAatTTtttATTTAATaAtAAAaaAAATTTTaaaTtATtaTAaaTTTtaATAATttAAt	?<>>><@BEDEEFDCFFFFFDFFDDFFFFEFDFDDDFDDDDFFGDEGF>CFFFDDFDDDFEFEBEBDCDFEDFFDDDD;EDDDDF@FDDFEDEEFFFFDEEEEEEEEFEDDEF@EEFFDEC9FFEFEFFEDEEEEFFFEFEEDFDFCEAEFFFFEEEFEEDEEDEEEEEEE=EEEFEEEEEEEEEBEFFFE<BEEEEEEEECCEEEEEEEEEEEECEEEDEEEFECEEEEEEDDEDDBDE=E>DBDDEEDBCBB=@?@CCC=8CCB	T	144	A	122
3	183439652	T	68	TCCCCTTCCTTCTCTCCTTTCCTCCTTTCCcTTCcCttTTtCCtCTCTCCCCTTctTtCTCCttTcCC	?GFGGEEGGEEGEGCGDEEEDGADDEDEGGGADFGFFFDDFFFFFDFDFDFFDDGFCFGCCCA@A?AC	C	35	T	33
3	183524193	T	109	CCCcCtTtCTCCTTTTttTTTcCCTCTtTTtCTttCCctTCTCTtCcCTTTTCCtTTTtcttctttctCTtttTcCCctTccccttTCTtcctTttctctTtcTCtCTT	<B@CBDEDFEGGFFFDEEFEBFF@<GFEFCEEFEEGEEFEF;FFFGFGFFFE=FFD;EF@FFGCFFGFEDFFFEGFFFFEGGEGEF;FDDGGFDFF:FGFEFGDDFEDC	T	66	C	43
3	183884895	C	32	ccTttttcctctcttctcttcttcttttTttt	CCGDEEDDDED>DEEDEDEEDE9DFEFEFFEE	T	22	C	10
3	183906515	T	74	CcCcCCCCCTCTTTTcTTCTCCTTCTTTCTTtCCCCTCCtCCtCCTTTTtCTcttcCCCtcctccCTTCCTTtt	=>??@DDDDGDGGFHBGEDGCDGG6GGGDGFBDDDDGDCHDBHCCFFFFFCFCHHCCCCFCCF;ACFFADDDA@	C	39	T	35
3	183907032	G	82	cCgCgGCggcccgCcGGCGGCgGCgccGCcCgGgcccCCCGgGGcggcgCGGggcCcGccGCCGgCCCCcCgcGGGGccccg	A?AFFFEFFFEFFGFIHGHHGF=GFFFH:GGCGGGGG>GGHGHGGGGGGFGGGGGFGGGHGFFGGFFFFGFGGGGGFGCBA?	C	44	G	38
3	183996213	C	26	tcTtTCTCTcTCTTTTtCTCTCTTTt	EBFGGDGDGCGCFGFF@CFCFCFDBC	T	18	C	8
3	184021628	A	47	cccaAaaacaCcaaCacCCcCcaccCaCcacccacaAccaacaCCaA	@?@A<CFFBEDAFFDFBDDBDBFBBDGDBFBCAGCFCBCGECGC9AG	C	27	A	20
3	184071063	G	142	CCcccGGGGcgCCGGcGCCCCGGGGccggcgccCgggcCcGcGgCggcggccGgggcGgcGgCcgCGgcgCccGcgcCcgccCgCGcGcGggggGCgcggggccgccCcGGCggcCGgCgGCGgGgcggCggCGCCGCGccG	D>C??@<AAEDDEDCCEAEFFDDEDFEFFFFFFFFF?FFFAF@CGFFFFFFGEFFFFEFFEEFFFF;FFGAGEEGGGFGGGGFGBEGEGEGGGGEFGBDGGGGGDGGEGDEEBGFEDGFGDFDGDGGGGFG8FDFEDGB@CC	G	75	C	67
3	184295316	C	142	TCCTCTTcTtCCCTCTTcCttCttCttCTtcTctTTtCCTcctCttctccccCcccttTCcccTcccTTcccTccctTCctCCCcttCctctCcctCttTcttctttccccctTttctCttttttctctctcccctctcccc	=>87=AB?FGBCCGDDHBDGEDGGDGGDGGBGBFGG9DDGBBGEGGAGABBBDBBBGGFDB?CGBABG?BCCGCCCHGDCHDDDAHHDCH@GDCCHCFHGBHHA@HHCCCCCHFHH6ICHHHGHGCHCHC>CCCCHCHB@>7	C	76	T	66
3	184295921	C	37	tttCctttcccCtcctccctcttctctcttttctCCc	A?A?CEDEDCDGEDDEDDE<EFFEFEFDFFDFEFGB@	C	19	T	18
3	184299167	T	109	ctTttcccTttcCTttCtctcTCCCTTctTTCTtTTCCTcTcTcCTTtTcCctccttTCtcctCcTcTttTcctTctttCttttTccTttcTCCccTTCCTttTtTTtt	?ABCCDGFGEEFDEEEDEFEFEDEDGGDEGHDHEBGCDFFDFFFDGGEFGDGFGGFFGC?GGFDFGGGFFGGFFFGBFF?FFEFFGGFEFEFCCFFFFCAEB@C?CDA<	T	65	C	44
3	184910535	G	126	AaGGGggagAGaaGGGaaGaaAaggaAAAgAagGagggaggGAaggagagaaagGgaGaGGaGGggaagaAggaGAggAAaAGagggGgAggaGGgaaggAaGggaaAGgGaAaaGgggggGGgAg	EC=;68ACAD@EGABBFFBFFHEBCEHHGCGFCCFCCCFCC@HCCCCCFCCEFCCCFCFACF>CCDFFCFHDDGCHDDDHGHCGDDDBDHCDEABDGGD?GGBDEHHGBDBGGGGBDDDDC@=@B@	G	71	A	55
3	184911151	T	199	cctTcTctCCctTtCctcCTttttCTTTCTTCcCttCCctctccctTccCccCtTcTctTtCCcccTTtctTCTttCCTTcCcCTTcttcCtccctcCttcTCCtTctTTccCcTcCTCtTTcCCcCCtCtCTTcCtccTTCCcCCTCTccTctTtccTCcccCttctcCtcTTCcTCtctCCCtcCCTTCcTtttctc	CC@>?=BBFGE>DEGFEFGEEEEEGEEEG>EGFGEEF<FEFEFFFEEFFDFFGEEFEFEEEGGGGEEEEFEEGEE:GFDBGGFFDEGFFGGFGGGFGGFFGEGGFEGFEEGEGFEG>EFBCDGGGGFFFFFFDDFFF<GDDCFGFFCFDGGDGFDFGFDFGGGFFFGFGFFGBBFGDFFFFFFFDFDCCB@AAAA>?CC	C	109	T	90
3	186015283	A	46	GgGAagaagGAgAAGAggaaGGGAGgAGggaGAAgGgAAagGaggA	CCFFDDDDFFCFFFGFGBEEFGGFFEEFGGEFEEGFFEEEGECCB>	G	26	A	20
3	186276393	C	30	tttTtttctccTcTTCtttCTtTtcCTtct	C@DGGGGBGBBEBGGGGHHGGHEH@FFH;C	T	21	C	9
3	186288811	T	33	tttttttttTtTTTTTTTggggggggggggggg	<A@BDEGFF<B;=EA=;B<DA>@D77BD?C:9;	T	18	G	15
3	186288815	A	30	aaaAaAAAAAAAgggggggggggggggggg	CCCEAC:EFD@EDDED>BDD7BB7ACCC>?	G	18	A	12
3	186330969	C	260	CcCGGGCGCCGGCCggGGcgCCcggCCGCCGCgGCCcgcCcCGCgCgggGccCCGGCgGGGCGgcCGcGcGGcGcgCCcCCggcgCCcCCCCgGcgGccGCGgCGCgCcCGCcccgGCGgcGCgcGCCGcCGGGCccCGCgcccGgCGcGCGcGcccCCGCGCGggGGCGggCGGCCgCGCGCGGccGccCGCCgGGGcgCGGgGcCGcgCGGgCCCggGCgggcCgGGcgCccCgccgcgGCCGCCgccgCCCGggggg	@CCDEF:FEGHHFFFF6GFFDGFFFGGF9GGFFHFGEFFGFGHGFGFFFEFGGGHFFFHHHGHFEGHEHGHHGGGGGGG=GFGGE5FGGEGEGHGAHBGHGHGGGEGGGGHFGGGGHGHGGGGGGFDGHGGGFGFGBDGFGGGGGGFGGGFGGGGGGFFGDGEFGHGGFGD?@GGFFGFGFGFGGGGGGGF?FFE5GGGGFGGGGGFGGGFG@GFFF=GGDGGGGFFFFGGFFFGFEDCACEBBECC=BAA>>CCB;?AE	C	134	G	126
3	186390627	C	112	TTccCCtTctCtctCtccccTtcCCCtttcctCCCtcCtCtCTcCCTCtTTcTcCCCtTTCCtctctcccCcttcTctttcCCcCTcccttcctCctCttttccctcccctc	DA@CCCEEDEDDDDEEDDDDGEDD5DDEE@DEDDDECDEDDDGDDDGDDGGDFCDADFGGDDF;FDECD?DEEFEGEFFFCCCECEEEEFFEEFCEFCFFFFEBEFDD>>9A	C	66	T	46
3	190030680	A	116	AAGAAAAAgaGAAGAGaAAGaGaGaGAAAAGAAAaGGAgAAaGAAGaAaaggAgAaAGaGaAgGGGAAGGgAAAGAgGGAaAaaAaAaGAAaAAgAGagAGaaGgaGGAAgaGAag	CC<DDEHBEDCHFCH@EHHCECBCE>HHHCCHGGECCHGHGF?HGCDHCFGGFGHFGCFBFHFBBCHCCBGGGEBGFBBG@BBEGFGFBGGFGGGGAFGFAEC@CA==>BB:CC>C	A	73	G	43
3	190999917	C	181	CCCcAACACCCAACCCcCCACCACcAcCAAAaACAacCCccCCAcCACCACCAcaCAcacAcCAAAaACAcCaAAaCcCCaaCCccaaaCaaAccAaaAACAACCcaccCaCcaCccAcaaAcAacaacccCcaAacccaaAaaaaCcACccaCccCacacccaaaCcccaccCacCAAaa	DB9BA@CDFFGFFGGGFGGFGFFFFFFDFFFFFGEFFGGFFGGEFGEGGFGGFFFGFFFF;G<FFFGFFFFGFFFFDFGEGGFGGGGF:GGFFGGFGGFDEDEGFGGGGGFGGGGGGFFGFEGEGFGGGGFDGFEGGGGFGFGGGGFCEFGGFFGGFBGGG?GGGEFGGFEGGEEGGECB?	C	99	A	82
3	190999990	C	83	tttCcTCcctCccCctccctttCccctccCtcCTTtcCCcttcccccTcTCcCccttttcTCccccCctttcttctCcctctt	CAC=CCCCDEGCDGDEDDDEEEGDDDEDDGEDGGEEDGGDECDEEEEGEGGEGADDBFFDEGDEDEDEFFFEEFEFFEED??B	C	51	T	32
3	191093053	T	114	CccCtTtCctCTccCcTtCCCCTCTTttccctcCCCTTCTTTCttTTTCTTCtTTCTtTCCtTtTCCCttTTTCttCCttcCCCCCTTcTTTCTtcTcTcCtCTTTTTCCctCc	A;CCEECFGDGG@GFGGBGGGEGD<GDEGGGDHAGGFGGGFGGEEGGGGFGGEGGGGEGGGEFEGFFFECFDFFEBFFECGFFFFFF=HFFFFFCHFHEHFEEEEECCDDD?AC	T	60	C	54
3	191093310	A	70	gagAgAaaAGAaGAAagaaaaaggaaaaGaggagggagaGAggaaAAGggAAaGaAAaaGgAAgaggGGa	CC?=BDEDFGFDGDFDFDDDDDFFDCDCGDFFDFFFEFEFEGGC;FEFGGEEEFEEEEEFGEEGEGGEE@	A	41	G	29
3	191098731	G	29	gggaAGaaagaaagAaagaggggaGggga	BBACCFFEFFFFAAEFGGCGGGGGH:GGG	G	15	A	14
3	193183817	A	67	gGGAGaAAAAAGAgAaGGGAGGGGaAaAgaAagggGggGAAGAGagaAAAGaGGaAAAagGaAGgaA	B>>B=CGHHHHCHFHE<@CGCC<CDHBHFFHDGFFAGF>GGBGBFGGGGGBBBBFGGGAGBFGBBAC	A	36	G	31
3	194080336	G	190	AGgggGGgaggAAAGAGAgggagagggaaAaagAgGAAaGaaaGGaGggaAaAggggAAGAaggAAgGAGAgggGGAaaagAgggaaGaaAaaGgAAgaAAgggaAaaGaaaaaAggggaaagGGGaAgaAAAGGaAGaAAaGAGgaaGaGgaAaAGAAgaGGaGAGaGAagAAagggaGaAGAAgAAAa	;>=CCACBFBBHHHCHCBCCCFCFCCCFFHFFCHCAHHFCFFFCCFDCCFIFH@CCCFHCHFDCHDCCHCECDDDCG=EGD:DDDGGAGGHGECDHHDGHHCDCGCFGC<DGGGFDDDDGGFDCCBG:@GHGGBBGGBGGGGBGBDCGBGBBGGDGBGGDGBBABGBGAGG@GFFCCCFCCC=BB?CC@D	A	104	G	86
3	194080916	G	116	gGAAgAaAaAggGGGgggAAgggGgGGAagaAaGAaAaAgAgGGGGAaAGGaGaagaGAAAaaAGggGGGaAAggAAGaGGGAgGAGGaaaaAAGgagGgGgaGGAGAaaGAgAaG	7?DDCHDHFHCC<=CCCCHFCCCCCCBHCCFHFCGDGFGCHCCBBCHGHCCGCGGDGCHFHFGHCDDBBBGGEDDCEBGBAAGEBGBBHGGGGCBBFDBDBDGBBG@FGE?EAD@?	G	60	A	56
3	194180743	G	26	tgggGgTttgtgggTtgttggtgttg	ABCGEDGDDFDFFFGDFEEGGEGEFF	G	14	T	12
3	194379596	C	33	CaaCCAAACAACACACCCCCCCcCAACaACAAa	DDCDDGCHDHHDHCFCCCCCCCGCGGCEGBED?	C	17	A	16
3	195022534	G	25	ggtttgggGgtgtgtgtgggggttg	CCDD5FFEGFDFBFDE?GFFFFFGF	G	16	T	9
3	195487737	A	29	AaGGGGgGAAGGAAGAAAaGAGGGGAagG	CFCCCCCCHHCCHHCGGGGBFBBBBFGCB	G	16	A	13
3	195943481	C	25	tcTTcTcTcTtCttcttTcTTtCTt	E@GG?DGEGGDD?CFEEGG@FECF9	T	17	C	8
3	195955762	G	73	AgaGgAGGAAgGgAaGGGGAAAAaGGaGGGgGAGGggaGAAGGAgGaaGagagagGAAGAGgaggggaggaaG	@FECFF?CDHFCFHFCBCCHHHHBBCDCCCG@HCCEF=CHGBBGG@G@AGG>GGGBGGBGBGGEGG>GFCC=>	G	43	A	30
3	196118621	A	113	ATTTTTATTATATTATTTTATaaTtTTTTAATTTTAAAtTTTTTtAATaTtATAAaTAAAtTTatATTTAATTATAAatATAATTAATTAtTATTAATTAAATTTAAaATtat	?BDEEDCECEEECE<DEEDEEEEEEEEEEEBDEEEEDE=CDDEDEEDCEEEDDDDEDDADEDDEEDDDDDDDDDDDDEEDDDDCDDDDD;DDABDBCDCDDACBBA@:>ABBB	T	65	A	48
3	196443826	A	28	AgGGGGaaaaagaaAgGgaaAGgggggA	?AGGGEFFFBBFEGDFGGGGEFGGFEFD	G	15	A	13
3	196627335	T	26	TctTtTCctCtttttcttccctctcc	D>>CGGEBGGGGFGGBGEBCCHCHCC	T	15	C	11
3	196742395	G	88	GAGGgAaGAaGAgggGaaGGgGGgAaGAaagGGgggGgGaagAgGGaaaGGAAaAGAAAaGaAGgggGgGgAgAGgggAGggAGaaga	E>A=BEFHBFGECCCHFFHHCHHC8FHEFGDGHD=DHCEFGDDCHHFFGCH66GDGADDGFGDGE7DGDGDDDBGDEDCGCCDECA?D	G	52	A	36
3	197557635	C	98	CTtTCCCTTcCCCtTCCCCTcCTCTTTtCCCCttTCtTcTTCTCTCcccTTTCTTTCCCCcCTTcTTCtCTTCCTCCCtttCTCTTTCtCcTtTCCtc	CDGEGHE9EBGGEHEGFGGECGEGEEEHGGGGHHDFHCCDDFDFDFCCCDDDFDDDFCFFC=DDADCDHDDDFFDFDFAHHFDFDDCF@G?CBB>B@7	C	50	T	48
4	59571	A	60	ttatttaaaaaatattaaatatatttaaaaaaataaaataAaaaTaaAaatataaatata	?ADDEDDDCCCC9DDCDDDDDDCDDDDDDDDDADEDDCEEEEEEGB<FEEDEE8EEEDC?	A	40	T	20
4	60400	G	93	gggAGAGaaggaagGGaaaAggaAGaAaAgaggaagaggAaaAagaagaaaagaaaaAagggggaggaggaggaaaagaagagaaaaagaaag	>@AB;@9CCCBCCDABFFFCEDEHCEHEH8EFFEEFEEEHEDHEFEEEEEEEEFEEEHFGEFGGFGGFEEFGFBFFFGEFFDCEFF?FECFCB	A	55	G	38
4	533001	T	46	TTTtTTCCTTCCCTTCCTTTTTTTTTTcCCCCTTTCTcTcCCTctt	EDEEFEEGEE@GFEEGFEEEDCEDDCCEFFDFDDDFDEDEFECACB	T	28	C	18
4	994414	G	94	AgAAaaAAgAAaaGgAaGagGgGGAGAagaGAgAAaAggaAaGaaaAaGaaagAGaGagAgaaaaGgaAgaagggAGaaaGgaaaGgagaaAga	DC@@DDEFCHEFFCCHFCFCCCCCGBHFCGCGCHHFHCBGHGCDGGHGBGGGCHC=CGCGDGGGGADGGDGEDDDGBGGGBDGGGBDGDCA@AD	A	58	G	36
4	995459	C	98	ccttctccctccccTtcTctcttccTcTCtcCCTTTtttttccCTCtcTTTTTCttcCTtTTTcttcTcCttctccTTCTccCcCctTTcttCtctTt	CC?@>CABAGBBBBGGBFBGBEFABHBGDGBDDGGGHGGGHC=AGDHCFDGGGDGHB@GHGGCCHHCFBDHCBHCCCFCDCCCABCGFFCHGCH=FD<	T	53	C	45
4	996258	C	51	ccTttctcccccttttcttctccTTccctcttttcttccctctctcctttc	C?ACCCDEFFEFDEEEFEDFDFFFFEFFEFEEEFGFEFGGBGEG@FG9BFE	T	26	C	25
4	996768	T	54	tcctTCcctTcTcCTCctCcTTTctTTCCtCTCTCtTCCCCttTCTTTcCCTTC	HAAEGDBBGHBGBC@DCHDCGGGCHFFCC;CFCFCHFCACCHGC?CCD;CCCC@	C	27	T	27
4	1006200	G	96	AAgGAgGGGAaAGGgAgAGGAgGgAgAGAGaAaGaAGGAaGGaaAaGAAgggGGGGGGAAGAGAgggaggGAggagGaggagGGagAagGaAGGAG	DECB7BCCCHFI>>CBCHCCHCCDFDE;HCEHGCGHCCHECCGGHGCHBD@DCCBBBBGGCGBGDDDGDDBGDCGDBGDCGDBBFCDA<>=CAA??	G	56	A	40
4	1050653	G	29	GAAGGGGAGAAGGGAGAAAGAAAAgGGaa	DFFEEEEFECEED?EDEEDCEEECACADD	A	15	G	14
4	1244267	A	26	GGGaGGAGgAAAGGGGGAAGgGGAGG	ABCGCCHB<GGGBBBBBGGBDABGA=	G	18	A	8
4	1291711	T	90	TTTTTTTTTGTTtGTTTGtGTTGgtTTGGGTGTTTGGttgtGGTgTTTGTttGTTtGgTTTGttTGttGtGGGTgtTGTtTGGtttGTgG	>DECFDGGF?FEEFGCFDABEFDADGFB98EGGGGFCF@FFEEF>EFFFEFFFEFFFAF=CFFEFFFFFEFFFFFFEEEEDDB?:?AB>?	T	57	G	33
4	1348806	A	50	caCCaACCAAaACCCCACaCaACCCCaCCCCCCCAACCCAAACCACAACC	ACGGBEF>FFFEFBFCFFBF;9FGFFFEFFEFE<DEFEEEAEFEDE@EC>	C	30	A	20
4	2439900	C	106	aAACccACAccaccAcacaAcacaaaaaccaaacaaacaaacCaaaaCCaAcaaacaaAccacCCaaccaaCaCAcacAaaaccaccacaCaccacaaccaaacca	AA?>CAD?ECCECDFDEDEFDDCEEEEDDDE?EDEEE@ECEDGEEADHGEGDEEEDAEEDEED=GFFCEFFCFGF8FDFFFFEEFBEFEBGDEDEEFFEDFAFDE?	A	60	C	46
4	2746285	A	128	ACcaaCcccAAaaaAACAccaAACaAAaAcaAaCCacCcCCcaaAaaCCAaaaaAcaCCcaaAcacAAcCAaaacAAAAAccaAAccAaCAaaccccaaccAaaaacaaAaccaAcaaacaaaccaca	EACAC?@@AAECDCFGCHCAEHHDEHH?HDEHE8DECDDDDDEEFEEDDHDEEEGDEDADEDHDEDFHECGFEEECHHCHEEFGHE<H8DHEFDEEEFEEEDFBGFFFEEFEEEFEFEDEFFFED9D:	A	79	C	49
4	2829409	G	99	GGaaggaagAAgaaggggagAggaGGggggaAaaaaaAagagAgAgGgAGaggAgaAaagaaaaAGaaaaaaGaaagAAaagaaaaaagggaaaaaagg	@=CA=ADB@A@ADECCCBFCFBCFEABCCCFFFFFFFD<CFCFCFCECGFFCCFCFFFF8EFGGDDGGGG8DEGGF?FFGGDBGGDFFDDDGAEDGGD8	A	60	G	39
4	2988636	C	25	tctCCccTcCtCCTtCtCCCCcTcc	CDEEDDBGEDFCDGEC<CCCCBFEE	C	17	T	8
4	3006043	C	114	cCCCtcTcTtcCCCCCccTCtcccttTtcTccCCtCcttCtCcctCttCCccTcctCCTttTctCcttCCTcCTTtCCctcCTTCcTccCctcccTttCTtcttctttttCcCc	C=@CDCA>FEDFGFFGDDFFEDDD=EFEDEDDFFEGEFEAEFEEFEFFFFEEEEEFGGF<FFDFEEFEEFEEFEEEFFEFDF?EFEEEEEEDCEEDFFEDFEACCCEEAFEBC@	C	66	T	48
4	3148653	T	173	TttgTgGGTgtGtgGTTGgTTttgtTTTGgggtggGGttTTtttggTtGGTTGTTtgtgggGttggtgTGTGtgGgtGgtttGtGggTtgGGGTtgTGtgtggttttGGttGggTtGggggtgtGgtttttttggTgtgggtgtGGGgTggggTGgtgtgGTgtTgggggttt	BAAA=ABA?BFGDF7EEHEEDEEFEEECHFFFEFDHGE=EEEEEFFEEHHEEHEBEFEFFFGEEFFEFEDEHFFHFEHAEEEHEHGAEFFGHGEFG=HFDFGEEFFFHGFFHFGEFHFGGGCGFGFFBEFFFFGGCG:GGGFGFCGGDCGGGGDGGFGFGGDGECGF?DB8CC	G	91	T	82
4	3255258	A	76	aaAGGaGGgaggAggaagAGaaggaaaaaGAgaaaaagAaagaaagagaggaagagaaagaaaaaggggaaggaAa	@?>=;ACCDDFFHEDEDFGCEEFEEEEEEA@EEFEEEFHFFEFF@FFFAGEFCEEGCEEFAE7FFFGGF=FDFFCB	A	46	G	30
4	3344680	G	126	GaAGGaagGAgaaGGaAGAAAAGGGggaGAGaAgGAaAaAAgGGAAgaAggAGagaGgAgaAGgaAAAAGgggAGgGaaAAGgAgaGagggGaAGaaGaAGagGgggaaAAaagaGAgaGgagggA	<B@>?EG@AHBFEACFHCHHHHCCCCCFCDCFFCCHFHFHHCCCHHCGHDCGCGDGB?HDGF;DGEHGHCDDDHCDBGGHHBDADGBGCDDBGGAGEBGGBGDBDDDGFEGGG?GAFCF@AA=<8C	A	64	G	62
4	3445745	C	50	TcttCCTTtTCTTtCcTTCttctTTcccCTcctttTTcCCtttCTcCCtc	B9DDGDGGEG?DG9GEGGGFDEEGGEEEGFEE;F9F:EBFFCFFFEFE:B	T	28	C	22
4	3446132	C	87	ccGGgGCGGcGcCccgCgcCCcgCCggcgGggGgcggcgGcgcCcGgcggcccgccCCcccggggGGcggCGgggcCgcggcgggcg	:>CCBEEGGBFBEBBCGBAGGBCDGCCBBFCCHCB?CBCGBCBGBHDCD:CCCDCCGGCB<DDDDHHCDDFFDD>CDDCDDBBBA>?	G	47	C	40
4	3478323	T	51	TtCtTCTTCctccCccTctctcTCCTcTTtttcttTccttctcttcttttc	?@<DE5FGCBE9BDBAGBGBGAG:AHBFEGHHCHHGB>HHCHCHCCGGG@<	T	29	C	22
4	3494847	G	83	aaagaaaaGGGAaaAagGgAaAGaAGGAaGAggaaGggGaGggGAgGGgAGAgGGgagagGaGaGGGGgAGAAgGAaggGagA	EDFCEFFFCCCHFFHFCB?EFHCFAC>HGBHDDGFC@C:FCDDCHDCCDHCGDC@CGDFDBGBGBBBBDGBGGD:GB<><=<A	G	46	A	37
4	3498624	G	50	AAaaaaggggagaaggggaGagagagaaggGggaagaaagggagAagaaA	@DCBECFDFFDFABFFDFDECFD=AFDCFAAFFEEF=EEEGAEGFDGEEE	A	26	G	24
4	3501873	T	37	CTTTCTCTTCTCTCCTCCctCCttcTcctCTTTcCTt	GC?EGFHDEECFEGEEGGCHFE=HCEC7HDDCC9A>B	T	19	C	18
4	3502386	C	39	cTCTTCCCcTCTTCCCTTctTtCCCTTctCTTctTTCtc	BFFFFGG>@AGFDBGEF:CGBHFEEDECEEDECHBEDC<	T	20	C	19
4	5687263	A	25	aaggaaaagggggaaagaagaaaGA	BCFE@DEEEFEEEEEFEFFGFFEBH	A	15	G	10
4	5757944	A	27	aAACCCcAcaACCccAccAACCCCCAa	B@F?GGHDHEFG:HHDHHBEFFEBBBB	C	16	A	11
4	5812566	A	97	GGAAAGGAAGAAAGAAAGAGAAGGAAaggAGGAaAAGgAAAAaAGGAGAaAGAaGgaaAGAAGAAggAAAAAggaaGaGAaaGaAgaAAgaaaAaaA	=:FFDEGFFGEDFFFFEDFFCFGGEFGFGFGGFBEFGGDFFDGFFFEFEFEGDGFGGGEFDEFEEEGEE@EEFGGEDGFEGFEFDAC>CBBAAAABA	A	64	G	33
4	5837871	A	37	gggggaaggaagagagagagggagaaaaagggggagG	@<AABEECDFFCFCFCFCFCCCCCGGFEBDDDDD>CA	G	22	A	15
4	5969113	G	48	GAGGAAgaaAGgGAGGGgGGGAgggaGAGagGAGGAaGGGgAAAGggg	EFEEFFFEEFDGEFEEEFEEEFGFEEDEDEG9EDDEF:DDFEEDCFFA	G	31	A	17
4	5977695	C	197	TCcCTCCTTcCcCCtTTCctTttttCtctctttTCtCCTcctcTCtCCTCcttcTtcTCCTtTCCtcCTTCCtctCcTCcCCTcCtctCccctTCcCctccccctTCccCCTcctCCCttTttCTTcctcTCCcccTcCCtcttcccCtcttTcccCTccCctcTttctttctctCccctTctTcCtcccttcctCc	C@C9?ABA??=@DBDDEFAGFFCGGFDAGBGGGAFGFFFBBGBEGGEEFFBGGBFGBFEFFGFFGGBGFFGGEBGBBEGCGEE<FGAHECCBHFECDCHCCCCCHFFCCGEFBCHGGGHHFHHGFF@BHCEFFCBCECG=HC:HCCCEHCHHECC@FECCFCHCDHHCHG@CHCHFACCGE@HECFHCCCGGBADB=	C	113	T	84
4	5990110	C	234	CAAACCcCAccccAAccACAcacACCCcaACCaaCaCAcCCCAcaAaaCAcCCCaCAaCcAaaAAaacCCAAAAacCACAacCCCAaaaCcaAACccACCCaaCcAAaaCAACccACAcAAAACCCaCaCaAcACcccccacACAaaccCCAcaaCcAcaaACCaCCcaacaaccCAccAACaccaCcaAAaaACCcAAaaacaaCacaAaccaCACacAcCCAaaccCAAcaC	AC<><?>@@DFEEHHEFGCGFFEHDDDFFHDDFFDFDHACDDGFFHFFDGFDDCEDHFDFFFEIAFFFDDHHHHFFDHDHFFDDDHFFEDGFHGD=FHAD?GEDGHHGGBHHCGFGDHGHHHHDDDGDGDFHGHDGGBGGGGFDHFGGDCCGFDGBFGGGBCCCDCCGGGGGGGG=EGEGECGGFGCGGFGGGGCCGGGGGGFGGCGGGGGE>GCGCDGGG9@GGFGE=BC??C	C	118	A	116
4	6382919	C	93	CTctTttcTTttctTcttctCTCCTtctccttCctCttccCTtttcTTtTTcCtctTtTttCCTcTtTccTctcttttttTctTTtcTtCcTC	<>@EEFBBHGGGBCGBDGBGDGEBGGBGBBGGDB;DGHCCDAHGHCDGHGGCDHCHGHGHHCCFBFGFBCFCHCAHHFFH@CHFFHCEHCBDA	T	59	C	34
4	6415618	G	118	GGGGAagAGAAAGAGGgaAAaagGgGAAGGaGAAAaGGaGGAAAGAGAGaaAGaAAaGagGAgGGGAGAAGAGGAGaAAgAAAgAGGgGaaAAAGaaGgaaGAGGgagGAGaAAgAGg	CAEGFDEEFFFFGFGGGEFFEF>G?GFFGGEFCFFFGGFGGFFFGFGEGFEFGEEEF@EFFCFFDFEFEEFEFFEFEE@HEEEGEFFGF?E=EEFEC;GFDFEFFG?FEDDCFD>??D	A	62	G	56
4	6594947	A	396	ACAAACaacAAAAAAacccaAACAAaaaACAAcaccaaaCCAAAAccacccACCCAAcCCACACAaaccccCACCacaccccCAccacCCCcacCAAcaacaAaaaccCACCCCAaccaAaACaaaCCccacacacCAcACaccccAaacCAaaAcaCcaaaaaaAAccCccaaacaCCcaccccAAccaacacCaaaaAACaaacCCcaacAAACaaCaaaCCcccaaCAAAacCAcccAAaCaAaacccACaccaaCaAaaaAcacccCACcaccccacccAAAcaaaaaaAcccaCCcaacaAacaaaCcCCcaAccccAACAaacaAAacacccaCaaacaCAaCaaAcccAcAcaAacaCcacAAccaaccaaAacAacacCAcaacccCa	E?C=9<@ACBCC;AB9DCD=CC>BCBAAD<CDFDFGDDECCHHGGGGDGFFGCDDGHGDDHDHDHDCGGGFDHDDDGDGGGGCHGGDGDDDGDGDHHGDDGDHDDDGGDHDDDDHDGGCHDHEDDDDDGGDGCGAGEHGHDDGGGGHDDGDHDEHGCDG>DCDDDHHGGDGGEEEGCCDHEHHGGHHHABCHEHDEE9EHFDEEEHCDHACGHHHDEEDEEECDGCHEADHHH<HDHHHHHHEDE:EEHHGHDDGHE;DEFEEDHG9GGHDHDHEHHGHEHGDHHHH9EEAEEAHCHEDCEEEH@GEHEE@CHCCDCGHH9HGFCG:FBDGGEHEHHHCCEEEHCCCECEEGHFHGHGGEGAHECHEHFFFHDDGBDEHCFEADAEBDC<=<C@AB	A	208	C	188
4	6969163	A	164	AGgGAAaAGgGAgAGGGaGGAGGGgAAagggGgAGgAAagaaaAggaGAGgaGGgaggGggGAaaggagGgaaagagagaagaGGGgaaagaaaaaaaAaggGggaaggaggggggggaAaggagaagagagaagaaaggaaggagagaagggagggaagagaa	BC?A=>C=?BEDFDA?GDGHCHGHFEEEEEFHEEHFEDE>EEEEFFEB@HFEHHEDEEHE?HEEEEEEEHEEEEFEFEFEEGEHHHEDFFCF@FEFFF<FGGHFFBFFFFEGGFFEFDFEEEEFGFEFF5FGFFGFFFFGFFGFFGFGFDFGFEGFGFFGEGB:	G	88	A	76
4	7725693	C	25	ccttcttTttccctttcccttttct	BCEDCEEEEDDDDEDEDEBDGD=EF	T	15	C	10
4	7731310	G	39	AAGGaAGAGAAAGGgGgGAGGGGGAAAGaAAaGGAGGAG	AHBCDHCGCHHHBCGCGBGBAABBGGGBFGCEBBFBAD@	G	21	A	18
4	8613026	G	57	aAGAaGaAaAAGaaGgAAggGagaAaGagaggAGGgAagAagGaAagagAgagagaa	C@GDDGEFEFFGEEGEEFEFGEEFFEGFADGFFGGGFEGFFGGEEEFFGEFFEFFFE	A	33	G	24
4	10027643	A	54	gAgAgaaaGgAagAAAAaaGgagAgAGgAaagaAaaGGgGaaaaggagGaGAaG	FFFEFBDDAGFDFDEFFCEGEDEFGDEGE6EGEDEEFFGFEEEEGGEGEDBC=C	A	31	G	23
4	10117728	G	105	AGGGAAAGAGAGGgGAGGAAgAAGAAAAGGGAAAAAaggGAAGGAAAAAAGGgGGGAGgGaGaAAAGGGgaAGAGAAGGAAgggagaaAAGGaaGagGAaAaAaa	EEEEDFFEFEFEECEF?DEFCFFEE?FEEBEFDCEEGDDEFEEEFFEFEFEEDGDDDDDDGDGEBEDDDCFEDEDEEDCEE@DDGDGG;EDCGGCFCEDECCB?@	A	57	G	48
4	10542058	C	89	GCCCGCCGCCGcGGCGGCccGgGGGcgGGccccCCGGCcGCCCGCgcCGGGGGCCGcgGGGgggGGcGgGgGGgCCCGGcgGcCCCCcC	CB>ADEEHEGHDHHGF@GDDHEHHHEFGGDDDD>GHHFEFFGGGFGEAGGGFGFFGFGGFGGFEGGEFFGFGGFDEFHGE@F?>BB>8?	G	47	C	42
4	13545792	G	43	TGGTGGTtgTTgTGtgggGtGgtGGtggtggGTggTgGggTTt	B?AECCGEEGBFFBFFG7;FCGEBBFFFEGEBGEFFGBDGFFC	G	26	T	17
4	15004655	G	94	aAAGgGGAAGGAGaaagggaGgGgaGggaAggagaaaaGaaaGaaaagaAaAAgAAGAGgGggAggaAgaGGGaaaAAagAaAgaAAggggGgg	AA@;A>>>HCCHCDDAFFFCCFBFD>D?DGDDAFCDDECEDECEEEAGECDHHGHGBGBGBEGGFCFGFEBBBEDEEGBGGEFGECEBBAA>?A	A	49	G	45
4	15568992	T	29	CTTCTCTTTTTTCcttCCTTTcTtcCTcT	BHGBGDGGDGGGCEAEC@AFEDFFEBGDE	T	18	C	11
4	15569146	A	58	accACCaacaACCCaAAcacacCCCaAaAAcCCcCCaAaAAaAcaccaaCaaaACCcc	C>@FGGFFBFEGGGFFFBECFCFGGGFFEEBGGCEGDEGEFGEBEC>GGFGGG<EF@>	A	30	C	28
4	15640168	C	107	CCTcTcTCTTcTcTCCTTCtctTTCCcCCCccCCTTTCCTTCTCCctTTTCTCCtTCcTTtTTCcTccTTtttTtccCcCttTctTTCCTtctcCtCcCcctctttt	?FGFGFGGDGFEFH?DGGEEFEGGGGFGGGGGGDGGGGGGGGGGGDFGGEFGFGFEDGFFFFFFGEGGFFFFFFFGGFGFDFE?FFFCFFFGFBFFFGFGGDFE@@C	T	54	C	53
4	15706466	T	66	CCTTTTTTCCCTTTTTCTCTTCTTCTCCTTTCCCTTCCTtCCTCTCTtCtCtCCtTttCCCCcTCT	>:BBEFFF9GBFFFFFFDF?FFFFFFG>FEEFFGFFFCEFDFEEEEEFEFEFFEFEFEECCA@AC?	T	36	C	30
4	15737937	A	27	agagggagagaaggagggaaaGagggg	CC<>BGDFCFDDFFDDFFDDDGBGGGD	G	16	A	11
4	15977823	A	62	acacAACCAAAAaACcccAaaaacCcAcAacacaaaCaCAaacCaacAaCCCaccaaacAaa	C?>@AEFGFDFFDFGGGGEDDDDGGGFHFEHEHEEEGEGFEEHFEDHEEFFFEHHEEEBABB	A	37	C	25
4	16215537	T	87	TTTTTttgGGTgGGGGGgtTtTtgtGtTgtGtgTGtgGtggTGgtttgGTttgGgtttttggTtgttgtggggGTttgTtttttTgt	@CEEDGFCGGECGGGGGCGFGGGCGGGGCB>GCGFGCG>DCGF7HHGCFGHHDFDHGHHHDDGGDHHDHDDDAFFHH9FHHHGHFCC	T	49	G	38
4	16675898	C	152	aCACcAACCCCaCaCCCCACAAccCAAAACCCCcaCCAaCccCCCACcAAacccAccACCacACAAcAccccacaCCaaAaccCccAaCCaaCCccccaacCcacccAacccacAcacacaaaaCccCcacccaCccacaCcAcaccccacc	C?B<>EFCDD?EDF;DDDHDHHBBDHHHHDDDDBFDEHFD?BDD7HDBEHFBBBHBBHDDFBHDHHCGCCCCGCG7DGEHFC?DCCHFDDGGDDCCCCGGCCCGBCCGG@BAGCGCGCGCGGGG@C>CCGCCAFCCCG?GCCGCGCCC;E8<	C	95	A	57
4	17608620	A	51	ggGGAAgggagGAgagaagAgGGggAggGaagggAgaggggaagaggagaa	AC@GD7EFFFFHEFFCEEFEFHHFFDFFHGGFGEEGFFG<GGFGFGDGGGE	G	32	A	19
4	17627332	T	100	CTTttTTtTTCTTCTCTCTtTCTCTcTtTCcCCcttcccTtTTCtTCCtcTTctTCtCCTcCctCcTcctttTTTtCTtTcTCTcctctcTCCTtcctTt	>EEEEEDEEEGBEFCGEGEEBGEGEGEFEGFGGGFFGAGDFEEFFEAGFFDDGFEGE;FDFFGFFGDGFFGEDDDAFDFDGDFDGG@FF:CFFCCDCCCC	T	58	C	42
4	17649494	T	39	cTtCTCcTTcCtCtGCtcccttCttttttttcctctcct	CAFE<G>FEBFGG@EFH<;<GFFHHGHHHHH=BHCFBBB	T	21	C	17
4	17649499	T	37	GTGgTTTgGtGgGtgggttGttttttttggtgtggtg	BB@FFFEFEEECEEGGGEFDAF5CFEFFAEFAEGDF8	T	19	G	18
4	17711076	T	57	TTtctCCCTtcCCCCcttctTttcctctTCcTtctccTtTCttcCcCccTCTTtCct	B9CBBFDGEEFGGFGFEEFEBEEFEDGFEEGE:GEDGD:DFF<FFGFGGDFD<EGE?	C	29	T	28
4	25408838	G	26	AAGAGagGAaGagGgAGAaAGAAAAA	C@AHADG;GEBEGBF?B?EGBFDC>B	A	16	G	10
4	25678396	G	54	tTTgTGtggttgGtTggTtttGttgGggGtgtggGggtgttgtttgtgtgtggg	B@?CEFF@CGGCGGDCCEGFGHGGCHCCHGCGBCHDD=AH:DHH:@HDHDADDC	G	28	T	26
4	25769135	T	104	TCTTCTCTCTCCCctTcCTCCTCCcTcCCTTcTCTTCCCCTCTtCTcCTTCCTTCccTTTCcCCCCTCCTtcTTCCTCCCCtTctcttCTTCTCCTCCTcctcc	AFEEGEGD?DGGGFEEEFDGEEGGGEFGGEDGEGAEGGGGDFDFG;GFD@FFDDFFGDDDFGFFFFDFFDFEDDCFD=F5FEDGFGDEDCCCDCDA<B><?>?@	C	60	T	44
4	25948424	C	53	TCtcCtCcTTtCCTCTCCTCTCTCTtTTttCTCccCctctCtCttCctctctc	CGDG6D7HFEEFFEGF=FEFFCECEDDEDEFCFHHFHEGEFDD>CCEBD@C?C	C	27	T	26
4	36160340	G	26	TtGTTTGGGGGGGGTTtTTTGGGTTG	GCGGGGGEFFFFFFFFEFEEEFEBBC	G	13	T	13
4	37590570	G	155	GGGaGAAGgGGGAaAaAGGaaAAGGggggaGgGAgAGgggAGGgGaAAGGGGGGgAggaaAAGGGGAGaggAGGgAAAGaggGggaaAAgAAgAGGGaaGAGggaAAGgggAAAaAAaggggAggAgagGagGAAggaAGaGGgAggAAaaggAG	8=>CBH:BFCCCHEHFHCCFFHHCCFFFFFCFCHFGCCFFHCCGBGGHCC=AC6FDGGGGGHCBCCHCGGGH9CFHHHBFFGCGGGGFHGFGGGBBBGFBEBGGGGG@GGGGGGGGGGGGGGGGGG@GFBGEBGGFGGGBGBAGF;?GGA@?A@<	G	89	A	66
4	38023302	C	40	CgGCgGgGCgGCCCGCGgCgggGccGGCGCCCGCCGcgcc	=B;CFBFCEECDCDCD>FCGGFBEDBBCBCCBBCCAEGC>	G	21	C	19
4	38062233	T	72	TAttTAaatATAtAAtAaTtATaTTAtaAtaataAAtaTaatATtAtTtaTaTtTatatAtaTTAaTtaaAa	?FEDFHFFDHGGEHHEFFGEHGFGGHEEHFEFFGHHFGDGGEHGEHFEFGGFFFGGFB9GFGFFGGFFGEB?	A	37	T	35
4	38776491	T	47	gggtggGtGtgtGggtgGggTGGgtgTtTgggtTggTtgggTTgttg	C@A>BBHEHEFEFFFEFGFFEHHGFFEF8DGGFEGGCFGGGCC@@>D	G	29	T	18
4	38829832	T	222	CCCcTTcttCCccCTcTTTTcCCTcCcTCcCtCCCCCCCCCtTCccCTTTCCcCTTtTTcTttCctCCTTTCcCccTTCTTCcCCTTCcccTTttTccTCcTTtctcCTCTCTCtcTTttCCTcCttTtTCccttCTccCtCcccCctTCtTccTCcCcCccCctctttTTctccttCcttctCtcccCtcTcccTcctcttTCctttcctcCTtTTttcTt	AA<ABCEEF;DFECHFGG<GFCCGFDFGDFDEDDDDDDECEEGDFFDGGGD9FDGGEGFFGFEDGFD6GGGDGDGGGFCGGDGDDFGDGGG<GFFGGGGDGGGFGFCDGDGDGDFGGGFFDDGGAFFFFFCGFFFDGGGCECGGGCCEFCFFGGFCGCG@FHCGFFFFAFFGFGGFFCGEFGFCFGGGCFGFGFGEGBFGEFECEDEEFFEEBFACDA>?CB	C	122	T	100
4	38924358	A	90	AGggaAgGGGGAGAAgggGgaaAggaagaAaAAGaAgAagGAAaaAGaGAaAaaAaagGAagAAgagAagAgGGgagaAAGagAGAGgag	A?FEFFFE9EDEE;FFFFEEEEFFFFFCFEFFFEGFGFGGDFFFGFEGEFDFGDEEGG?EGGFEGFGEGCEEADGGGEEEDFGEDEDGD?	A	50	G	40
4	39478832	G	25	agaggaGagggggagagAgggggag	?ADEED@?EFEDFEEEFDFGFEF?:	G	17	A	8
4	39510329	C	45	cCcCTTctcttcttcttctccccccTttCttcccctcctctctct	C;EFAFGEEEDEDEFEEFEFFFEFFGEEGFDGGGGEGGFGEFFGF	C	25	T	20
4	40119501	T	29	TCTtcCTCCTTCTTCTCCCCcTTCtTTCC	@AGGC7DG@GG:GFGEFFFCCFFFHFFEB	C	15	T	14
4	40810978	G	87	ggGgAGgagGGgGGAggGggGGaagggaagAAgggGaaGgggAAAAggaAggggaaaagagGGGgGgggagGagAgagaaaggaggg	@AACE=CEBCEBEEECCECCEE8@CCCEFCFBCCCD?FECCBFFFC?CFFCDCDGGFGCG=ECEDEDCCDDDCDEEGD<HFB@CAAA	G	57	A	30
4	42576522	C	51	CTTTCTTCTTCTCCCTCTTtCCttcCtCTTcTCCCCTcCCTTtTcCTtCcc	BGFGGHGBGAGFGEGGGEDEFFFFGFFCFFGFFFFCEGFCFCFFGEBAAB=	C	26	T	25
4	44682465	T	49	CCCTTCCCTCCCTTCCTCCcTTCCCtcTcccTtTCctTtTTcTTCcCcc	>DDGEDDDGD8DGGC>GDDGFFDCCFGFFGGFFFCGFEEFFDD?=BCCD	C	29	T	20
4	46314593	T	49	TcCTTTCTtCctcCcTtTcTcTtCTCTtTCCTCTCcCttcCCtttcTct	@=AECEGEEGFEFGFEEEFBGDEGEGEFEGGDFCFCFFFGFFFFEEB@C	T	26	C	23
4	47880494	G	27	GGGAAGGGAAGGGGGAGAGAGGAAGAG	BCCHHCCCHGBBBBBGBGBGAAFD>DA	G	17	A	10
4	48069725	G	84	GAGGaAgaGggGGaAAGgggAAggaGaaggaGggggagagaggaaggaagggggaAggagaggagagaaggaagaagaaagagg	E9?AD?BDBCCFGFDEH9CCCECCFHFFCCFHCCCBECFCFCCFFDCFFCCDDCGAD8GDGDDGDGDGGDDGGDGHDGGGDB>C	G	48	A	36
4	48588742	C	87	ttctCTcttcccCcTcCCtccCTCccccTcTcccTCccCtctTctcctcTtcTccccctttctcttcctttcCtcctcCtctttctc	CCA?<A@DDEDEDDGADCEDDD7D;DDDGDGDDDGDDDDBDEGCEDDEDGEECDDEEEFFFEEEDFEEFFFEDBEEFECE9AF9D@E	C	51	T	36
4	48610961	T	45	CTTTCTcTCCTTTTCCCCTcCtTcTTTCtctCTtcCcCTcTCTcc	CGEGDGGGD:GGGFD>DDGHDEGGE7ECEHECFEHCHCFHEBECB	C	23	T	22
4	52927113	C	53	AacaaccccaccCaccAaaAAaAAccccaCcCaaCcCaaaCaAaCcAaaacac	?D?EFCAABFBBGFBBEFFFGFFFBBCCGGCFGGDBGGGGFGEHFCEFGGBEB	A	28	C	25
4	54011424	C	39	TTTTCCCTTTCTCCCTCTTTCCTTTTTCCCCCCCTCTTC	GGGGDDDFFFCFCCCFCFFFCCFFFFFCBCCBCDA?CD@	T	20	C	19
4	54310188	A	37	GAAGGAGAAAGGAGAGaGGGGgGaaaGaGgaGgGAgA	5DHCBHCEHHACHBHBGBBBBGBGGGBG<GEAFBE@;	G	21	A	16
4	54327584	A	45	GGAAGAGAGAAGGGAGGAaGAGAAAGaGGGAAGAAgAAAGGAGaA	ADFFCBEFEEFEEEFDD=GDEDEEEDGDDDEEDDEGEDBCC=BBA	A	24	G	21
4	54441842	C	34	CGGGGGCGgGccGGCCCGGCgGGGCGGCgCGCcC	DCCCCCDCDCHHCCDDDBBCEBBB=BBBGC@@BA	G	20	C	14
4	55599436	T	43	ctTcctcCCtccctctctcctttttcttttcccctctTcctct	CBFDEEFGGEFFFEFEFEFFEEEBEFEFEFGGGGFGFG@EFGF	C	22	T	21
4	55980239	C	99	CCCTTTCCTTTTCCCTTTCcCCTCTTTctCttTTTCtTCCCCcTCCTCCCtTTTTCCcccTTCcttTtCtTCccCCcTTCTcTTCcTCTtCtTTTcCtt	CGGGEEGGFHGGGGEGFGGEGCGDGGGGEGFDGEGGFDEFGEGFFGGFGFFFEFFFFGGGFFFHGFFFFFAFGGFFGFF=FGFF>GFFFDAEDAC<?BC	T	51	C	48
4	57176965	T	43	tccttcttttTttctcttctcTTtTCTTCTTTTtttctcttcc	@BC?CEDDD<GDEFEFEEFEF>CEGEF>DG?FGEEEG=ECCB=	T	30	C	13
4	57181629	C	85	cccTTTcCtTccTTTcCTTTCcTtctCCCttTCtCTTCCCTCCTtCTTTTTTCtTCTCCCTttTCTTtTcCtTccCttTCcTctc	CCDFGGDDEGDDEFGEDGEGDEGEEFDDDFFGDFDGGDCCECCDFDFFGEFFCCFCFCCBFCEFCFFCFECEFEEBFFGCCDBB?	T	47	C	38
4	57182647	G	103	GagAGgaGGAgagAAaaagAaAGGGaGAaGGgGGGGgGagaAGGagGagGGaagaagaagAgAagaaAgaAGaaGGgagaaggggAagGgAgggGGAAGAagg	;AA@=AC??EDFCFHFFFCHFHCCCFCHF>CCD;CCCCFCFGCCG?CGDCCGGDGFDGFDFDHGDGGFDGHBGGBBDGDGGDDD@AHEBDEDDDABGG@DA?>	G	56	A	47
4	57325476	A	34	GGAGAAAGAGGAGGAAGGAGGAAAAGGGaAAgaG	ACEGEEBHEHGEHFDDGFAGGDDDDFGF?7@B9A	A	17	G	17
4	57397157	G	82	gccgcggGgggccCGcccgcccgGcggCcCGgCggggcccggccGcccggCgggcGgGGggggGGcCcgGGgCgggcggGCg	?BCDDCDDEEDC;GEDDDDDDDEECEEGB?>FGFECE@DD>EDDEDEEFFGGFEEDFEEFFEGEDEGEEDDGFBECDGED9B	G	49	C	33
4	57397196	C	59	cccggCgggcGgGGggggGGcCcgGGgCgggccggGCggggggcccgCGGCGCCcCcGg	CC?CA=GDE@CECCEEEFACDDDECCGDAF=DEGACDGEGGFGECDGCBBCBCCECDBB	G	37	C	22
4	68447040	C	55	TTCTCTTCTTCCCTTCTCccCCTCTTcCCCtCCTttTcTcCTCTCCtTcTcCTCc	B>DEGGEGFFGFGGGEDGCCGGGGGDCFGFHFFFEHFCEBFFFFFFGF@ECFEF5	C	30	T	25
4	71110639	G	30	AAAaGgAAagggggggggggaaaaaaggga	@=@FGFEEFFFFFGFFFGGGEDGGFGFFBB	G	16	A	14
4	71232388	G	76	gGAGAGGGGGGAGGGGgAGGGAAGGAAGGAGAGgGGAGGAAGAAGAAaGAgAgGAGAGGAAaGGGGgAGGGGgGGa	AEF8DEE9EEBF?EDDDFEEEFFDDEF>EFDEDDDDEDDEEDFEDEEGDEEECDEDEDD?EG6CDD:CBC@A>ACD	G	49	A	27
4	71346701	C	225	CCGgcGGccCggCccCCGCcGgCCcCCCGGggcgcCgccgCggGGcggCgcGccCCCgcCGCGGCcgGgCCGCcGGGCggcgCGcgGggcgcGGCCggCggGCGgcggGCCCccCcgGGCcCggGCCGcGGcgccGGcCGGCcCCgcGCCccCcCCgCCgccCccCgCccgCCCcCCGgccCCccggggGCcCCcCCgGGGgGGccCCCCGcgGggCGggcggCc	DDBBBACED?FEGDDFFG8CGEGFDGEGGGF8D<DGEDDEGEE>EDFFEFDGDDGGGE?GGAGEGDFFFGGGGEGGGGFG?GDGEGGFGEEEFGFGFGGFFGGEGEFEGGDDEEGEEGGGEGGCGFFFEFFDFDEEFEFFFFCFFGEFFFEEFEFFFFDFEEFFFFFFEEGFFFEFFFGEEFFEEG:FFFFDFFEFFFFFFFFFEEFEEFECFC@@ACB??@>?A	C	125	G	100
4	71389669	T	63	cTCctccttTttTcctctcctTctttttttcttcttCtcCtTccttccttctctccttcccct	C><@@EGDDCCCCGGDGDGFDEGDDDDDDEGDDFDDGEHFE@HHEBHHEEH=HEHGEEHHHH?	T	35	C	28
4	71459248	A	72	GggAaAggagaGgAAagaggAggaGGgagaggggaagaagaaagggaggaaaggagagagggaaggagaagg	DC@<BEF@DFDGDFFDFDFFFFFDEFFCFDFFCFDDGDCFECEGGFDEGEEEFGEGDGCGGGEEGGEGEEHF	G	40	A	32
4	71465241	C	36	CCTCTTCTCTTCcCTTCCCcCCTTTTTTCCCTcTTT	FEEFECCEDBDFFFD<FDFEFFDDDDDDFEFCAB>@	C	18	T	18
4	71467443	A	41	ggAGAaAagAaaGaaAAaggaagagAaaAaaaggagaaAgA	ACGCHDHEFHEEB=FHHEFFEFFFFHDFHFEFFFEGDFGBA	A	28	G	13
4	71467710	A	37	aGaAGaaggaaggAaGagaAgAggagAAggaaagaag	DF=FGDDFFDDFDCD8EF?FGEGGEGBEGGEEEGECF	A	21	G	16
4	73931170	T	36	ttccttcctcctttcccttccttccttctctccctc	CFBAGGBBGBBGGF?BBGGBCEHBCHHC@BFC?CHC	C	19	T	17
4	74447510	A	90	CcCaaACCaCCAcCaaaCaacAcCCcaaCccacaCAccCCACAaaAAcAaAcacACaACCAAaACAAcaccaaacCaacaAcCcCaaccc	;EGDCF9GDGGFGCDDDGCDGEGGGADDGGGDGDGFFFGGFDBEEFFHFEFHEHEGEDGFEDEEFC>IEHHEDEGFBEHEEHEHEAAB<A	A	45	C	45
4	74718941	C	50	ACCACACCAACACcCaAaAaaCAaacACCcAACaAACACCAAAAAacCCA	HDDHCHDDHHDHDECFHFGEFCGFEDGCCEGCAFGGCFCBFFEGH>@AC?	A	29	C	21
4	74735524	G	104	GcCcGGGgGccccGCgGCCccgGcgCCGGCGgCcCGCgGCGGGggggccCGCCgCGcgGcGCcCGGgCGcGgGGgGgGggGgCgCGgcGggccCGgGCGcCggc	@?<>;>?CACDCDCDF5DDDD9CDFDDCBDCEDDDCCG=D>CBFGEGEEDCDC7DBAGCDBCDC5BF@BECGBBFBBBFFBFCFCBFEBEEEEBBB?B>?8>@B	G	60	C	44
4	74736144	A	121	AgAgAGAAAgaAGAagAGAAGAGaGGAGGaAAAAaGgAaAaaGAggggaaaGaGgaaaagGGaAaGAgGgAGGagaGAaaaAgAAAAgaaggaggAAAAaaaagAAAGgagAggGgAGGGa	=@?B@>@;DFCEFFDFDFFFGEGDEGFGHDFFFFDG=FDEDECFGGGGEEEAEGGBEEEGGGDFEGDGGEEGGEFEFEEEAEGDEEEEEEFGEGGDEEEDEEEGEEEFGEGEGGFECCBC:	A	70	G	51
4	75023709	C	207	TtTtctCTcTtccCTTCTCCctTttTCTctctcCCTCCCTTCTCCTCTTCcCcCTTccCCttccTCTcTtcCCttttCCccCCCTCcttCTcTTCCcTTCCCCtCCCctCttcTTTctTtcTcTCTtccCttCCttCctccTCtctcCccTCccTcTCCtCctcccCCtctctcTcTctttcTtcccctCCttTCCtCccCTtttcc	D??CBC;>DGDCDDGGGFGGDEGEEGG?DEDEDGEGFGGGGHEGHHGGGGDCDGGGDDGGEBE;GGFEFEDFGEFFEGGEDDGF=GEFEGGEGFGGEGGGGGGFGGGEFGEE?GGFDEGEEGDGGGFBEFEFCG9EFEFEEFGFEAEFEAFFEEFEFFD:FBEEEEFFFEBEEDFCFE6EFDFFAEEEFFFFFFEFEFCDFCC@@;B	C	115	T	92
4	75040944	T	198	TTTTTgGTTtGtgTgtTTTGGGggGTTtTTGTTTTGGGGGtgtgGTggGGGTggTTgTtGGtTGTTGtTggtttTtgTTggTgtGGTGGgttgGGGtGGGTGgTGTGTGTGGTGttTGGggTGTgttgTGgGTGggGTGtTGgTtGgTtGTGGTGGGgGttGGtTTTTtgtgTTgTTtGttGGGgtgTGGggtTTGtt	DFGGGCGGGGGGCGCGGGGGGGCAGEGGGGGGGGGGGGGGCCGCGGDBGAGGDDGGDGHGFHFFGGDHGDDHHHFHDGFDDGBHDGGGGDEHDBGGHFGGEGDEFEGGFEEFFFHGGDFDDFFFDHHDFFDAFFD@FDFH<FEFHEDFHFFFFFBFFDFHHFFHFFFEGDHDFFDEEGEHCEEFCHCDC7?<@C?CEE	G	101	T	97
4	75938179	G	173	GAAgaaagaagggAGaaaAAGaGgAaaGaaGgGaaaGGgggAaGggaGGgAgAAagaaaGgGAGAGGaaaaGAggaaGgagagaagAgAaagGgaaggagggaAaagGAaGggGaaaaGaaggaagAAgggaaagagggagGgggaggaGGaaaggGGggggggGAgagaGaA	<C@>>@B>CDDGFGCDDCHFCDCD>DDCDDCF?DDDCCFFFGDCFFCCCFHFFHDF<DDCFCHCHCCD9DDCGFFCD>GEEEGEAEHGHEE7CGEEGG;GGGEAEEGCHEB@GCEA<>CEEEEEEGGGBGGBEEGEGEGAGBGFFEGGEBBBCEGGBBFGGGFABFACEB@?B	G	90	A	83
4	75938236	A	114	gAggaaggaGGaaagggagaaagaAaaagaagAAgggaaAAaaaaaaAGagagAgGaAaaAAaGgaggagGgAaaAAAagGAAgAgGggaGaagaAAAgGAGAaAgGAgAagGa	?@@AACBCCFDEEDFFEDFEEEDEEEEEFEEFFFEFEEEEDDEFEEEB@DFEFDFGFDFFEEFHGFDEEGGGBF7DDEEEHED?DGGEFFGFFDE7DDG;DGDDCBE><@?@?@	A	68	G	46
4	76571732	C	25	tcttcccctccccctcccttTtcct	@=BC=@B@EBB@BBGCC8HHFHCAG	C	15	T	10
4	76721459	G	77	AAGGAAGAGAGAGAAGGAGAGAAGAGAGGGAGAGGAGAGAGGaAGggaGaGAGGAAAaAaGGAGGGAaGGAGGAgGg	BCGHECGEHEHEHDEHHEHEGDCHDHDGGFDFDGGDGDGDFGGDGEGGGGGDGGDDDGBGFGDHFFACDDADD?BC?	G	41	A	36
4	76722422	T	31	TcCTtCtcTTCTttTttctccttcccttttt	=:?CDGEFEEGEDEEFEGFGGFFGGGFFFF?	T	20	C	11
4	76881392	C	32	TCCTcTctttTtTttcctcttTtctCCttCct	DEFGDHDE5=GEGEEDEEEFFFFDFGGFFFEF	T	20	C	12
4	76944491	T	71	TCCTTTTTCCTTCTCTCCTTTCCCTCTTTCTCCCTCTTTTtTCCCCCtTCCCCCTTcCTCtTTctctTCTC	CEEEEEEDEAE<GEEEGGEEEFGFAFDDDFAFFFDFDDD=FDFFFFFFDFFFDFDCEEDFFDCEEFB=AAC	T	37	C	34
4	77676220	A	90	aaaaaaaaaaaCaaAAaaaaaaaaaaACaaAaaCaaaAaaaaaaaCaaAaCaCaaaaaaaCaaaaaCaaaaaaaaaaaaaaaaaaaAAaa	ADE5DADD@DEDEEA=EEBDBDEEDD;9?E?D>DDED>;AD8B?E;8FAC??DCEFE>;57FE;FBCFDDFC<GFEF?>FBCDCCEBDA@	A	82	C	8
4	77818132	G	54	ccGccGgCccCcgCcgGcGGGccCggCGcCccccGgGCccGcCGGCCGcgGcGg	CA?ABECGBBFBCDC@EBEEEBBFDDFECGCCBCADEDCCD?GDDFFDCDE?B<	C	31	G	23
4	78870940	T	56	AATTTAAtAATTtttATttATAATTTTTAAtATTAaTttATAAAATtATtTAaAaA	AFGGFEEFEFGGEEFFFEFFGEEFEFFFEEGEFEEEFFFEFEEEEFFDFFEEB?<?	T	30	A	26
4	79173616	C	117	CGGGcCGGCGCCGgCCGCCcCCGGGcGgCgGcCCGgCgCGgCcGcCccgCGGccGgccggGgCcGCCcGCCccgCgcGggcggGgggCCcgCCcCgcCcgGCgcCggGCGgggGCgc	?BCCADBCDCDDCFDCADCDDDCCC@CDCGBDBDCE8A<CGCCCEDAEEC@BEDCGEE@FCGCECDDEACCEEGD6EBGGEF;BDGFCCFECCECGDCEGBCGECGGACCE>>>?@B	C	59	G	58
4	79187900	T	58	TGGGTGGGTGTTTTGGGGGGGTGTTtGTTTgtGGGTTGGTtGGTGTTTTGGGTgTTgG	AGFBFGD7GGFGFGFGGGGFFFFGEHEF@FDHFFFE5FFFCFFFFFFFFFFEFCDC<?	G	31	T	27
4	79343111	G	168	agaAggaaaGagggGGAgAGaaaAgGagaaaAAGAagGGGAAAgAAAgggAaAgAGgggAAggaGGagagaGgggGAGaggaaGGgAggGaaAaggAGaAgagagAGAAAGGgAGaAAAgagGAGAggaaAAaggaaagggaggagggaagaaagaagaaaggaagGg	AC?C=ADCEBGCBCCCHCHCFFFHCAFCFFFHHCGFC@C>HHHCBDGC;CHFDCABCCCHHCC@CCFDGBFCDCCCFBFBDGFCCDGDD>@GHGDDHCGDDGDGDHCHEHC8DHCCHHHCGDCFCGDDGGHGGDDGGGDBDFDDGDEEHGD?FGDGGDGEFD@GGB<B	A	85	G	83
4	79387586	A	58	gGAAAgaaAAgaaGaAaGggAgaaagagagagAaagAAagaaggaaggaaGgaaggaa	??=>:ADEEECEFGFEFGCCFCFFFCFCFCFCFFFCEAFCGGDDFGDDGAFDGGDDGA	A	35	G	23
4	84234229	G	47	GGGAAGAGGAGAAAGGAAAGGAGAGGAGGAAGAAGAGGGAGGGGGAG	8EEEEDEDCEE=EEDDEEEDDECEDDED;CEDEEDEDCDDDDDEBBB	G	27	A	20
4	84240654	G	36	gaaggggaaaaaaggagGGgagGaaGgAgAgaggga	>BDFFEFFEFDEFFFFFHI=CFHDFGDEGDCFGGFG	G	20	A	16
4	84338076	T	28	ttccttcttctTtctttccCcttttcct	C@EFDDFDDGCADGDEDHHGHE:CEHFD	T	17	C	11
4	87769929	T	56	tcctttctTcCtCCCcTttcCcCtTTTCcCTctctCTTTCCcCTCTCTCCTCCccT	C@AGFGBGFBEGGGGBEDBBGBGGFGGGCGECHCH9DFFFD=FFC;FFFDFFF>=A	C	31	T	25
4	88577754	A	78	AGAgGGaAAgAgGaaagaAAagaaAggaGAAaaAaaagaaggaaagaaggGgaGgaggggaggaggaaaaagaaaaaa	CDCA?@BACG;FGEFFFFFFFFFFFFFFGFFFEEFFFF=GGF<GGGGGGGGGGGGFFFGGGGGGGGGGGGFGAGFEBB	A	47	G	31
4	88761269	C	57	cacCcaaACaaaAAaccacaaaCaacacCacCCCaacaaaaccaacacaacacccac	A?BBDBDCCBFFD@FFFFFFFFHFFFFGGGGGFFGGGEGGGDGGGFGGBGFFFGCA=	A	31	C	26
4	88898941	C	97	CcttCcCcCctCTCCtcttCcTttTCccttCtcTTTcccctcCcctTtcccCTCtcCtctCcTtCtcTCcttcctctccttTcctTTTtttTtTTtC	CCCBBBDDGDEGCFGCDEEGDFEEFFDDDEGECCFEDDAEEDFCEFFFEEEFFGFEGFEFGEFEGFCEEEFAEEE@EEEFEEEDFEEEFFFEEEEEB	C	49	T	48
4	91645026	A	50	AGGGAAAGAAGGAAAaAGAAAGAgAGAGAGGAGGaaGAgGGGGaGAGGGA	CF@GEEE<FFGEEFEEEFEEEFEGEFE>EFFEFFEEEEGEEFDBCBCA??	A	25	G	25
4	95575601	C	74	TTTTTTTCCTTTTCCCTTttcCTCTtTtCtTCTTTTCtTTtcTCCCTCCCTTcTTtcTTccCTtTTtCttCTtc	>?@DDEEGGEFAEGGGEEECGFDGDFEFGFEGEDDDEFEDFADFFEDFFFDDGDDFGDDFGFDFDDEFFE>CCA	T	48	C	26
4	96069846	G	39	AGGAAAAGAGAAAGAGAGGGAGGAAAAGAGGAGAAGGGg	HCCDHHHCCBHHE@HAGCBBEBBGCGGBGABGBGD:CC?	A	20	G	19
4	100003333	A	114	AgagaAgagaaaggaaggGGAaaGGgAggagAaaagagggaggaagGGaaggGGaggAGagagaggaaggggGaaaagagaaAgagggGagaagggAggggaggggaaaaaaga	A?CC?@?C?DDDAACD@@EAFEFGGCFCCFCFFFFCFCCCFCCFFBGGFFCCGGFCCFGFCFCFCCFFCCCCGGFFFAGDGEFDGDDDGGDGG>DDFDDDDGDDDDEGGGFGDG	G	61	A	53
4	100212173	A	74	tttaaaAAaTTaaATAaAaaATAaAaAaaaATaAAtAaAAAaatTataataaaAaAattttaAatAAataatta	C?CBFCEEEECFFEEEFEFFEDEFEFEGFFDEEEE@EGEEEDFFEEEGFDGFGEGDGDF?EGDFFDDEEGGFEC	A	53	T	21
4	100784118	T	30	TGTTGGTGGGTTTTTGTTTgGGTGGTtttG	EFEEHHCHHHDDDDDFDDDGGGCH?BA?>C	T	17	G	13
4	102839287	G	104	gAAgaAggaAAaaagAgagaaagAAAgaGGGgaGGgaGgaAagGaGAaaAGgaAagaaaggagaaaAaAggGAaGGgagagaaaaaaaagaaggaaggGaaaaa	CCA@CDDDFFHEDDDHFEFEEEFHGHFECCCFE>CEED=BHEFBEAGEEHCFEHEFFFAFGFEFFFHEHFGCHECBFFEFGFFFFFFFFGFFGEFE?ABFFAD;	A	63	G	41
4	103557251	G	55	ggaagaAGaaagGagaAaggaAgagaggaagagAgagaaaggggaaaggggagaa	AAD?AEHCEEFCCFCEHFCCFHCFCFCCFFCFCHDGDGGG@DDDGGGEDDDGCGG	A	29	G	26
4	103964529	A	198	AACAAACACcAcCCAacaCACCAAaCACCCAaCAaACAACaACACCaaCAcACCCCAAAaaCAcAAAaAACCaCCAAcAaAAcacAacACaccaaaaaACAaaAaCcacaCaCACCAacAAcaaccAACAcaAaaaacCAAccCacacccacaaacCCaaaaCaCAaACacCAAccCAcAccaccaaCaccaacacaa	>>9>A@DB?F@H?FEDFDGEGGFFDFFGGGFDGFDBGFFHDGGFGGDDCFHFGGGGECFDCGE?FFFDFFGGDGGE@GBECFGEHFEHFEEH@EEEEEFGFEEFEGGEGEDEFEFFEEHEEGEDHHEDFEH?EEC8EHFEEIIFEH>HFHE;DEEHFFEEEDFECEEEFEHFECGGFEHDGFEGFD:CAEA??@=CBA	A	113	C	85
4	104000973	G	45	CCgCGCGgGgcggggGggggcccGCggCcgcgGGGgccgGgcgcg	BDBEHG>EHFGF<DCHFFFFFGGHGGFGGGHFHHBGHHDGGHEAD	G	29	C	16
4	104003993	A	79	CAACCCCCCCCCAAAACAACAAaCCACCCCAaCAACACACACCCCCCACacAAAaCACAAaCAcCACCcCACcAACAAA	CGHCDDDCCDDDHDHHDHFCHHACCHCDDCGECGG?G@GBGCCCCCCGCEHGGGECGCGGECGHBGABGDGBA@CCA??	C	42	A	37
4	108574590	C	56	TTCTCCTTtCcCCCTTcTTTCTTTtCCCtccctTTCCCCCTtTctcCcTTCtctcC	<AFCFGFEGGCEFEEECEEDFEDDH7=FHBBCHDDFFFFFDHCCHCFCDCFF>A<A	C	29	T	27
4	108868515	T	61	CCCTCTCTTCtTTCTTTTTcCcCCTCCcTTCCtTTCCCcCCTTTcTTTccCCTTtCtcCCc	EGGBGEFE:GFEEGEDEEEFGG=GDFGGDDFFFADEFFGFFCDDBCC;GFDBCAA>>?CC?	C	33	T	28
4	109478108	C	85	CgggCCcGGgGGcGGgCgcGgcgccgGCCccCgGGcccGCCcggcGCGgGGcggccGGccgcGggcgcgcgggcGccCGcggggc	DCCBCGGHFEHHCHHFGFGEDGFGGFHGGFGGFHHGHHHGGFGGGGFEGHHHGEHHHHHHGHHGGHGHGHGGGHFIIDGHGGGF=	G	47	C	38
4	110772711	C	31	CCtcTTTCTcttCCCTCTTcTCCCCtcCcTc	ACGBGGGDGBEHDDDGBEGCFCCCCHCCCF?	C	18	T	13
4	118976252	G	40	cgccCGgcGgcgGGccgggccgcCgcgccgggcgcggcgc	DBCDFFFFGFGFGGGGFFFGGFDFFCFHHGGBHGFGGHGH	G	21	C	19
4	119161795	G	46	gaggggagAaaaGaAAaGaAAggAgaGAaAaGaAAgAGagAGaaGg	BFBCCCFCHF6F@FIHFCFDHCCHDGCHGEGBGHGDG@FDBBFGA@	A	27	G	19
4	119203479	T	34	cttctcctcttctttttctttcccctcttccctt	CCCCHBAFBGGBGGGGGBGGGBBBCACHHCCCFA	T	19	C	15
4	119726949	G	28	AGGGAAAGAGGGGGGAgGAaAAAagGgg	H;CCHGHCHC@CCBBGDBGGGG>F@?AA	G	16	A	12
4	120241902	T	31	CTTTCtCCTTCCctCTCtTCtCTtTtctctC	@@FEGGEEFFFECHFFDDEEHFEHEDCHBHB	T	17	C	14
4	121957559	G	180	aAAgaAaagGaGaGAAggGgGgGAaaAGgaaaaagGGaAgaaGAAGggggagAgagGGGAagaagaaggAaAgagaAAGgaaAaaGaaAaAGAGgagaAGAGgAGaAAgagaggGAGGGggaaagGAGGGgaAAGAgaGAggGAgaGaGAAAgaGgggGggGAGAgGaaaaGGaAaaagg	A>>AD>BBAAECFEEDDDGBGBGEFFFECFFFFFCGGFFCFFGFFFCCCCFCFCFC8GFFCCFFCFFCCEFFCFCFFFFCFFFEFGGGFGE@FGDFDGFGEGDFFGEFDGDGDDGFGGGDDGGGDGFFGGDG<FFDBBEEDDFDDGFG9E=EDGFDDDFDDFEFDDFGGGGFGEDCC=><	A	92	G	88
4	121958091	T	227	TTTTtGGTtGtttTGTGgggGTGTTgGGGTTGGTTGTgggTGtggGGgTttGTtgGTGttggtgGTTggGTgGGGTTGTTgTTTTGgGTTtTTGTTgTGtTTgTGTggTggGttgTTGgtGGTTtGTgtTTttGgGGGTGTGGgtGGTTTGgttTgtGTGTggtgTTtTGGtgTTtGTTgTTttggTTGGTTTGttTTTgGtTtTgGTGGttgtGGGGTTGttgtGt	BB@=>;DADGEEEEHEGEFFHEHECFHHHEEIH@FIFFFFEGDFFHHFEDDHEDFHCGDBFFDAHDEA>AEGHHGEEHEEGDEEEBGGEDEEEGEEGEHDEEDEHEEG@EGHEEGDDGG<GHDCEHDGEDDE6GEGGGDGDGGBDGGDCDGGEEDGEGDCDGGEEDDEDGGDADDDGDDG<DEEGGDDGGDDDGEEDDCGGCDECGGCGGDCE?EEEECCD:@?@CB	T	121	G	106
4	122737965	G	30	gGcCcGCCCgcGcggGcGCgggcCgcgcgc	<FEFFGGGFFFG8GGGGGGGGGGFGG88;B	C	15	G	15
4	122756274	G	82	GGGGGGGGTTGGGTGTTTTGGGTTGtTGGGTTGTTGTGTTGGgGTGtTGTggGTGTTTGtGGtGTTTgggGGTtGGGGTgGG	DEGGGGFGGDGGEFGGFGFFGGGG>EFEFFFEFFFFEFEFFFGFFFEEFEGGFEFFFFFBFFDEEEEGGFEDCADDCBB?AC	G	48	T	34
4	123187869	C	26	TTTCCTTTCCCTTCCTCTTTCTTTCT	CCEGGECDFFFDDFFCEDCDEDDDC>	T	16	C	10
4	126412891	C	153	cCTtCCccTtttcctcTTCTCTCCTCTCCCCCCcCTTCcCCTcCCctTcTttcTTcTTcCCccCCCcCtcccctCCtcCcTtcTtttttCctccCTTtctcttTtCccttcctccCttctTcttttttccctcctctcccTttCccccTcTtc	?==?>=ABDFDDECDBGFDGDGCDGDGDD8DDDDDGGDDDDGD@D=EGDHEEDFGDCGDDDDDDD@DDEDEEEEDCFEDEGFDDFFFEFDEEEEDGGFEFEFFGFDCDFFEEFEECEFEFFDFFFFF5EEEFFDFEEEDAFFFCEDEEEEE@9	C	86	T	67
4	128554404	G	44	AggGaagggaaagggAgGaaagagGaGAAgGaaaagaagaggag	>BCBCDEFADDDFFFFFEDD>FDFEEEEEDE9EEC=EEE=8FEF	A	22	G	22
4	129924977	C	152	AAACCAACCCCCACaAcCCCAAAACACACCCcCAAACcAAcCAaAcCCaCcCAAaAaaACCccAacACAACAAaCAcaaaaaCCaCccccCAAccCCAAaAAAAcaAaAaCacaaccaAacaAaaCCAAcAACaCccacCaAcaCaaacAaa	C@@:=A@??@@B;CDGGEDDFHHHBHDHDDCGDHHHDGHHGDCDHGDDD9F@HHDHDEGDDHHGEHH>HFDHGEDHGDD@EBDDBCGCHHDAHHHCDHHEGGGGHEGCGEC<;DFGHEGECDGECCCGFHGGCE5HHEHCDFC=B?==@ABA	A	84	C	68
4	139140494	G	113	cccGgGgcCCgGgGCcggcggggcccggGggcGgcggcgggccccgGccgGGGcgCGGGGGcggccCcgCGgcGCcggGgggGgGggcggGGgggCcgggcgggccccgggcg	CCC@@?A=ADBECFAACCABCCCBBBCC:CCBGCBCCBCCCBBBBCG=BCGGGBCEGGGFGBBCBCDCDGGDCGGCDDGADCGDGDABDDGFDDDF6DDDCDCBCCCC>D<;A	G	72	C	41
4	141290522	T	34	CtcccCCTTCtcTtcttCTCtTcTcccTTTtcct	?FB@BGGDBGGBGGBHHGGGHECGCCCFFFG<7C	C	17	T	17
4	141313500	G	70	AAGaagGAaaGgggGgAGaAaaaGaagAgggaaAaagaaaaagaaagagggagagaagaggggaaaggaa	C@>ACA>EEDBBBCCCHCFFFFFBFFCHCCCFGAFFCFFFEDDGGGDGCDDGCEDGDDGDCDDEDFBEG<	A	40	G	30
4	141383121	A	52	aaATTttaTTTTttTatATttTttataaataTttaAtttaatAAtatttAat	BFFGGEEEGF>GFEDEDFGBEGFFFEEFFAFFFFFEFFFFFDEE<FFEFB?C	T	32	A	20
4	144466050	A	47	aggaAaagggagagaagaagagaaggGggaggggggaaaggaggaag	CB@CBDGFFFFFFFFFFFFFFCFEGFGGFGGGGAGGGGGGD=GDBG<	G	26	A	21
4	144620758	C	77	cTtcTCctttttCcCTtTcCTctTccCccTTCTTCctTttTCtTcttCcCTttCttCCtTCttTTTtcCCcttTTCT	AAE?EBBFGFGGDBDGGGBBFBGEBBEBBGGAGGDCGGHGFDHGBBH=CDGHHCHHCCHF7FFFFCGC@CCHHE9=C	T	45	C	32
4	151344333	T	57	CtCTttcCTtcTtccTtttccCcTTCtctcTcCTcCTctcTctcCtttTTtTttTTc	??DDEECDGEFG>FFGEEEFFDGDGDEGFC?GCGGDGGFGEGFGCFGCFFFFFFEFB	T	33	C	24
4	152609700	A	26	CCCCAAACAAACAcAACCAAAAACCA	DDDDHHH@HHHCGHBGCCGGGGF@AA	A	15	C	11
4	153565645	A	29	aagGGgaaggGaGaGaAgaggaaggggga	CDEGGEEEFFGEFEFBEFFFFFFGGGGBF	G	17	A	12
4	154478300	A	34	gGGGAgagagggAgagggAaGGgggaggAggaag	@?HHEFFFFFDFFFFFFGDGHHGGAFGGDEGGGG	G	23	A	11
4	154669733	G	34	AGAGAAGGgAGGGGGAGAGGAAGAAAGGAaAGAa	EHDHEDFHCEGGGH?DGDGGDDG?9DFFCEDECB	A	17	G	17
4	155407680	A	30	AGgaGGaAagaAaaaaGaGgAgGaggaaaa	AECFCGFEFCEEFFGFGGGCF8GGDDFGGD	A	18	G	12
4	156289900	C	158	tctctctCCttCTCcttccCCcTttctTTCTCtcttTcCTTTCcccttcCCTCtCTcccCTccCcccTtTTTtTtTCCTtCcccccccttTtctCttttcCctCCcctCtcttcctctcctcttCTtCtcTCTCcCTcccctCTtccttcccTctccT	CC@?@DBFFDEFDEGDDFFFGGEDDGDDEFEGDGDDEFGEDEGGDBDDGFEEH<GEGGGGEGHEGGGEEEEDEEEDFFEEGHHDHGGHEEEEHDEEEEE:FHEFFHGEFEHDECHEGEHHEAEEFDDFEHCCDFHFDGHGHEFDEHHEEHHGDFDBBA	C	85	T	73
4	156643176	T	244	TtaTAtAATAAAATTTattaAAAAtaTATAtTTTTATTTaTATTtAATATTaataAAAAtataaTaTTtatttTATTTTAAtATAATAttaATATATTTAAataATATAAAAAtTTAaaAAAAaTTTTaTAtataaAttATttATTTtaattaAataTtataatataAataaAATtatAtATaAATAtTtaaaattAttTAaTTAtttTAttTTaaatTTTAaTtaaaTTTttTttTTATTata	DAC@?BAABDDEEGGGEDEFFFFFEEGFEFEEGEGFGGGFFFGFEEFGFGEFFEFFFFDEFE>FBGGGFGEFEG9AFGFEFEEFEFGEEDGFGDGFGGGFEGFGEFEGEEEEEFGGEDGFFEEGGGFFGEFFGFDDFEFFGFFFEGGFG>FFFEGFGGFGFGGEDFGEGFGFEDFFGFEFEFEDEFDFFDFGGGFFEDEFEGFFEFFEFEEEFFGFFFFFFEGEFGGGEEFFEDAA=>?AAB>D	T	127	A	117
4	156643183	C	235	CCAcaacCCCCaccACACaAAAACAAAcACAaCCACAAccacCCCCacaccAcAAacaaaAACAAAACCaCACCACaacCACACAAACCcccCACACCCCCaAACccCCCCcAAAcACaacaccCaaCAaaCAAaccaacCcacAacaccacacCcaccCCAacaCaCAcCCACaAacccaaCaaACcAACaaaCaaAAcccaAACcAacccAAAaaAaaAAAAcaccaaacACc	A>A>>CEDDFEFEFEFEFFFFFFGFFFF5GFFFFFF<FFFFFGFFEFEEFFFFEFFF<DFFFGCEFFFFFGEGGFGFFFGFFFGFAFGGFFFEEFFFFFGFGFFFGGFFFFGFCFG>EGGGGGDBFGGEGGGFFGGFGFGFGEGEGGGGFGGGGGGGGGFEEGGGGGDEGF6EEGE@GGGGGFGHEEGEEEGGFEFFEEGFGGEEFGEGGGGEEEGFDGGEDD@GAEE?BABACD	A	120	C	115
4	158142740	T	26	GGTggTGTTGGGGGGGGTTTTttgGT	GGEFFEHEEGHHHEGEGDADDFDGF;	G	15	T	11
4	160277276	C	45	TCccCCTtcTttTttctCtccCtcTTcTcccTcTtTttttctCCc	CDFFDDFEFGEEGEEFEDEFFDFG6FGBG=GGGFEFFFFFGD=AD	T	24	C	21
4	162421109	G	28	AaGAGAGAAAAGGaAGgGaAGAGAaAaa	HFAH;HCH@GG@BEGBGAGHAD?EA>;@	A	18	G	10
4	165981142	A	31	GAggaGaaAAGgaaAGAGgAgAaAgaAaGGg	BABFFGFFFFGFEGFFEEGEGEFEGGDCBC?	A	17	G	14
4	169348435	T	67	TcctctttcCttTTcttTcCTCctcTtcCCcTCCtttcccctctccCcctTccTCtcctcccccTtt	=?CCEDEEFEEEEEEEEEFGEGFEFEEGFGFEGFFFFFGG@FFFGGFGGFEGGEFFFGFGGCFGDBA	C	37	T	30
4	170429402	T	109	TTTCTCCTTCtCTCTTTCtCTCTCTccCCTTcCcccTcCTTctTCTtcCTtCtttcCtCCtCCcctctctcTTctTtTTctTCtTTccCtccCttccTttcCTCtcctC	BD?GEGG5EFEFEGAE?EEGEGEGEGFGGEEFEFGGEGFDDGEE?EFGGEFGEE>GGFDEF>GGGF;FGFGDDGFCFDCCFDFFDDGGFFGGFFDGGDEFGECEFB<>?	T	55	C	54
4	173269638	T	86	CTTTTTCCTTTTTTTCCTTCTCTTcttCtttCTtTTctCCCTCTCtTCCCTTTCTcccCCCTCCtCtTTTCTtCTCtCtTTTCttt	FEFFFFGGFEFGGGFEFFD8FACFHEEFEEDGEEEEHEFEFEEEDEECFEEEEFEBHHEEEEEFEEEEEEEEDEDDEEEECCB=>B	T	52	C	34
4	174458022	T	193	TttATatAtAATAAAAattATAATTATtATatTAAAtTTtTTTAtttAATATAaTTTtaaTtatAaaTaaATaTtttATtttttTaaTATaTAtaatTTAAtATTttaaTTaTAAAtaatTTtattttatTTATtAtTTTattAATtatTaTATtaTAAAtAtTATTTatATTTTTATtatAAaatttAATat	?C@?CFG@GFEAFFFEFFGCGEFGGFGGFAFGGFAEGGGGGGEFGGGFFGFFAFH=GGFFFGFGFFFGFFFGFGGHHF@HHHHHFGGD@GGFFHGGHEGF>H<B8HHEGFGCGFFFHFGHBGHGHHHHGHFFEFHEHFFFGBHEEEHGGFGFEEIHEDEEHEHFDF7EGHEFEFEFEDHGGEEEFCBBAAC@;	T	112	A	81
4	177049854	C	31	CCTCTCCtCCCTtTCccctccTcctCCCtCC	GGGGGGGFFDGGEFFGGGFGGFGGFFFFFEA	C	21	T	10
4	177052925	G	28	GgGcgggcccggccccgcccgggggcgc	CABCGFFFFFFFFFFEFGGGGGGGGGGG	G	15	C	13
4	177093505	T	42	TTTTGGGGTTTGTTTtTgGGTgGtgTGTGGGgGTttTgggGT	EEEEHFHHDEEGBEEFEBGHEGHFFDGDGGGGGCFFCFGGEA	G	21	T	21
4	177116463	C	73	CCCGCGGCCCCCCCCCCCGGCCCCCGCGGCGCGGCcGGGCGCGGCCCGCCCCGGGCgCGCCGGCcGGGGCCgG	GEGGGG>GGG?GGGFG><9GGGFG;FFFFFFFFFFEFFFEFFFFDFFFFFFFFFF9FFFFFEFECBEFF@ABA	C	42	G	31
4	178257516	G	29	gagggGagaAgaaaaggagggggggaagg	ACDCCCFCFHCFFFFCCFCCDCDDDG=ED	G	18	A	11
4	178274565	A	54	gaGgGaaaAgAAAAAAaGaAgAgGAAgaaAAAgaGGgAGGAGgaaGaaggAaAa	@DEFEDDDEFFFFFEFEBEFEFGEFFGEDEFEGEDDGEDDEDEECDECEEDAA>	A	33	G	21
4	184190535	G	101	AGGGGAGAGGAGAGGAGGAAAAGAGAAGAaAGAAgAGGgAAAGAAGGgAGAAGGgAAAAGAAGgagGgGGgAGGGGGGaAAAGGGaAAGgGAGAAaAAGga	>HHHHDHEHHEHEHGEH9EEEEHEHEEGEGEFEDGDFGG9DDGDDGGGDGDDGGHDDDDGDDFGGGGGGGGDGGGGGGGCCDFHGEBBECDA>A@?AAADD	G	52	A	49
4	185655171	C	61	TctctcCccCtccCcCcTcctctcCTCctccCtccCTTCcCCCcCCCCccCCcTCtcCCCC	?@:@CDCCDDDDDDDDDGDDEDEEDGDEFEEDBCDDFFCECCCECCCCEECCEFCEEBCB@	C	47	T	14
4	186112111	G	132	gGgaGgggAaaGgaagggaGGggggAGgAgaAAGggGGaGAGGgAGGAaGaaggaaGGggGaAaggagGaAaaggAaaAAggaGgaagGAggAAggAgggggGggAagaaagggggaggagaaGgagGagAg	C;@?>ABBGGG=CEE@CCECBCCCBHCCHCFEHCCCCAFC=ACCHCBGFDFFCCFCCCCC?FHFCCE>CFH<ADDHFGHEDDGBDGECCGDDHGDCGC8D?DBDDGGDGGGEDD?DGC:EBFDBDGCCEA?;	G	79	A	53
4	186299260	A	46	GAGAGAGaAAAGGGgAGGGGgaAAaaAGgaAGgAAAgaGAaAGgAA	D@CFGEGDF:EGGGGFGGGFGEC:E>EEGEDFEEDEG>FEEDFC?B	A	25	G	21
4	187159282	G	27	GGGCCCGCCCCCGCCGGGGGCCCCGGG	GGGGGGGAGGGGGGFFFFFFFEGAC?B	C	14	G	13
4	187534363	G	159	AAGGAGAAAAAgGAAGGAGaAGaagagGaggAGaGggAAAGAGAGGAaAAAggGGAAAGGAGgGGGGAGgGgGgGgaAGAgGAAAGgagGgGGgAaaAaAGaggGaaagGGGaaGGgAaGgGGGGggGAGgAGGGGaagaaGAgaAGAGGAGGgaAGGa	AB>?GAHHHHHFCHGCCDCF;CFFFFFCFFFICFCGFHHBCHBCC@HFHHHGGBCDHHCBHCGCCCCGBG>GCDCGFG?HGBGGHBGGGBGABEGGGHEGBGGGAGGHGBBBGHBBGGGB>BBBB:GBG9GGBBBBGGFGGAFFGGCD@AE>>B?C???	G	90	A	69
4	187538942	T	141	TGTGgGGTtGTGTGTTTGTGTGGTTtGGTGGTgGgtTtTGTtgGGTgTTGTGGGGGTgtTTGTTtGTGTTgTGGTggTTgttgGTTTGGttgtgggGgGGGtGtgGGGTTGtGGGGgTTTTGGGgTTtttGgtTTggGtGt	=AADBHHEGHEHEHEDDHEFDIIEFGCHDHHECHCGDHEGEGDHHCDDDHDHCHHHEDHEEGEEHHE:EDDEHGADDDEDHHDGDDDGG@9BFEEBFDGGGHGGDGGGDDGHG<GGDDDCDGGFDCCFHFGCGBA?>DACE	G	74	T	67
4	189065055	C	87	cCGcgGcgGgcccGGcCccgcggcCcggccccgcccGGcgGccGCcggggcgCccggGgcccGggggggcgggccccgcGgcgcgcg	?<>DA?DCDFBGFEDG>FGFGFFGFGFFGGGFFFGGEEGFEGGEGGFAFFGFFFGFAEGHHHEGGGGGGH;GGGHGHGGDGH:GDF?	G	44	C	43
5	413639	G	70	cgCccgcGGgccggGGggccgcgcgcggGcgggGccgcggcgcGggcgcggccggccccgcgggcggcgg	C>AC>=CEHEFFFEHHFFFFFFFFFFFFGFFFFHFFFEGFEGFF=GFGGFGG<GGFGGGGGGEHFG7EEF	G	41	C	29
5	422955	C	80	GccgGcggcGcggCcGggcgggGCcggcgGCccccccccgccgcgCcgccgggcggcgggccgGggcggCgggcgcgccg	@CAB>BCEDCCEDFDEFEDEFEEFDEEDFDFDDDCCDDDFCEFDFGB>CEFGGAFGEFFFEDFDGAEGGFFGGEEEFEEC	G	43	C	37
5	472951	T	68	tTcTCCtcCTCTTtCTCtTttcCTCCTcCcCCctcCcTCcCTTCTtTctCTtTTttCTcCcTTcCCtc	ABECEGEFGFFBAEGFF;DFFEGFEGEGGFGGGDGF6EEGEEEF;FEGFFDFBECEFEBEGDE?EGB@	C	35	T	33
5	476848	C	43	CTCtctttTccccctctttTcctcctTctccctcTttctttct	@B8BBDEEGDDDDDEDEEEHDDEEBEDEDBDDEEGCFEAACE=	T	23	C	20
5	1062900	C	47	CCGGCGGGCGCCCCGCCGGCggCCCGcgGgGgGCcGGGCgcgcGCGC	GGGG>CGGGGGFFGFGGGGGDG7FGFHGFBEEFFH6EFFGDCEB?CC	G	25	C	22
5	1074560	A	53	CCACCCAAAACAACACCCAAACCACCAAAAAACACACCAACCCCcAaCcAACA	CDGDDDGHHBDGBDADDDHGCCDGCCCGGGFGCG@GCCGGC?CCA=GCBBB@?	A	27	C	26
5	1232775	T	29	ATAaAATTAAaTATaTTTTTAAAAtATAA	ECEEEEDED:FDDDCDDDDCDCDDCAA??	A	17	T	12
5	1881916	A	120	AAaCAAACAAACCAACACCAACAACCAacCACAAACCCAaACACAAAccAACAAACACAACACAaCaACACCCaCCACCAacAAcCCCCAacaAaCCaacCaaaacAaCacacacAcaaa	BHDDHHFDHHHDDH;DHDDHHDHGDDGDDDHDHHHDDDHFCDHDHDHEEHG=HHHDHDFHDHDFFDEGCGCCCFCCGC@;EFFGECCCCGFEFG?CCDEECFFFFECEA@ACAB@A9>=?	A	69	C	51
5	2755191	G	82	GCGGCGGcCGCCCggCGCCcgCGggCgGGCcCGgGgGcggcccgcgccgCGGcCggGgcCgGCcGcgCcGccgcGgccgcgc	>?9>>ABBDCDD:CCDBDDBCDCCCCCCBABDCCACCBCDBBCDCD;>DDCC<DDDCCCDDBC=BCECCBCCDCADABA>=;	G	42	C	40
5	6604931	C	31	cttccTcccctttctctccctccctttcttT	CA?ACFDDDDDEEDDDDDDEFEDEFFEEFEF	C	16	T	15
5	6737571	A	29	AAGAAGAGGGGAAAAGAAAGAGAAAGaAG	GFFFFDEGGFFEEEEFEBEFEEEEEBCA?	A	18	G	11
5	6748518	A	40	AAGGAGGAGGAGAAAGGGAGAAGAGGAAGGAGAGgGgaGA	DHCCHBCHCCHCHGHBBBGBEGBGBBGCBBFBFAE@D<A?	G	22	A	18
5	10664578	A	192	gAAGGGGGAGGGAGAGGAGGGAGAGGGAGAAGAAAGGGGAAGAGGGAGGAGAGaAAGGGGAGgGAAAaAgGaGGGGAaaAAAgGagAAgAAAgGAGGGgaGGAaGGGAgGGgaaggGGGgGGAgGAGgAGGgaGAGaAAGaGAAGggGAGaaGAGGAGAAaGgagAAGgGaGGaggAGGgGGGaGAggGAAa	@D=DEEEEFEEEEE9EEFEEFGEBEEEEDFFEBFFEEEDDF9FDEEEEEFDFEGEEEEEEFDDEFFEFEDEGCEEEDGFBFDDEFDDCDEEEDEF@DDDGDCEG?DDEDDCDGGDDDDDEDDEDDBDADDDDGDEDGEEDGDEEDEDDEDGGCCCDDCEEGCDGCDECDEECCDA@BAB?9BB@AC=?CCCD	G	113	A	79
5	11117583	C	274	tttttCCTTCCccCTtCcttTTTTtcCCTCCtTCCTtTtttttTttTcTtTCCTTCCtTCTTTcccCTCcCTTCTTtTCTTTCCTtccTCTcCTTTtTTCTTccTTTCTTTTCTCTTTcCCTTCCTTccCTcTCCTCCTTCCCCCcCtCCTctCctctCTtctctCttCTCCttctttcttTCCCctctcTTTcttCctTctttTCTtTttttCTTctCctCccttcttccttccctttcctcTCcctcCTttcttCtttcCCtttccTtcTtc	A@BCCBA??BCCCFDFGCEDCDEEDDGFDGGE;GEEDEEEEEDDEEEDEEEDGDDFHDDGEEEDDDGEG9GEEGEDEEGEBEGGEEDDEGEDGEEEEEDGEEAEE=EFEEEEGEGEBEEFGDEFGDBDEGDDEGGEGGEEGGGGGDDFGGEECEDEDFGEFEFEFFFFFEFFFFEFFEEFFDFFFEECFE9DDEFFFEEDEAFFDFCDDFEGAFDCEFFEFDEE?FEFFEEBEEEEFCEEEFEDFEDFEFDFFEDFEFFDEE6ECDB?A:?A?B	T	154	C	120
5	13814682	T	56	CTCTTTCTCTCCTCTTTCCCCTCCTCCCTCCTCCTCTCCCCCCCCccTcctCtCTC	GCGEFEGEG=DGEFAEEGGGEEFFDFFFDFFDFFDFDFFADFFFFF>DFED>?AA@	C	36	T	20
5	13859743	G	62	GggtttggTGtttttttgttggtTgggtGgttTgtgtggggggttgtggggttttgttttgg	>A9BBEFFEEEEEEEEE;EEFFEEFFFEECEEFFEFEF8GGGGEFCFGGCGFFFFGFFFFE?	T	32	G	30
5	13862600	T	46	GGGGTGTGGGTGGTGTTTTTTTtGggTgGGTGTTTTTtTgGGTGTT	B>GHEGEFHHEHHEHEDEDDDDEGGGDGGGDGDDDDDEDFGFCFCC	T	24	G	22
5	13894894	T	186	ttTTTAATtattTTtAAtTTATttaatAAtAATattAatatAaataAAtaaaAATAaAtaTtTATtAAaattTaaTTAtatATAAaaTTTaaAtttAAttatATTtatatttAttaaAttTtAaaaaaaATaattaaaTaaaattattataaatAatttttaatAaAAtAAaaTtTtAaaaattaa	?@@>A>AACCDCEGDFFEGGFGEEFEEFDE@FGFEEFFDFEFEEEFFFEGFFFFGEFFAFGEGEGEFEFFEF>GFGGEFGEF@FDGGGFFGGFFEFEFFFGFEGFFGFEFEFFFFGGFFFGCFGGGFFGFDGGFDGFFFGDGFFFGEFGGEFGFEGFFFFFFGEEGEEFDDGGEFEDFFEEA?9DD	A	99	T	87
5	14381174	C	27	cCTTTTCTTCCCTCTTTTcTTccCtCT	BGFEEEGEEGDGCFDADACDDCCFHEC	T	15	C	12
5	16679966	C	32	CCTCCTTTtTCTCTCCTCTTcTtCTTTtTCtC	CFGGGGGGFFGGFFFFFGFFGFDFFFEFFEEB	T	19	C	13
5	16684143	A	55	atTAAatattaaAaATAatAtttTAatTatAtAataaaAaaaAaTattaaaataa	CC?EEFFEEGEFFFFGFFGEGGGGFFGGFFEHFGH?G<EGGGFGFGHHGGEGHGC	A	35	T	20
5	32784776	A	45	GGAGAAGGGGAGGGAAAGGAGGGGAGAAGAGgGGGAgGGAGAGGG	;DDGCFGGFGEFGFEEBFFEFFFFEFEEFEFGFEEEGBEEGFEBC	G	30	A	15
5	34716270	A	60	AAAcCcCaacCAAcccCAacaCacCaCCAACCcCCCcaacccccCCCCacaacccAacAa	CCFFFGGDCFGFFGGGEFDGEGEGGCGGFFFGHGGDHEEHHHHHGFFFEHDEHHHEEHD=	C	37	A	23
5	34795968	C	85	CCCCCCCCCCCCCCCCCCCCCCCCCCCCCCCCCCCCCCCCCCCCCCCCCCCCCCCCCCCCCCCCCCCCgggggggggCCgCCCCC	DADDDGFG7>BEGFF7FFFGGG>FGGFGG?GGFFFGDGEDFGEFEEEFFFFEFFFEFF8BEFFEFEFEDDD@DD@@@GF>BB@@?	C	75	G	10
5	35643615	G	93	AAAGAAGAgAGAAGAGGAAGAaGGgGAGAGGaAAAAggAGAGAGgGAgGAGGgGAGGgAaAggagGaaGAaagaGAaAgaGGgAagAaaaAaa	5FFEFFEFFF<AFAFDAFAEFEEEEAF?>EEEFCFFCEFEFEFEGEFFEFDDGDEDDGEEEF;FFDFEDBEEFFDEFEAFCDGEDBB@@:?CB	A	50	G	43
5	35644621	T	29	cttTttTtccTccttCtttCttctcccct	9EEEGGFG>AEBBGGGGGGGGGCHCC@C>	T	17	C	12
5	35857177	G	199	gCCGggCGcgCcCGggcCgcCcccgCGCCGCGgGggcCCgcGgGgcGgggGcCCgcGGgGgcGgGCccgccGcgCccgGcCgGGcCGGgccGgCCGcgcCCGCccgCGgccCccCGGCcgGcccGCCgcgGCgGgCcgGGCCGgCCcCcgggGGgcGgcgcgcGgcgCGCccCGcCcGGCgcgCgGcGgcgcgcccGcc	C@?<@AB@CC?EEEFDEAFFGFFFFGGGGGGGFFFFFGFFFEDFFFGFFFGFGEFFGGFFFFGFGGEFFFFGGFGFFFB7GFGGFGGFDBGFGGGGGGGGDFG?FGGGGGGGGFGGG>GGGFFFGEEGFGGFF;GFGGGGFGFGGGGFGGCGFFGGFGGGFDGFGGHCEFGGFFGFGFFFGGGFGFGFGGGGGCAAC@?	C	101	G	98
5	35861152	C	59	cccgCGcggggcGcggcgggggcccgGcgGgggccGgGcgGGccgccggcgGgggcggc	ACCABBCGFEEEHFFFFFFFFFFFFFGFFHFFFFFHGHFFHHGGGGGGGGHGEGGGGFG	G	37	C	22
5	36985303	A	65	aGGAgGGgaGaaggaGAGaAGgggGgAAgAAAGGgGGgaAAAgGGaAgAggaAAAaaAGAAAgAa	CAFEFGGFFGFEFFFFFGGFGGGGGGFFGFFFGGG7FEGE:EDFFFEGEEFGEEEEGEEECB9AD	A	33	G	32
5	37001074	A	27	AAggggaaGggaaagaaAgaGaAAgGa	BBG:FFFFHFFFGGGGGEFFHGDDGGG	A	15	G	12
5	37341352	T	78	cttttTctcttttCTtccccttCccctttctctcctttttctTtCttttccTtccccCtcttcttctttcCTcttctc	CCBCBA?ECGGGGDEGBABBGGFBBBDGGBGBBBB>FGGG9GGGEGGHHBBGHBCCCG<6GBCEHBHHHCFFCHD?C@	T	45	C	33
5	38408093	C	52	gcGgCCgggCCGcGccccggccggcccccccgCcCccgCcgcccggcgGcgG	A?=A?=BABAEEAEB@BBCAB@CCBBBBBBBCEBEA:DFC@CCBADCDDC;A	C	31	G	21
5	38919158	G	202	GAaaggGAgaaGggGGggggGgagagaGggGggAGgaggAAGagaGgaAGAgGagAGgGaaGAaggGGAagGggaagGagAAagAgggaggaAgaGGGgaGggGgGggaaGgAGgGaggaaGagGAAAaggagAGGaggaaggGgaaGgGgaaAagaAggggAggAaaaaAgagGaaaAgaggGagaaGgaaaaAgGaAaag	@ECCA?<BB<A>CC??DFDFBFCDCFCCFFCFFHC@DFFHHCDFCCDDHCHFCCFHCFCDDCHDFFDDHDECCFDDFCEGHHDFHFFFDFGDHFCCCCGECFFCGCDGEECEHBGCEGEEDCEGCHGHEEGEDHCCDGGEEEGCGEECGBAAEHEGEGEEGDGGGGEED@GGEGBEEEGEEEGBEFEEAGEEEEGGBDF:>?	G	115	A	87
5	39364358	G	35	AAAAAGAGAAAGGAAGGAAAGaAGgaAGAGGGGGA	EIGHG@GCGEGBBGGBBGGGBEGB:EFBFA<@CA?	A	20	G	15
5	39375082	C	35	TTcCCtTcctCTCCCCCCttTtTTTCCTTctCccc	GGDD>EGEDE?GDDDCBCFDFBFEFCCFFEFCEE?	C	19	T	16
5	40746885	A	34	AaTATTATTTAAtTatATATATTTTTTTAtAAat	FEFFFGFFGGFEFFAEEFDFDEEFEFGDB;AA@B	T	20	A	14
5	40964816	C	68	AACCCCCAAAACCCCAAAAAACAAAACACAaACAccAACAAcAAAACCCCCCACCAAACACcAACCCA	EDFEGEGEEEEEFFGDDBEDBGDDDDFDFDFDFDDEDDFDDDDDDDFEEFFFCEECEBCBC??CC?C?	A	37	C	31
5	41155088	T	265	CTTCtCTCCTTCTTtTTTTTcCcTTccctTCTCCTTTTTccCtTTCTCCCtcccCTCCTCtCTTtTTTTTtCTCTTTCCCCtctCTTTTCTCCTcTCCcCCCTTtctttcCcccCTtccCTctCTCctTCcTTCTttCCcttTCCcCcttTTccCCCCtTtcCTcTCccTtTCTCCcttcTTTccctCCcttcTCttcttctCtcccCTttttTCccTtCctcCCCtCCccTTTTtccTcTCctctttcccTccctctctctTTt	DA?@CA;BBBBAAABEFEEECFCGGDDD6GGGGGGGEGGCDGEGGGGFGEDDDDEFDGGGEGGGEGBGGGEGGGGFFGGGGEDDGGGGGGGGGGDG9CEFG?GFDEFDFEGEEEFFFEEFFE?FGGEFGGEGGGGFFGGEFFGGGEGDFEGFEEGGGGFFFCFEEGEEEFFGFFDFEF<EFFFEEEFFFEFFEFFFFEFFEFFEEDEFFF:FFFFEEFFFCFDFFDEFFEEFFFFFEEFEFFEFEFFFEEEECDDEB=?>=@?B9	C	133	T	132
5	43245922	C	44	CTcCTCCCtTTtTTCCTCCCtTCCCTCCTcCcTtCTTtcCcCCc	EEFGGHBGDBDF=GGGGGGGFFCFFFCCFGFGFFCDEFEG?>AB	C	26	T	18
5	44305309	C	53	cccggggcccgcCcgcgccccccgcgcgccgggcggccgcgccggggcgcggc	BDEFFDFGGGFGGGFGFGGGGGGFGFGFGGFFFGFGHHFHGHHGGGEHGHGGC	C	29	G	24
5	52781597	A	29	AattttttAttaataatattaaattttAt	BABEEEEEFEEEGEGGFGFEGFCFFCFA?	T	17	A	12
5	54528393	G	43	gcgggccggccgCGggggGgccggccccggcgcCgggccgCgc	A@BCDGFEEGGFFEFFFFDFGGFFGHHGGGHG=GGGGH;@DE=	G	24	C	19
5	54923668	G	38	AGGGGGGGGGGAAAGAAGGGAAAggAGGGAgGgGAgAA	CHHEHHHHGGGDDDGDDGGGDDDGGCGGGDFEBDA@C?	G	24	A	14
5	55155402	C	107	TTCCCTTtCCCCCTCCCcTCtCttTCTTCCCtCCcttCTCCttcTcttTCTCccctttcCctCCcCTCTtTTtcTCccCCTTtCTcCCCTttTccCCctTccTTCct	@BDDDGGEDDDDDGDD@FGDEE=EGDEGADAFCDGEEDDDAFFGFGFFGDGDGGGFFFFCGFCDGDF9FFCF@GFAGFCCF6FCFGCCCFFDFFGCCFFECCC?@DC	C	59	T	48
5	56209735	A	122	GGGgGAGAGGGAgAAAAGAAAgaGGAGAAAGaaGGaAAggAGAaGgaAgggagGAGgaaGgGAGAaaAAGGGAGaaAGGGGAGAagagAgAAGGGgAAAGAGGAGGGgGGAaGGaaaaaaAA	BBEFGFGFGGGFFFFFFFFFFFDGGEGFFFGDCGFDFEGGFGFCGGEFGGGEGGFFGEDGEFEFEEEEEFFGEFDAEFFFFEFEFAEGEGEEFFFGEEEFEFFEFFFDFEEEFFECB>@@C?	A	61	G	61
5	56719995	G	92	GcgGCCcCgGgGGGgccCcggGccccGgCCgGCggggCCgcccccgGcCccCgGCGCCCgcgGgGggGCccGcGCgCgcCgGCggggcGgcc	BAA?BFB@CCBEEECBBEBCCEBBBBECGFCBFCCCCFEBBACCCDECGCCFDEFEAGFDCDDDDDDDF<CDCDEDEDCEDDDCC>=<B=@?	G	47	C	45
5	57842049	C	149	cccCgGCcgcGCccggcggCcGGCCgGgGCCgCGcGGCCcGcggCGcgccGGGccCCgcCcCccGGgcGCccgccGGCcggcgccCgCgcggccCCgCggcccgccGggcgcggGcggccccCcggcCCgcccgcggcccgcgcggggc	CDC>>?CGGGCDGFDDGFFDGCCDD5CFCD@;ACG8CDDB@GDFBCGFFGCCADGDAFGDHDFFC=FGCDHGGGHCCDGGGGGHHCGCGGGFHGDDFCGEHGHEHHB?FHGEGGBHDGGHHCCHGHG=CGHFHGHGGHHHGGGHGGGAC	C	83	G	66
5	58476225	G	30	GgggaGaaaAaGGagaGgAGggaaaaAgag	=CEFFCDFFGF>CFFFBFHCGGGGGFHGGG	A	15	G	15
5	59899413	G	81	ggGAgagagGGGaAGagaaAAagAGaggaGAgAaaaAAaGaggaGaaagggaAaAgaaggGgagaagagGaagggaggGaa	AA?8ACACCGFGECHFCFFE?FC?HFCC6GECEFFFCEFHFCCF?FGGDCCGDGEDGGDD;DGDGGCGDHG=CDBGDDFEE	A	42	G	39
5	59995820	G	82	CGGgCgGgCcCcGCCCCcCCgCGCcgCgCCCCCCGGCcCCcCGGGgCgGCgcCCgccccCGgcccgCgGgggGgGGCcCccC	<@FFFCFFGFGFFGHEGFGGCGGEGEGDGFGGGGGGGFGGGFFFFGGGFFDGFFEGEGGFFGGFHGFGFGGGFGEEFFGB>B	C	49	G	33
5	60981850	T	40	CCCTCCTcTTCCTCCTTtcTCCTTCTtCTCCCcCCcCTCt	EGGEGGECEEGGCGGCDFCD;FDDFDHFDEFEBGC@@@C@	C	24	T	16
5	64865658	T	42	TtctCCCCTTTTTTTCCCCCTTTTTCTCCATCTCTCTTCCCc	EEFE=GGGEFCF=FFFFFFFFFFFFFFFFEFFFFEEEEFD=@	T	21	C	20
5	64890479	A	28	AcacaaCAAacaacaCaaacCcaaacca	AB@DDD?HFCGDD<DDDDDHCFEEDHHE	A	17	C	11
5	64920803	C	26	CTTCTTCTCCTTTCCCCCCCCTCTCC	?EFFEFGFGFDEEEDFEFFFE@B?>A	C	16	T	10
5	65892448	C	31	CCcCGGGCGccGCcGCgGgCCGGCGCgCCCG	D?EC@BBCBEEBCE=CGAFCCBACBBEBB;<	C	17	G	14
5	66084424	A	28	AAaaCCaCCaaaCaaCaaaaCaaaaaaa	>HEE99E?@FFC8FF9CF?F:FFAF;EB	A	21	C	7
5	66084430	A	39	CCaACaCCCCCCaCaaaCACaCaaaaCaaaaCaaCaAAA	9;DC:AD>C;7:EDEFE99>ABBFCFDEEF;?>BCA@@A	A	23	C	16
5	68720419	T	78	TGTGTGTTTGgTgGTTGTGggtgtGtgTtGggGTtggTGGGGTtTTTgGttTtGgTGTTTGgtTTTTggGgggtgTgg	?BCGEHEEEGFEFGDFBDHFFECFHEEBEGGGHEFGFEG>HGEFCDEGGEFDCGGDGDCDGGFDDDDGDFFEFEAA7:	G	40	T	38
5	68728544	G	83	AgGaagAAggaaaaagaAaAAgaagAaggGaggAggaaAaggGaaAaagggGAgggagaAGggaagGaaggaagggagaaGgA	C?=CCAEFCBFFFFFCFFFBFCFFCFFCCEFCD<DCFFEFCBEFFFGGDDDDFDDBFDGFEDDGDDDGGD7GHEDCGDGGCCC	A	44	G	39
5	70800538	G	42	AGAAGAaaAAGgGaaaaGggAaaggGAaAaaggaaGaaGGgG	@AEEHEFFDEHEHGFGGHGGEFGGGG;GEGGEGGFGGGGGGF	A	24	G	18
5	71490962	A	78	GGaAGAaAGGAAaAaaGGAagGAGgGaAGAAAgggaGGaGAAAAagggaGGgaGggGAAaAAGGaAaAAAGaGGaGga	DAGFGFEFGGFGFFDGGGFDFGFGFGGEG8FFGGGGFEGFEEEEGGGGGFFEGFDGFE:GEEFFGEGDEEECB@@B?D	A	42	G	36
5	71524163	A	300	TAAaATTaTaATTTTatATAtaaTAAAtatTTtTTAAaaatAATTaaaaAAtAAAttTAtATTaaTTTtaTTtTAatTatATtatTTATaaaTATAATAAtatTAaaATattaaAattTtTAaAaAttTAATTtAttaTTTAAtaAaatTTAaaAtaTtatAAttTAataTaAttAataaaaaAatAtataaAaaATTtaaAtTTtaAAataaaatTaTTaAtataATaatAATaaAataaaaaaaAtTTatataaAaAaaTatTattaAtAAtTaataATaatTttttAttTAtTatta	BCDCAB?>:BA?BBACADEFACCEFEFDDCGGDGGFFDDDDFFFEDDDDFFDFFEDDGFDFGGDDGGHDDG<DGGDDGDDCGDDDGEFGDDDGFDFFGFFDDDGFDDFGEEEDDEEDDGDGEDFDFDEGFFGGEFEDEFGGEFEEFCEEFFEEDEEEFEEEFFEEGFEEDF<FDEFEEEEDDEDEEFEEDEEFEEDGEDBEFEGECEEEEEEEEEEGEFFEEEEEEEFEEEEEEEEEEEEEDEFFFEDAEEE:EFDEEEE>FEEFECCBEEEEEFEEEEEFEEEFCDCDE>:BC?B@>=B	A	164	T	136
5	73076457	G	36	gGAAgAAAaAAgaaGAAGGaAGAAGaGAAGAAgggG	>DDFFDFEFFFFFFDFFEE<FEFFEFDEEDEE?D7B	A	21	G	15
5	73090089	T	49	GTGTGGGGGTGTTGGTGGtGTTGGGgtGTGtgGTGtgTTTtTGGgggGT	@EHEHHHHH>HBEHHEHFFGEEGGGGFGDFFFGDGFGDDDFCFGGGEAC	G	29	T	20
5	73090261	T	52	cTtTccCCtccTtctCctccCCtcTTttTctCtCttttcTcttTcCTccttc	AAC@@@CBFBBGGBGD@GBBEDGBGGEAGCHDHDHHHHCFCHG7CCFC;HH8	T	27	C	25
5	73091126	T	34	ATTTAATTAAATTTTAATTATTaAAATTttAATT	D?EEEEDEEEEE9EDEDDDDDDEDDDDDECBBAC	T	19	A	15
5	76708987	A	79	AGAAGAGGGGAAAAaGgGAGGAAAggAAGAgAAAGaAaGGGaGaGGGGgGAgAagGGGGAgGAAGGaAAgAaAGGaaAa	>GEFGFGGGGEFDFDGFGEGGCFDFGFEFDGEFEFGEGFBFGFGFFFFGFEAEGGFFFFEGEEEFEDC?FEBABC@<AD	A	40	G	39
5	78697675	A	150	CAACACAACCACAACACCCCAaCACCCCAACCAcAAcCACcAcAcacCaAACCcCAcCAcCcCAaaaaAACCAcaCAcCcCaACCcCccAcCAacaaCAaaACAacCAaaACccaacAAAAACaaCcaCACcccACCaCCACCACAaAca	D?:AABCEEEFBFFFAGCFEEDGGFGGGEFFGEGEFHBFGHEGFHEHFEFEGFGGFHGEHGHFFEEEEFEFECFEF9HEHEEEBFGEHGEHFEAHEEFEEDDFEEHEEEDEECHCFHEEEEEEEDEEEEEDFGGEDDEFDBCBBBB@BA@	C	78	A	72
5	79086649	G	26	AAGGGGGAAGGAAAGGAAGaGGGGAA	FEGGGGFEEGGEDEF=EEFGFFFEC?	G	14	A	12
5	79095417	C	60	CtcccTtCttCTtTtCctttcccTCCTttCcCtCcCCccctCttccCcctcctTttttcc	ACC?:@DAEFDFGGGDBGGGBBBGDDGGHDBDF??DDBCCHCEHCCCBCHCCHFHHCGB>	C	33	T	27
5	79354702	C	27	TctcTtccctctttctctctcttcttc	DCACGGBB=GAFFG@F>GAFBHHCGHA	T	15	C	12
5	79366249	T	81	GGgGTGtTTTTGtTGGtTTTtggTtTtTGTtgTGgGTgGGgggTgGtTTtTGttggtGTTggtTTttgGttGTgTggggtt	D@CCBDGEFECEGFEDGFFFGCCDGFCFEFGDFEDD=DEEDADFDEHF=HECHHDDHDEE@DHEEHHDDHHDEDEDDB?C@	T	44	G	37
5	82353087	T	63	TtCcCcccttCcTCcTcCcCcttTTtcttccccctttttcctcttCtctttcctccccttctt	BC@A@CCBAEEFGGFGFGFGFEEGGEFEEEECFGEEEEFFGEGFFFFGEF@GFBGHGGFFGD=	C	33	T	30
5	82940273	C	121	GcgCGCGCCCCccGCggCCCgggggcGGCCGCgGccggGCCCGcGcgGCcCcCGGCgcGGGCGcCgCcCcCcgcCCgcCgcgGCccgcgCcgcgCGCCggCCcgggGccCCgccggccccc	<CCDCD=FFDGDCE@EEFFGFFEFFDEDGGEBB?DDFDEEGGEEDDFCGAGDGEEGEAEEDDEDEFEEFEGEEEGGDEGGEEDGEEAEGFE?EFEDGEFBFEDFDGDEEEFEDDDEAA<>=	C	70	G	51
5	89825210	G	98	AGAgGAAAAaAGGGGGAAAGAGAGGGGGAGAAaGGAGAGGAGaGGGAGAAGAAGaaGgaaaaaAAaaaagGGGGaAGaGAgaAagAGaAGgAAGagGG	CDFFEFFFFEFCEEEEE:EEEEFDEEE;FE>FFEDFEEEE?EFEDDEEFEDBEDFDDEFFEGFEDFFFFADDDDFEDFDEFFEF@CCDEDDDDBA>C@	A	52	G	46
5	89938587	C	60	ttCttTTTcCTtcTCCTTTtTCtCCCTTCCtCTTCTtCCCCcCcTTTCCTCTTTCTTtTt	CDGGFGGGBGGGAGDGFFFBFEHGGFFFFFHFFCCFIDFFFCDCFFEFEFEEEEEDGFDC	T	35	C	25
5	89979380	T	33	TTCCCTCCccCCCCCCTTCCccCCCCCTCCCCC	GFGGGGCGGGGGEFFFFFFFGGFFFG@B=ABAA	C	27	T	6
5	89985882	A	69	aGaaaagAggGggGaGAAaaaAaAgaagaaggaggagGgggagaaggaggaaaaagaagagggaaagag	C<?CBB=BFFFFECECEEFFEBFEFEFCFFFFFACFFHFFFF>FFFFGFGFGGGFGGGGGGGGGFGEFD	A	37	G	32
5	90020923	T	32	TTgGTGTTGGTTTgtgGTtGGtGGGGTtTttt	G>DCFCFAB=FGGGEGCGEBBEBBBBFEG;B@	T	18	G	14
5	90449154	G	26	gAaGGaaagGAggggAgagAagaagg	A@EDEFDFFEFFFFFFFGG;GGGGG?	G	14	A	12
5	96116660	A	54	AAGGAGGGGAGGGAGGAGGGGAAGGGGGGAGAAGGAAGGGGAGaGAAAAAGAAA	EFGGFDFGFFFGBFFEFFGEFEEEFFFFFEFEEFFEEFFFFEFEFDDCBBCACA	G	31	A	23
5	96121715	C	27	cccttcctccctattcctttctttctt	C?CEEFFEFFFEFEEFGFFEGEFFGFF	T	14	C	12
5	96122260	T	25	tGGgTGGGTGGtgtTtggGggggtg	EFGFGGGGGGDEGEGCGFFGGGB<?	G	17	T	8
5	96239294	A	50	ggagagaagGgggaaGaaggaaGaAgAggagAggGGaaaaggggaggaGg	CCDCCECCFCFFFDDCDDFFDD6DHFHCFEDHFGCCDEEEGGFGEGEEBF	G	29	A	21
5	96363407	C	103	TCCTTcCTTtCtTTTCTtcTtcTcTcTtcTCCcttCTTTctTcCccctCCTcTcTcctCtCTCCtTCcTTccTtTCTCtcTCttttCtCTctCcCcCCctCtt	BBACDFBEEEGEECD<DEFFEFFFEFEDFBGGFDEGEEEFEEGGGGGFGEEFEGDGGFFFFDFEFCFGDDGGDEDFAFFGDFFEFFFFFCGFDGDGEFGDB>C	T	53	C	50
5	105751502	A	31	GAaagGgGaGGggGgggaaGGAGaGGaggga	B@CEFEFEF;EEEEGGGGGD9FCFDDG@A?D	G	21	A	10
5	108691738	A	29	tttTtttttattttattatttttatttaa	C@EGDDDDDDDDDDDCCDEC=E<FDEEDC	T	23	A	6
5	108714298	T	239	CtccTCtCTtCCccTCCCccCcCtCTTCtCTTCTcCctTCCTcttTCCTtcTCTcccTTTcccCCccCttcctttcctcCcCtTtttCtCttcccTTTcccCTTtttTcTTtCTctTcCtTTcccttcCTCcTtCtCCctTccccTCccccttCccttCtcccttCCttcctttttctccTccCCtctTctTctCcttcTCccCCtttTcTttCTccctcctTCtTtTcttcTctCccT	A??C8?CB>>BA9@;BCD@AGBGFGEEFGEEEFEBGBGEGGEBGBEGGDGBEGCBBBEEEBBBEGBBEGGBBGGGBBGBGBGGEHGGGGGFHACBEEEABBFEEGHGECDBHGECHECGGEECCAG>CGEGCEGFGEGCHD@CCCEFACCCHHFBCCHEH@CCHHFFHHCCHHHHHCHCBDCBFFHBIDAHDCHFCGHCDFCBFFGHHDCDHHFDCCCG<CHDEGDGC;GGBD?>B;;A	C	127	T	112
5	112176325	G	83	aaaagggaggggaaagaagaggggaagaaGAgGAaAagGaagAAgaggGAaagaaGAaGaGGAAGGGggaaGGgaAAAAgGAG	ACDD;CCFDCCCEFFCEFCFC8CCFFCFFFFCEFFFFCEGFDFEDGDDBFGFDGGEEGAGDDEEDCDDBFGDDCGDCDDAA?>	A	43	G	40
5	112256814	A	41	AAGGaAGGGGGAGAagGAAGAGGAAAGGGaGGGgGAGAGGA	EEEEF@@EEBEEEFGDE9=D:DDEEEDDDF@DDDCDEDCA?	G	24	A	17
5	112257908	T	110	CtccCcTCcctCtttctcTTTtctcTCCTCttcTTCCctttccccccttTtcCcttctttttttttTtcCCccCcttcctccTtttccttTccCttttcctccttccttt	??@A8AB>5BC@DFEDEDGFCDDEDADDDDEEDGGDDD9EEDDDADDEDGEDDDEEDEEEFEEEE8FFEBDEEDEDFCEFDDGD;EEEFFFEEC:@FFEEFDEFFEDFC<	T	58	C	52
5	112927686	C	42	AAACAACACACCCACAACCACaaAccCACACACCCAcAcCCA	FFFGFFGFGCFGGFGEFGFEGDFEEEFDFEFEFEFE?DCFA?	C	22	A	20
5	114557727	C	40	TcTTCCttCTTctcctCtTCttccCccCttcccccccctt	@>9?GGEGGBGBGB8GGEGGEGBAGCBGHHCCCC=8@BCG	C	23	T	17
5	115298518	A	118	GGGgGAAagAaaAAAGGAAGAGAGGAGgGaGgaaGaaaAGgagAaGAaAAGaGgGaAAaaaaAGgGaAGggGAAaaGaGgAaGagAgGAGgaggAAGgGAggGGGaAGaAAagAAaaG	<>AF6HEDDGD:HCCB>HGCHCHCCHCFCDCFDDCEECHCGED;EBHDHH5E>F?EHGEEBEGCEC=HCGG>DGEABEB?G=BEEGEBGBGEEGGGBEBGDG=B?>FBCEGCFCD;@A	A	63	G	55
5	115783553	C	62	cctctttctttcCcttCctCtCtcccTttcTctctccttcttccttttTcctttttcctTtc	CCC;C;>@HFGBDBGGCBGEGDGBB@FGGBHBGBEBCGFCGFCCHGHGGCCHHGHHCAHFG=	T	35	C	27
5	118969960	C	200	tCTccCCcTtCTccTTCCCTCCcTTCTTTTctCTtCtCCTtTTTCTTctTctctCTCCTtttCccTCCCCCccTTccCTCTtctTtCccCCTTCCTtCCTTCTCTtTTTtTTCcCcCCctcCCTttcTTctCTccCCCTCCTcCTTtTTCtTttCTCTCTTCTtTTCCcCTCCctcCCCctTctcCccctCCctCttcCc	A<BBB@@CEFCG@DGDDDDFDCDGEDGGEGDEDGEDEDCGEFGFEGFDEGEEDFDFAAGBDEDECGD7D@DEEEGEEDFDGF9DGE:EEDDGGD=GEDDGADGCGFFFFFFGDEDECCEEECCFF:EFFEECFEDCCCFC@D:CDFAFFCCFFFCFCFCFFAFAF6CCECFCCDFECCCDFEEFDB:=DDCB@=@@>=8B	C	106	T	94
5	123966399	A	78	GgAAgGGAgggAggaAagagaaAAaaGAaGgggGAGagaGAAAAAagaggGaagAGGaAggggGAAaagAaaAAgaaa	D?<>A@BAFEFFFFFEFFFFFFGFFFGCEGFFGGEGFGGGFFFFFGGGGGGGGGEFGFEGGGGFEEG<GE@GEEDG@?	A	43	G	35
5	129098311	T	31	cTTTTCCcCtctcCtTtcCctTTccttcttt	=EDECCGFHEFEGEFEBGGGFDCGGBFGDAA	T	17	C	14
5	130831365	T	44	tttTtCtcCtTcccctTCctCCcttcCTCTCctctCttCTcccc	C<DGCGDFGDGAGGGDGGGEGGHEDHGGGGFHDHFFEEFDFEC?	C	24	T	20
5	130982768	A	144	AAGGgGAAAAAAGGAAGGAGGAGGAAGGAAGAAAGAgGGgAGGaAGgGAAGAAGGGGaaGaaAgagaAGAgGGaaGGAgAaAGggGAGGAGgaAGgGGGagGagAGaGgAGgAgGaaggAGGGGgaAaggGGGGAAgAgagaAG	BA??CEEFFFFFEEFFEEFEE<EEFFEEFFEFEEDFGE;GEDEDEEGEFFEFFEEEEE>EECFGEFEEEDGDDEEADEGEDEDGECEDDEDGFEDGDD?EGDEFEDE5FCDGEGC>EEAECCCDFDE:;EDBB<BB?;>=?=A?	G	80	A	64
5	131805735	C	107	ctTTCCCcCCcTCCcCCCCcCCctCTCTCCCCTCtCtcTTccTCCcCCTtTcCccTTCcCCCcTTCtcCcCCcTcTtCCcCCTCcTtctttccctctcCccTctctt	CBAAB@9B9DBGDCBDDDCBCDBFDGDGDDD>FAHDHBGGBC=@DCDDGHGCD=CEECCCCCCFFCHCD>CC?FAFHCCCCCFCCFHCHHHC@CHCHCCABFBHBFF	C	71	T	36
5	132018169	C	137	AACAACCCAAcaCcAAcccCacaACCcCACACcAACCCAACAacAaaACCccaaAAaCaaacCcCaacAccACAACACCaaCccCAcCcaaacaaCaAacacaacccAAAAcaaACCAAACAAaaAAacaCcAacAc	B=?;>BCFADFCECEEFFFGFFFEGFFGEHFGCCEGBEEEBEFFEGEEGAGGGGDEGGGFFGGGG<GGEFG7FDDEDFFGGFGGFDGFGGGFGGGFFBG>FGGGGEFDDDBGGGDFFDDD@DCGGDDE@GFBD>>?B	A	74	C	63
5	132038199	C	42	CCCCCCTCCCTCTTTCCCcCcCCTTTCCCCTCTccTTCCCcc	DCDDDDFCC>GCEFFCCCGCDCCFEFCBBCECFEFEEA@@?D	C	30	T	12
5	134059334	A	65	GGagGgGgGAAGAgGAAGgaAGaGGagAggaaaaaAgaaagagaAaggaAggagggaaAagaaaG	@7CABFCDCHHCGF:DHCFEHCFBDFFHFFGFGGGGGFGGGGFFGFGGDGFGGGGGAGFFCC@@:	A	34	G	31
5	134782576	T	112	TTGttTGGtTgtttGtGTTgtGgttttgTggtGgttGggttgTttTTTTTttgttTTgggtTtTtggTTTGttGTTtGGGTGGgGGTggtGgTttTTGGGGgTtTgGTTTGT	C?@BB?AA?FEDEEEEEFFFDEFEEEEFFFFEEDFEEFFFEFFEFEEFE;FFGFBEFGDG>FCCBGGEDEDFBAFEFDDDADDGDDEEGBDGEFFDEDDCDEEECD?>BCA@	T	66	G	46
5	135276701	T	78	CCCTCCTCTCTTTCTCCTTTCTTCTcTTCTTCTCCCTCCTTTCCCCCCTTTtCtCCTCCCTCtTCTCCCcCCctctTc	GGGEGEDFEGAEEGEGEEE9GEEGCECCFEDFDFFFDFFDDCFFFDFFDDDFFFFFDFFFDFFCEDE>GDDC@A9>>B	C	43	T	35
5	137673623	C	60	CAACAACAAAAACAccAACAACCaCaacCAaAaAAACCcAacCACacAaaCcCAacACcA	A?EAFFGEFDF?GBG?FEGFEFGEGEEFGDE>EFDFDE@CEHED=EFEEDFHEDDGCB;A	A	35	C	25
5	137733891	A	97	GGAAGAAagGGgAGgAAGAaGAAAgAAGGGAAAGggGagaAAAgAAAgAAaGgaaGAGAGaGGAAaGaaGAaAgAaaGgaGaAGggaaGGggAGGGa	CHEEHE?EEHHEEE@EFDEFHEEEFDDHHHEEDHF?HBGEEE?GDEDADEEGGFFGDGCFFGFDDFGF<GBFDFDFEGFFFFCGCCCCDD@BCCA?C	A	52	G	45
5	137777269	A	60	aaggaggGAgGAaaggGAaGGGaaaaaAgagGGaagGgAgagaagAaaggggagggaaga	CDCCGGECHFCHFFFFCHFC@@FFDFEHF<C?B;EFCFHGDGEGGGGG<GGGGGGHHGGD	G	31	A	29
5	137780368	C	91	AcACAaACacCACAAACaCaCaCAAAACACAAACCACAACCCAcAACCCAAaAACCAACACcAAAACCaACcaaaCAAAAAaCCAACaCAA	BFFFFDFFDGG@EEA@EEEEGEAFBDFFFFFFFEFEFEAFDFEHB>FDFEEEEEEFECE>EHEDEEEEFEFHEECDEEDE@:DCBB=@CC@	A	55	C	36
5	138775173	T	47	cTCtctCTtctttctcccCttctcTTctccccTcctcttctttcccc	@BDGAGGFGBGGGBGBBBHGDBGBAFBGBBBCFBCGCHHCHHHCCB=	C	25	T	22
5	139940233	G	198	GGgGGAgaaaAGggGGggAAGaAAaAGaagaAggAgggGGgGGAAagAAAAgAAAgGagAgaGagAgagagAagGAaGAGagAaAAaaAgAgaGggAaAgaGgaaaaagaaaaagggggGAGGgaAaggggAaaaAaaAgaaGaagaGGAGGagAAAgGAAaGGagGagGGaaAgGaGAAGaaggGAgGaaAGAagGg	B<C7=ABBCDECFFDBDFF?>FF:EEEEFFFEFDEFFFDAFAEFFFFF@9FFGFFFEDBFFEDGFFFFFFFEF@EFFEEEGFFGFFGGEGDGEEGGFGFGGA>GFGGG7FFFGGGGGGGEEEDGFDGGGGG8GCF9GFEGFGDG?GGD;9DDGGECEGDBEGD@GGDGGDDEGEBDGDEEDGGGGDDGD=?FDEDCCD	A	104	G	94
5	140057216	G	63	AgGAAAGGAGGgGGGGGGGGGggggAAAAaGAAgGAaAGAAgAgGGGGAAGAaAGGGAAAGAA	AFGEFEGGFFFGFGFGGFGGG<FGGEFEFEFEEGEEEEFEEGEGFFFFEEFEEEEFGCCB=AA	G	35	A	28
5	140517431	T	75	CcCttTTctctccctCCCtcCtCCtCTCccccCtCtctTCTCtttTccttTCtCCtttccctttttcccccctcc	@C=BBBCAHBGBABGDDDGBDGDDGDGDBBBBDGDHBGEDGCGGFGBCHGGDGDDFHHCCCHHHHHCCBCCAF>>	C	42	T	33
5	140562073	A	91	CCcCcCAAAAACCACCAACAAACCCacCcAACAAAACCAAACCAAAcCCAACCCacAaccCCaAaCACaaAccCAcaCAAaaaCaAAaaaa	>BADA@HFGAHDCHADHH9HEH@DDEBDCHGDHHAHDDHHHDCHHFCCDCHDBCGCGFCCCC>GGBGCGGGCACGCGCGGGFFCGGF@B@;	A	50	C	41
5	140596162	C	79	CttcctcccCTttcccCTttcctcctCTcCcCTCtcCtctTCTCtcccTTcCTCccttttcCCtcCccccCCctCctct	=C<DDAEHG:GDDGGGDGDD?GDGF5DGGDGDFDEGCEHEGDGDEHHHGGHCG@HHDE=EHCCEH@H>HDCCHEBHE<8	C	49	T	30
5	140719090	G	389	AAAAAaAAAAGaaagGAAGGGGGGGGgAGGGAGaggAGgGaGAAAgAAGAGaGAAgaaAAGAAAAaaAgAGAAgaAGGAAGAgaAGAGGGAAagAaaggAAGgaGAaAGAGAaggaAaggGgaaGaAAGGGAGggaGAagaGGAagaAGGaggagAgggaGAGggaagaaGGgaGAgaAAGGGGAaaaaGAGAGAaaAGggaGGGAAgaaagaaGAGgagagagGgGAGggaaggAGAAaagGGGgggggAAAGGgGGAGgAaggGGAGagaggggAAgGaggGggAagggAgaaaGaggaagAAgaAAaaggaAAAAaAGgGgagagaGgaaaaGAGGAAggagagAggaAaaaGGgAGAaGaaaAGAaAAgaGggAAAggaggggag	B=B9C?>>>;>CEDCCEED:CCDECEBEEEEFEFCCFECBFDFBFCFFEEE@EE=CFFFFEFEFEFFECFEFFCFFDEEFEDCFEFF@EDEFFCGFFBBFBD@CEFFFEEDFFCCFFGCCECFFEFFFEEEFDCC8EFGCDEEFFCFCEEGBCEDBCCDFAFEBDGGDGGEEDFEF@GFFEEDDFGGGGDCEF@FGAFEDDGEEEE;DGGGDGGEFDDGDGDFDECEBECCGGDDFEFFGGDEEEDCCDDFFFEDDEEDDDEGDDDDEDGDGDDDDEEDCGDDCDDEDDD@DDBG8DGECEHEEEDGEEGGDDGEEEEGEDDDDEBECGDDGGGGDDDDEEDDGDGEECDGEGGHDC@EDDDDGGDDD<@CC@CA>>:AA?:=<<AADA	A	198	G	191
5	140774689	T	60	TTCCTCcCCCTtcctcTcTcTCCCCtCTcCCCTTTCctTTTCCTTTcTTCTtctCCCTtc	9ACD>GFGGGEEFF>GEGEGEGGGGDFEGFFFDDCF<FDDDFF<DCGDDFDFFFD5<B@D	C	32	T	28
5	141027462	G	45	gGagAAGagAAaGaAaagGgAAGGgGGGAGgGGGGGgGAAaGGGG	DCFCEFEFCFFFDGFGGDEDDEEDDEDDECCDDDDDDDEEFCBBA	G	28	A	17
5	141035955	G	79	gaggggAagaagaaaGGaggAAgaaAggaaagGgaGggagaaggAaaaAGaaagggggAgGaagaagGgggaggaGaag	A?6A@@AEBFGBFEEEEFCCEEC@F=CCFFFCECE=DDECFFCD?GGFEEGFGDDDDDEDDGGDGGDDDDDGDDGB@A:	G	41	A	38
5	141051236	C	75	CTTCCTtCCTTTTcTCtTCcTCCtTTTTTctTTTtTCCCCcTtttCtTTTtcCTTTtTtCCCccTTTcTcCCtcC	FCEGDEGGGEEEDBEGF<GAEE>HEEEEECHDEEHCFFFFCDHH@FHDADHCFDDCHDEEFF?CCCC7DBBCC<A	T	44	C	31
5	141335284	G	241	aggAgGAaaGaGGAGGagAGgaggGAGGGGaGGagggGGaAaAAaaGGAGGgGAAagAAggGAGggaaggAGaAAagAAAgGAaAggAGaAGGAGaGaaAGAAgagGaggAGAaaaGGAggaaAgAgagaaAgggGagAgAAAaagGAaggaggAaAGGGGgGggggGAgaggagGAgGaaagAGaGgggaAGggGAGGagagGgAAgGgaGaagAGaGAAAAGaaAaagggaAAGaagga	C@@@BFDFFGEFGDFFFCF=CFCCGEGGGFFGFECCCGGFFFEFDFGBFGFCGFAFCDFCCCFD@C=FCCFDFFFFCFFFDGFFF=BFFFFGGEGGCGECGFFDGCFGDDFFFGGGGGFDDGGBDF?DAGFF>DDG=DFDFFFFGDFEGDDGDCDGEGFFADFDBDDFEDFDDGDFEDEGGGEEFFFDDEGEF@DFEFFGDGB9DEEDEDGFDGDEFGFEEEDEGGD=FBBAAABC?B<AD	G	126	A	115
5	141337225	A	185	AGagaagGggggggaaAAAGgagGggGAGaggAGggaaaaggagaggagGagaAaaaaGGaggggaAAAGGaaagggGGGaaGAaGGgGAagaGGggagaagAGaAAaagaaaGGgGGAgaAgGgaaAAaaAaagAaGGAagagGAaAaaaAGaGaAgagAAGAgAaAgggAaaAagAAgggAGg	=;BACDB>BBCDDBFFGHHCCFCCCCCHCFCCHC@CFFFFCCFCFCCF@CFCFHFFFFACFCCCCCHHECCFCECCCBCBFFBGFBBC<HFDGCCDDGDGGDHCGHHGGDGCGCCDCCHDGHDAD=CGFGGGGGDGG;BGGD=ABFGGGGGGBHBGGDFDGEBGDGGGDDDGGGFG@FFA>9BA@	A	96	G	89
5	141364637	C	42	TcTcccctttccctcctccttcctctctcttctccccccttc	@D@HGGGDDDFFGDGFDGGDDGGDGDGDGDDGDFHGAHHEEE	C	25	T	17
5	142259083	C	39	AaCcCccAccAacAcaccCcCcaacAaCCaCacccaaac	>>BEFGGFGGEDGEGDGGHGGGEDGFEGGEGEHHHEDEG	C	23	A	16
5	145239283	C	51	GCGgCcGGCCCCCCGgCGGCCccCcCGCCCgcCCGgCCCgcGCGCgCcgcc	?FEDFGEEGFGEGGEGGEEGDGHFHFDEFFGHFDDGFEEGHDFCFGEE:@C	C	33	G	18
5	147486774	C	100	CcTtTCccTtcCTccCcCctccCccTTCttCcTCCTtCcctttCTcctTTTcttcttTtcTttcTttTCctTCtttCtctccctctttctccccctcccC	@:=C@D=ACHAGCBBFBGBGBBGBBEDGGGGBEGGEGGB?HGHGE=CHE@DCHHBHGEDCEHHBEHBDFCHDFFHHFHCHA@@GCHHHCHC=CCCH<A@A	C	52	T	48
5	147781732	T	162	TgGGGGgtgtttgTgtTTtgtTttGgtGtggtTGTtgTgtgTGTTtgtGgTtGGggtgtGgtgttTggtTTTTTTtGgggtTTgtTTgggTTgtTGgGggggGggtTGttGgtgTtGGGTgttgTtGTgggGtgttgTggttgTGttggGTgtTgtgTGtgt	B?CABDEEEDEEECFEE=EFDEEDHFEGEFFDAHEEFF=EFDIFFEFEGGEEHHFGEFEHGEFFEEGGFEEEDDCFHGGGFDEGFEEEEGEEGFEHFHGGGEGGGFCGFFHGFEDFFHHEGEFGDFGDGGGGFGFFHDGG;FGDGFB=GGDGFDGEECE>?C	T	82	G	80
5	147900574	G	33	gGttGgGtgggggtttgggtTgtggttgtgggt	CBAEFFGDDFFFFDBDFGGEFGEGEEEGEGGEB	G	20	T	13
5	147902703	C	59	AAAcACCACCAACAAACaaACCACAaAACCAACAacCaAcACACCaCACaAcaaACCcc	FH5DH8DHDCEBBGHHDEEHDDHBGFGGCCGGCGEECCGEECFCCFBFCDDA@>C??BB	A	33	C	26
5	148639062	C	32	CCCTCTCTTCTCTTtCCTCCCtCtCTtCTcCT	DDDGDGDGFDFC@FF@CDCCCF?FBEFBD@@C	C	17	T	15
5	148725199	A	26	AgaagaAgggAggaagaaaGggGgaa	<AEEBFFCDDACCGFCGGGED9DDFE	A	13	G	13
5	149008467	C	44	AccCaaCCcaaCAaaCCccCACcCAcccCaccccccccacCcAc	EBB@D7=DDECCHEEEDDDDHDEDGCDED:DEEEEEEEFECEG>	C	31	A	13
5	149226992	C	168	TCCTttTtCtcCcTccTTctCCCtCtTCcTTTCTCTtcTtcccCtTTCtCTctCTCCCTttCcCTTCtTTTtCttcCTtCcCTtctCcctcTtCCCtccCctcccttcccCccttttcCCCcttCTctCttTcTCTCCTTTCctCTTtcCctccCtTccctcTctttc	=?A=BB?B@DDFECE=EDFEGGGEGEEGFEEEFEGDEFEEFFFFEEFHDEEFEGEGGGEEDGFGEEGFEEDEGFFDDDFGGGDFFFGGGEGEFGGGFCGCGFEGG?CGCFAGGFFFFFFGG6FEFCGDFEFDFDF=FFD9DFGFF>DFCFGFGGFFD?GAEEAA@;>D	C	87	T	81
5	149278856	T	27	TCCCCTCCTcTCTCTTCTCTCTCCCCC	GGGGGGEDGCFGGD@DFFFFFFFFFCB	C	17	T	10
5	149546426	A	61	GAGGAGaaGAGGAAAAGGaAaGGAAgGaaAGgGGagAGAgagGaaAggGAGagagagGGga	>EAEFEEEDEEEEFBFEEEC@EEF?DEFFFEEDDEGCCEFFG:FEEFFDEDAFFGF?E>D<	G	32	A	29
5	149580819	G	38	agAGGAGggAGagagaGgAGaGgaggaaggaaggaagg	BBBDEDECCFEFCFCEECFEFECGDDGGDDGGCDEGB@	G	22	A	16
5	149584981	A	128	AAgGGAAAGGGAAaGGGGGAAaAAAAGAaGGaAAAGGGAaAAAGgGAAAaAGaAAGAagggAGAGaAGAGAAGGAAAAGGGGgGAAAGGGGaAAGAgAaaAaaGgaaGggAGGAgGAaaGGGAaggGa	DDFCCHHGC@CGHD;CCCCGHEHHHAAFDCCEHHFAACHEHFGBGBHGGBGBEGEBGEGEGGBBAFGBGBEGBBGGGGBBBBFBGGGABBBEGGBGGGEEFECBGCD?BE=@?FD>D?><<=B>@?CB	A	70	G	58
5	149602824	C	58	ctctttctctctttctttcctttctcCctTttttCcccccctcctcttttcctctctt	A=ACDFDFDEDEEEDEEEDCEDE>EDGDE@EDEDGDDDDDEFEEFEFEFFEEFEFCED	T	32	C	26
5	149907533	T	212	GtggGttggGGgTGTtGGTGGTTTGTGTgtTTGTgGgggtTGGggGGtGttGgGGTtTTTtGTTTgTGTGGGTttGTTGGGTgGGTgTttgTTtGtgggTtGTGggGttgGTgGGgTGTTttgggTgGGTTTTGTTtgtGTTTTGgtGtTtgtttTTggtGgTtgGtgGGGTtgtggtggtTggGtgGTGtGGTgggtGGttggtTGgtTTt	ECCC=A>ACDDDEFCDGHEBH9EEHEFCFEE>HEFHFFFDEHHFFI;EGEEHFGGBEADEFH=9BFEHEHHHEFFHDDGEHEGFHDGEFFGEEFHFGGDEFHDGGGHEEFHAGHGEAHBDFFDGGA?HGEAEEG=C;GFGEDDCH7FGFDFGB;EDAGGG>GDFG?FGGGFCFGFGGFGGDDGGGFFFDG<GGCGCGEFGFF>GFDFF?B@A	G	110	T	102
5	150158226	A	74	CaaAaCaacaaacaAAccCcaCaaaaccacCcacccacacacacAacaacaCcaaACAAcaCcacCcaaaccAa	A@AACEDDFDDCGDFFGGGGDGDDDDGGDFGGDGGGDGEHDFEGEEAEEHEGHEEFGCEHEFHBGFHCCEHFCB	A	40	C	34
5	150413219	T	53	TTTTTTTTTTTTTTTTTTTTTTTTTTTTTTTTgtggTTTTTTTTTgtgggggT	<FEEGGFAGG7DGG<GF:;GGGGGGF<C<>FFD???DDF>FFFF956CD8D7B	T	44	G	9
5	150413226	A	52	AAAAAAAAAAAAAAAAAAAAAAAAAaagagAAAAAAAAAaaggggAAggggA	><EFFBA6FDCEFFE<FFBA>FDE;DF?A9=EDEE7EE9@E:?87DDA9C@?	A	42	G	10
5	150415098	C	53	CCGGGCCCCGGGCCGGGCGGGCCCCcGggGcCGGcCCCCCGCCcGGGgcgGCG	ADCBCDDDDCCCCDCACDCAADDCCHBAGBFCA:HCCCACBCCHBAB=CACCC	C	27	G	26
5	150516887	G	27	gcGGCggGgggCCggcgcgcGgcgGcg	BAEEGCCECCCGGCDBDCDCEC@DD;D	G	18	C	9
5	150519670	T	53	TTTAAaAATTATTTATTATatTATATaTTtAaAaaAAAatATaATataAAtAT	?ADHHFHHGGHGGGCFGHGEFG>GHGGGGFGGGGGGGGGB?FGGFGEGGGEDF	A	29	T	24
5	150603444	C	63	CCGCcCCcCGcccGgcgCcGcGCggcgccgCGCCCCCCcggGCGCGcCcCCCGGcccGCcgGg	ADBDFD?ADAF=FCCFGAFCGCCG?GGGGGDACDCDD?GGHBCBCBFCGCCCBB?GG@BGA?A	C	40	G	23
5	150666962	G	67	GggaaggAGGAggggAgAGaaAgggGGaAAagGgaaaagagGgaaggaGGGGagggaaaggAaggag	B==BD@@:CDDC<CCFCFDFBFCCCEEFFFFCECFFFFCGDDDFGDDGEEEDGCDDGGGDBDGDDGD	G	39	A	28
5	150667016	T	26	ctttcccttCcttcctctttTccttT	=DEEFFFEBGEEEFFFGF;FEGFDD=	T	15	C	11
5	150905398	C	158	ccCTTTTtcTTcttcCTcCCTtTtTTTtttccTttTCcTCTTcCTcTCttCCcttCTtCCtttTtTttCTCTCttCTCCcCTTtcTccccTCcttCcttttTCccTTCCctCTtttCTTtTTctCCCcCTCctcTctTctTtTcCTttTcCcTtcTtC	:<<?BBEHBGGBEGBDEBDDGGGGGGFGGGBB?GGGEB?DGGBDGBDCGGDDCGGDGGDDHHGFCGHHDGDGCHHDGDDCDGGGBGCCC6GDBGGDCHHHHGCBCGECCBHCFHHGCCFHEFCHCC:CCFCCHCFCHFCHFGFCBEHHECCB@C>D@?	T	90	C	68
5	150917545	G	59	AGGAGaaaGgggGgGaGGAAGggAAAaaAgAgggAggaagaaaAAaaGggagaggaaga	?=?@?BCDDDFFDFEDDEFEEFFAF@DDFFFGGFFEGEEGEEDFFEEDDGFGEGGEEFB	A	30	G	29
5	154135802	C	29	tTcttccTctttttttccttcttttcctc	C>@ADGGAGDBDDDDDGGEECEADEHH=@	T	19	C	10
5	154282235	T	77	TCTtTTtCctctTTttTCTCTttCccTcccCctcCtcttTccTtcctTttccccCtCttcctccTtttcctcctttt	=ABCCDEEDDDEE>EEDGEG;EEEDDEDDCGDEDGEEEEDEDEEDE?EFFEDDEGEGFEEDEEEDFFEEEFEDFCAC	T	42	C	35
5	156650052	C	27	ctttcccTcctctctctTtccTccTtc	ACDCABBGBBG@G5HBHEDCCFCCFG>	C	14	T	13
5	157158414	C	35	AACACAAAAAAAACACCACAAAAACAAaCCCAaAa	EFGFFC>F;EFEEFEEEEDEEEEEFEEGFCBAABD	A	25	C	10
5	157285895	T	29	CCCCCCttttttttttttttttTTTTtTt	CBD@>DEF?FFFFFFBF?FFEEDADD9?=	T	23	C	6
5	167946076	A	33	GGGAGgGGAAGAAGAaAAAgggAaAAagAaGGG	HGHDGFHHEEHEEHEGDDDCGD>GDDGGDEHDD	A	17	G	16
5	168175205	C	59	CgGGGCGCGGcGCGCggGGCCCCggGCcGCGCcgCGCCCCGGCgCCGGCCCgCCGgCCg	GFEAEGEFEEHEG9GFFDDEF=FGGDFHDEDEHGDDDEFFDDFGEFDCDDEDAA@@C@D	C	30	G	29
5	169496051	T	65	CTCCTCcTTTCCCTCCTtTCCCTTCTCCCCTCTTcCTCCCTTTCTtTTcTTCTTTTcTCTCTTCC	GEGEEG?EDEFGGE>GEFEGFFDCGAFFDFDFDDFCDFFFDDDDDFDDGDDFCCCBGDDDGCCBC	T	33	C	32
5	169695440	G	37	CgCCcgGCGGcGGCCCCCGCCcGCCGGGCGGCGcggg	>CGFBCEEEEBEDFEFGGDFD7DEFDDDEDDD>:6DD	C	19	G	18
5	170380523	G	60	GGGAGGGAAAAGGAGGGGGAGGAGGGAAGGGAAAAGGGAAAGAAGAGGAGGgAGaAAAAG	BDHCHHH@EDEHHEHHHGH?FFEH@GDDGGFDDDDGGGDDDGDDGD5GCGFEDHB@7?AA	G	33	A	27
5	170827118	A	122	AaAgaaaGaAaGGgGAaggGGGaGGGGAgaaGgGGAggAAGgaaaagGgAGAaGgAggGGGgaAAAaaaGAggaaggGgagggAaaaAggaaaggaagaagaaggggggagagagaggaaaa	<:@ACDGFFFEGGFAFDFFGGGFEGFGFFFFGFGGEFFFFDFFEFFFGFFGFFGFFFFFGGCFEEFFGGFFG9GEGGFGFFGGFGGGFGGGGGGGGGGGGAGGGGGGD<GGGGGGGGFGECB	G	63	A	59
5	171217371	G	154	GGgaAAaAGGgGGAagAaAaGgAAGGGGGagGGAGGgGGggGAGAGgAaAAgggagGGGAGaGGaAAgaAAAaagGaGggAGAAaAggagaaGGGAaGGGgaGAGGaAAAGGAaAAggGGAgGGAAgAaGAgGAGaAAggAaagAgGGagaaga	BBC>AADECEEEEFDFFDFDEFFEEFFECDDEDFE@DDEFFEF?FEGFDFFFGGEGBEEFDEEEEFEGEFEFEEGDEDGGEDEEEFGEEGAEDDDEEDDDGCDECDEDBEDDEFEEGF@DEFDDEEGECDEGDEDEDEAGDEEGDFCC@=<@@B	G	82	A	72
5	172097353	C	55	CcctccccCTtcctccTcttcctTttctttcccctCTtttcctctccttttttct	DAACEDDCFFEDDEDDFDEEDDDFDEDEE@DDDDEF7FFEEECEFDEEFFEFE?=	T	28	C	27
5	172261489	C	69	AcAaAcCcACAAaCAaaCACCAaaCAcaaacAcAaAAacAacccCaacccaaaaacccacCacaaccca	@@<DAAECFG=FFGEFDGFDFFFFGDBFCFBAAEG?FGBEGCCCEGGCC?FGGGEC=CGCFE?FGCCCD	A	39	C	30
5	172461243	C	40	TcTCTTCTCTTCCTCTCTCCCTTTCTCCTTCCCTTCTCCC	@DEGHFGGGGGGGEGGGGGEGFFFF?FFFFEFECDCC@>A	C	21	T	19
5	172659511	C	39	CAACAcCACCAACAACCCAAAAAAAACAAAAACACACAc	?HDCHE@HDDHHDECCDCGGGGFGGGCGFFGFCFDFBCB	A	24	C	15
5	174868700	G	38	GAAGAGGAAAaAAAgaaAAGAGGgAAAGAGGAGAAAGG	BFEGFDFEEFFFFEFFDFEFEFFGEEEFEEFDFEBBB@	A	23	G	15
5	175307299	G	43	gggGcccGCGcgcgCgCgGggggcgggggccccgGcgggccgg	CCBABEDEGEDEDEGFEEEEFGFDFGFFGDEEDFEEFFG;DEB	G	27	C	16
5	177546990	G	46	GgggaaaagAaagaggAaaaggagaaagagaaaAAgggaaGgaaAa	BBCFEEFAFFFFFFFDFFEFFFFFFDFGG?GGFFEG?=BDDEDEB<	A	28	G	18
5	177547336	G	38	GgaaAggggGaaaagaaggGaAaagaggagGAaAGAGG	<CEFHCCCC>FFFFCFFDCAGHDG8FDDG@BGGE@E=@	A	19	G	19
5	177715291	G	42	AgGagGGAAaGAgGaGaGaGAaGAAAgggaGGAAAGGgggAg	F:CFC<EFFFEGCEFEGEEEFGEDFFDD7GCDEEECCA>8B=	G	23	A	19
5	177715581	T	28	CcTTTTCcTttCcttTTtTttTCTTTTT	AA?BAGDD6EFDDFFGGEFFFFCFEGGC	T	21	C	7
5	178373319	G	100	GgGGGGggCCGCGGCCcGgCCcCCCGCGCGGGCCggggccGCGcgGGGGGCCGGcCcCgCggGgCGcgCgCgCGcgGGGGCgCgcccgGgcgcGcGCCgc	DCGGGGCCGGGGGG>GBFCGGB@GGGGGGFGGGGCDDDCCGGG@DGGGEFFDEFCCCFDFCDFDFFCDFDFCFFCDFFFFFDFCCCCDF?B@?D=AAA:;	G	56	C	44
5	178413816	T	122	TTtcttTtCCTCTCCTtCcTTCtCTtcCCtTccTcttCcCTtTTCCTCTCcTtCTcCCCCtCtCTcTTTTCtttTtTttCTCctcTTCTCCCTTTCTTtTCTTtCTtCTCTCCTtcTctccc	B@GBGFG?DDFDGDDGGDBGGD9DGGBDDGFCBGCGHDCD7HGACCGC=DCGHDGCDDDDHDHDGCGFFFCAGHFHFHHCFCCG>FFCFCCCFFECFFDFCFFHCFFCFCFC@FG8E@>><@	T	68	C	54
5	178419288	C	58	CccCcCccCcCccccccccCCcCcccCCcCCCCCCCCTTTTTTTTTctTCTctCTCtt	BBBFBGBBGBECCCCCBBBFGAF8CC7FCEFFEFEFEEFEEEEEEECEEFD@CB?A>=	C	42	T	16
5	178504199	G	32	GgGGAaagGaGaGaGgagAGgGGggggggGgg	ECEDFFFCEGDGEGEDGDEDDEDDDEDDCDB<	G	24	A	8
5	178504201	T	32	TtTTGggtTgTgTgTtgtGTtTTttttttTtt	EEFEEFFEF9FGFEFEGFEDFEDFDFEFEDD@	T	24	G	8
5	178507069	T	69	TCTctctCctcctcctcTTtctCcTCcctctctTctCtcTttttccTcttctccctttctctttttttc	BA=BAEDFGDFEEFFEFBEEFEGCEGFFDFEFEDFEGFF=FEFDGGEGEFFFGGGEFEGFGFFEFFFF=	T	38	C	31
5	178565052	C	27	tttctTttccCtcccctctcttcttTc	CG9BGGHG;BDGC8C;GC?CHHCHHF?	T	15	C	12
5	178986978	C	31	CGGGGGGgGCGCCgCGgCGcGgcCggGgCgc	BHHEHHHFHGHGGFF??FGEGFBAFGGFGDB	G	20	C	11
5	179126090	C	33	CCTTTCCcCCcTCttccccccttccTcTctCCT	DDGGGDDDE>DFDFFDEDEEEFEEEF9?EBCCE	C	21	T	12
5	179260153	C	82	CtTtttTCCCcTCtCCTCcccTTcCTcCtCtCctCctttttCtCCTcCctcctcctCcccccccTcccctctccccccttcc	DAB?:ACDC:CGFEGGGGDDDGGDGGDG:GEAEEFDCEDEFGEGGGEGAEEEFEEFGEEEBDEEEEEEEFFFEEEEEEFBCE	C	52	T	30
5	179744009	T	246	TGgGGtGTTTTGGTgTttTtGggTGgGtTtGtgttgTtggGgTGTTGGgTTTgGTGgtTTGgGGGGGTTGggTTttttttGggGGGgTTGtTTgGGTgtTTTGtgGGTGGtGggGGGtgTTgtgGTTGTtTTtgtGtTGgGtGGtGgttgttTgggttgtTgGgTttgttgtGTgGGgttgTttggttggGGTTgtttTgTgggggTgTGtGttgttttttttgggGGgggggttgtgggGgGgGt	B?C6;C6B>@@?AECFGFGGBCCG;C>GGGBGCGGCGGCCCCG>GFCBCFGCCCHCCGHGCCBCDCCGGCCCGGGCGGGGCDCC=CCGGCGGG<CCGDHGGF?CDC@GC?HBDDCBCHDGGDHDCGGCGEGGGBGCHGCDAHCAHCDHHDGHEDCDHHDHFDBDFHHDBHDHBFD?BDHDDFIBCDFGDDB=FFDHHHFDFDDBBCFDFBHBHHDHHHHCHHFDDCBBDD8DCHFDC??>=<::AF	G	129	T	117
5	180338649	T	88	CtttCTcCCccttctctctCttCtccttTTctcTtTccttccttccccccttttcccctcctctctttctccctttttttccttcTcc	>BBB<>BGGABGGBGBGBGFGAGGBBGG8F=GBEGFBBGG@AC@BCCCCCHCH:CCC>EBCHCHCF@ECHCCCHHFHHEHCCHDCE9>	T	45	C	43
5	180374523	G	107	AGAAGAAAaGAAAGGAaAGAGgGGaGAAgGaggGgAaGAagAAgGaAaAAGGaAGaGaGgagaaGAGGAGGAGgAAAgAgaaAGAgaaaAGgGgagGAAAaGGagGG	CCAG<9HHDCCIHCCHDHCHB@CCEBHHGCEGGCFHECHEGHHGADGEHH?BEGCEAD@GCGEBBGBBGB<GBEGGGGGGEEGBGGDEEGBFBGEGBFHEA>==;??	A	57	G	50
5	180472513	A	185	gGgAAGAAGgaGgaaaGAAAgAAGGaAGGAGAgaAGGGgaGAggGAAAgagAGAGAaggGGGAaGagaaggaGAgAgAGgaaaAGGaaAAGAAagAGgGAaggAAGGaAGAgaaAAagGAAAAAAAGGAgaGGAGggAaAgaaaagAAaGaAagaaaGAGAAagAgGaGaaGaggGAGgagaaag	A>BGHC:GBCECCFFFCBHFCHHBCFHCCBCHCFHCC:CFCHC>CHHH@FDHCHCHGDDCBCHGCGDGGDDGCD8HDHCDFGE?CCGGHH?HHGDHCDCHGDAFGB@FHCG?GGGGDABGGGGGGGBBGDG=?GBD>GGGD?EGGDGGDBGGECGGGBGBBGADGDBHBDFB@DDBH@AD=B@A?	A	102	G	83
5	180480363	A	25	aAaagAaGgGaaaaggaagaGgGga	@BEDEFDEFDDDACFEDECDDGDEC	A	14	G	11
5	180480365	C	25	CcctCcTtTccccttcctcTtTtcc	?BEEFDGEFDDADEEEEFEF@DEDE	C	14	T	11
5	180486841	C	98	cctcCccTTctctTccCcCCtcTctCtccTctcCcttttttcTccttcctTTttttcctcCTcCCtttTTcTttCcTCTtCtCcctcCtcccctcccc	?@7CCDBFDEADDECD@DGGEDGDEGEDDGADDDDEEEECEDFD9FEDDEGG=EEFEEFDGGED>EEEAGEGFFGEEGGFFEF:E@DF@EEEDFEED?	C	53	T	45
5	180626927	A	131	AGGAGagaagGgAGGAaggGGAAagAAGGaGAGAAaAGgAgAAAaaAAaaggAAgAAaaggaAaaagggAgAGAGGGGgaaAGGgagGGGgaaGGagGGgGAaaaGaaAgaGGgggagggGgaAaAaGAag	CADB@DDCDCFGDFGFD<EGBFFEFFFGG7FFGEFEFGFFFF?FEEFEBDFAEFEEFFEFFEFFFFF?@FFFGFEGGGF?EFEFFFGFEFFFBFFFGFFFEEFECFDFEFFFFEFGF@GGFGEEDDA6B=@	A	66	G	65
5	180630667	G	50	agGaggaAaGAaagaagAgagaGaGagGgggGggaagggAGaAaggggga	C<?CFFFFEEEFEFFFFFFFFEEFEFFEFFDEFGGGGDGEEFFGGDGAGG	G	28	A	22
6	497520	G	106	cgccgggGggcGccCcgGccgcGCcggggcGgcgcggCcgGcCcCcgccgggcGcgGcGcCCgcgCGCcgcggCgGcgGcgcgcGCgcgGccggcggggcccgcgc	CCC?@@B>A@DDEDEFEFFEEFHGFFFFFFGFFFFFFGFFHFEFGCFFFFFFFHEFCFHGGGGGF=HGFGGFGGGHGGHGCGGGHGGGBGFGAH>AGDFFGGGGGC	G	55	C	51
6	2836266	T	169	TTTaATTtAaATAAaaTTTAAAAAtAATtTTaaATATaTAATTATTAtaTTaAaAaTTAAATTaTttatTTTaATTTATATatTTtAAattAtttATAtTaTTaaTAtATAtAATATATTattAATAtATAaaATATTAtATTAATaataAAattTAAATtAAaaatta	@AEG@FFEFEEFFFFFFFF@FFF?DEFFE@AEFFFFFFFFFFFEFADFGFDGFGFGFEEEE@EGEFFGFFFEFF@FFEEFEGFFDFEEGFFEFFFEEEFEGE8GGEEFECEAEEEBDDEEGFFEEE:FEDDGGDDEDDEEEEDCCCCCBC>A?9>??BBC>@@DDBCCC	A	86	T	83
6	2959513	C	171	CCTCTCTTttTCCCCCCCCTtCtCCCTcTTTtcCcTcTccCCCCccccccCCCTCCCTCtCCCTTCCcCCCTtTTTTtTCTCtcCCTcCcccCTcCCccCTCCTCtCcTCccCTcctCtTCttcttTCCTCTTTCCtTCttctCTttCCccTTTctccTtcCCCCttTctt	C>><CA=DGGFAEFFGAGGFGFGFGGFBEGFGBFBFBFBBFEG=BAABBCGCGFEGFEEGFG>FFFFBFGFEH;FFFGCFFEHCGFD6FCCCDDCDECCEAFFEFGFBFECCCDCCHECEEHH<DHEFEEFDEEFEHEEHHCHE>HHDFCCDDECHCCEHCDDBBCBB>@E	C	101	T	70
6	3264487	T	118	CctCttTTCtTcCCCTcCctctcTCCTtCTCCtTCTTcttTctTtCTcTcCCcCCctttTTCCcTCTCttCCTCccTTtCcTtCTTCCTcCCTTCctTTcCCtTCtttcctTCtTTTt	A@DE<FEFFGEBFGGFBEBGBGBFFFFGGFFFGFEF9BFHFCH?EFFCDCAGCFFCDGED@FFCDE@ECDFFEEAB7DHECEHCADFFDCFEEDECHEECEEHDFHHHBCHEEFC?A@	T	61	C	57
6	3264582	G	75	GGGgGGAAaGgAAgaagAggagagaaAAagGagGagagaaaggggggagaaagagaggAgaaaagaagaaagaga	>;=D66GFDC@H=FDDFHFFDD@FDDGFDFCDFCCGCDEDEAGGGGGEGEEEDEG>EGGGEFFEGEEEEEEAEFB	A	39	G	36
6	7390369	T	110	ttTtcCCTtCCtTtcccttTtcCTTTCTCCtccCccCCccttTttTTTTtCccCtTttcctTtTccccctCCTtTccTtcTTcTTTCCtttTctccTcTtTCtTCCtTTt	?B?D?BFCFGGGEGBBBGFGFBFAFF?FFFGBAGCCFFBBGCBHH<=AEHFCCEGFHFCCHF5FCCCCBHGFEHE>CDHBDECEBDDFH?HECHCCECDHEEEE?GBBAB	T	62	C	48
6	7605560	T	79	CCCCTCTCCCTTCTCTcTCTTCTCCcCTCTTTTTTCTTCTTtCCTTTTTTcCCTCTTCCTTCTTtTCCTTTTCCCCTTc	BGGGEGEGGGEE@<GEFAGEEFDGFGFDFDDDDE@FDDFADFFFDDDDDDGFFDFDDFFDDFCDFDDFDCCBBC<>A@D	T	43	C	36
6	7879407	T	52	ttTTtctTCCCCtTttTtTtccCtctcTTcttttcTTtctcCcTtcccCttt	AAAEDGDGGGGGDHDDGDDDGHGEH5HGGHEEBCHG>EHEHFHBEBBHFEEE	T	32	C	20
6	7910865	G	92	GGaggggagaAaaaaagaaagaaGagaaggaaAgggagaagaggaggagGAgAAGagAaaaAgaaggaagaagaggggAgGgAgagaagaaa	BBCC>>ABBC?CCCFADEEEFDEDDFEEFEEEEFEFEEEDEE@EEFFEEEGFEEEFFEEAEFGFEGFF;FBFFA@FFG?FEG@CBGAFG=9;	A	50	G	42
6	8054413	T	65	CTTCCTTCTTCCTtTcTTTCTTTtCTTCCCCCcCCCCcccCTcCtCTCcTcCTCcTTCttCCTCt	DEEGGECGEDGGEHDBEEEEEEEGGCEGGFGFBFFFFCCCFDCEIFCFCDCFDFADDEFCBCC?@	C	36	T	29
6	8411882	C	176	CctCTCTTCTCcTcCCTCCTTcTTCtcCTcCCcTCTCCCcCTCtCCCctTTccccCTTtCTcCcTTtCTCCCCCtcTCtCcTTttCtcCcctccTtttccTcTCttTtCCTCTctcCCTTCTCCTCCccCCcTtCCTCccTCTCTcttTctTcTCcttcTCtCTtCcccCccttTt	:DDGEGGG=F7DEDFGGF@EFCGGEEDGGDGGDGGGGGGDGBGFADGEEGFEEDEFGGFGGEGEGGFGGGGGGG@DGGDGEGGEFGFEFEEEEEFEFFCEEEFFFFE;FFFGFEDEFCFFFEFFEFFEEFFEFFFFFFEEFFFFE;FFFEEFEFEEFEDEFFFDBA@??A@?><CB	C	100	T	76
6	9750430	T	78	CCTTTCCTTCCCCCCTTCTTTCTCTTttTTTTTTTCCctctTTCtcccCTTTtTTCccctCCCCcCtTtTTCtCtTCc	>>E;FFFFGGFGFGEEFFFEFFFFFFEEF@EDEEEFDHEHEEEB?HHHFEEEDEEFGFHEFDEFHDEEEEACA@:AAC	T	42	C	36
6	10927390	G	112	GGTGGTTTGGGGTTTTTTGTGGTGTgTGTtgGGtgTGgTTgGtTGtGTtTTTtGTTgTgGtgtggggTttGtTTGtGTTgGgTttgTtggtTGgtggtTTtTtGTTTGTttG	AEGGEGGGGGGFGGDGEGGGGGDFGGGGGCGGGDFCAGGFFG?GG:EGEGGEEFFDGFGBEDEEGG5FEEF:FEFDFEECFGFED<FEGGEFFGEGFEEEDFEECD>B>=>?	T	63	G	49
6	11094681	G	27	TTgttgggtttggggGgTgGGGtgggt	A?ABDGEEEEEFFFFEFFFEEDCFAGE	G	17	T	10
6	11714806	G	99	GAgaAGaGGgAaaggagaAAgGAagGGAAgggaagGGGGgagAaGagaAAgagagggggaaaaagggaggGagAagagAaggaGagaagAAaaagAGgg	E?>A?ACABCCEEFFFEFEEFHEFFHED<FFFEFFBBHDFEFDFHFFECDFEFEGGGDGGGFGFGDGGFGGGGDFGGADGHFGGFG9G=DDEE@A>CAD	G	51	A	48
6	13801615	T	69	TCTTTTTTTcCCTCcCCttCtTTtTctcttCTtTCtCctTCTtcTcctTcTtTCcctTtctttttcccT	>=?EFEFEFBGGGGBGFAGEGFFHF6HCHHGFHFEFGCHFGBHCFCCHECFBEDBCHEHCHGHHGCCBC	T	42	C	27
6	17834213	T	89	TTTTCTTCCCtTTTCTtCTCTCCtTtTTtTTtctcTCCTCTCCtCtttCTtccTcCctTTTcCtTTTtTcctCCCtCTtCttCCtctTt	B@>@EEEGFGEFEEGEEGEG5GBFEEDEFEEFEFEEGGDGEGGEGEF:EDFEEEEFEFDDDEFFDDDDDEEFFFFDFCFFFFEEE?E@?	T	54	C	35
6	20115512	T	135	CtTcccctCctTTtCTCtCCTtcCTctCtcTCcttcCTCcCTttccCcttCTcTTtCCCtttcttttcccttttCTcTTCttTtcttTcccCcttttTcttTtcccccTtCtttTtcccTCCCttcCCcTccctt	>C;CBCCCFEDEEEGEGEGGEEFFEFEGEFCGFEDFGEGF?FEEFFHFEDGEFEDECEEEEEFE>FEFFBFFEFGEGDEDFFDFGFFEFGGGCEEEFCGFFCFCGGAGDFFFFFDFGGGCFDF?FGDE?DC>B?C	T	70	C	65
6	20481678	G	99	CGccCgccCcCggcGGgcgCGGggGccgCGcGggcgGccgcGggCGGccgccCgGCgcccGggggggccgGCgCGgCgcggcggCcCggcggcgcggcc	DBAA=BDCEDGEFDG=FDFGHHFEHDDFGHDHFFDEHDDFD>FEGHHDDEDDGEHGFDDDHGEFFGGEEFHGGAHFGGEGEEFFFEGFF?GEEFEEECA	G	54	C	45
6	22570064	C	138	tccctTcatCTtcCtctcTTtTCTTcttTtttctcctctTcTTcctTctTTccttcttttcttccCcttTttctTCTTTccCCCCcctcctctTttttcttctTtcccTtctTttCcctccTTtccCCcttccttccc	C?CC?B?DDCBDC?FBGBFEG=DGGBGGFGGGBGB>GBGGBGABBGEBGFEBBGFBGGGGBGFABG=GGGGGBHDGGFGCCGDDGCC9CCHCGGHGGHCHH>HGGCCCGHCHGHADCCHC;FFHCC;FAHCCCHCCB?	T	76	C	61
6	24174955	G	69	CGCCCGCGGGCCCCcCgCCgGcGgcGCcccCGCcCGCCcGGGcCGcCGGGGGgGCCGcGgCgGgGgGCg	;EGGGHGHH@FGGGFFGEGGGGHFGHGGGGFFFG@GGFGDFFHFGFFGGGGGDGFFGGGFFDGDE>D?D	C	35	G	34
6	24357796	G	102	gAAGGggGgaGgGaAGaAagAAgAAAGAAGGGAGGGAGGAaAgAGGGaGGAGaaGgAGAaGAGGGGgaaGaaGgAGAaGGGGaaagAAAagAaggAAAgAAG	@CBAACCBCFC<@FHCFHGCHHCHG;CHHC=CHCCAHCCHGGCG@BBGB;GBGGBDGBGF9G<@BBDG?BDF5DGBGGBBBBAHG@GGGGDGECCECD?BC?	G	52	A	50
6	24532578	T	30	cttctctttttcCtcctcctCcttcctccc	ACDFDEEEEEEFFEFFDGGECGFFFGFGGG	C	16	T	14
6	26104448	A	40	gGgggaAAggaaaAAgAggGgGggaaagggGaagaaGgAa	?GEFDDDEFF@DCEEFEGGHGGDGDBEGGFGEDGDEGEC@	G	22	A	18
6	26199822	A	105	aAaaAAAGGAAGGGGaagaAAGGGAgaaagAGgGaAAAAaaAggGgGaGaGGgGaaAAAGaGagaAgagGaAGaAgaAgGAAaagagGGgaaGggAgGgAagggg	C?@CBEFGEFFGGFCDDFDEFGGGFFDCAFFBFGDFFFFEEFGDGGGEGEGGGGEDFFFFEGEGEEGEGFEEFEEG@EGFEE>EG>GFEGEEFGGEGCAB><??>	A	55	G	50
6	26200256	C	43	cccCtttcTccccctTcccctttctttctttttttcttcttct	A>@CFCGAGBBBBBGGBBBBGFGAGGFBGGGGGHHC=HBHHCG	T	24	C	19
6	26240624	A	182	GAgGGAaGaGGaGAGAAGAGGAAGAAgAGAGggAAGAGAGAGaGAgAaGAGGAggAAAGGAGAGGAgAAGGGGGAGGGGGGGGGgaAAAAGgGAAAaGAGAGGggAAGGGGGGGGgGaaaagaaGAAAAAGGGAGgggGaAGaAGAAAaaAGGgGAAGAggGAGGGGgAAGAAAGAggAGGg	D>BF=FDGDGGDG?GF<GE?GFEGFFC@GFGGGEEEEGFGFGDGFGFEGFGGEGGDFFFFEGFFE>GBEFGGFFEFGFFFFFFFGEEFFFGGFEEEEF7FEFFEEE:FFFFFFFFGFEECEGEEFEEEEEFFFEFGGGFEEFEEFDEEEEEFFFFEEEDGGEEFEEEFEDCAAAAB?@A?@D	G	101	A	81
6	26271713	A	29	ATAaataattatTttaattttataatata	CC:CDEDE@EDEFEEEEFAFFFEEFBFEE	T	15	A	14
6	26444168	C	122	ttTctTcTTTcccCCcctctTCTctTTccttTTCCtcCCcCCTcTttcccTTTtCTCcTCCTTCCcTtTtcCcTcTCtCCtcttccTCttttccccctCttTCcTttttctCTTtCCcCccc	C?=@B?B=EEDDDGGDDEAEEGBDEFFDDBEEEGG=DGGDGGEEEEFEEEEEEE9EGEEGGEEGGEE:EFEFEDDEEFGFFEFFEEDFFEFGDEEEEFF=EDFEDFFFFEFFDCFFGDD@>>	C	62	T	60
6	26598188	A	100	gGAgagagGAAAaGAAaAAggGAgagaAGGAaaggaagaAGGGaAGggGGAGGGAAgggAaAGGAAggGAgaGaAagggGagGGaGgAAGAGgAGggAAa	A@?BDGDFDBF8DEFFDFF=FEEFDDDFEEEDEGGEEGECEEDEFEGGEEFEEECDGGGFEFDEDEGGDEGEDEEFHHFDEGDDEDG7EDDDG<DFCBB@	G	53	A	47
6	27279852	T	212	tCCCccTCCTccctTcccTTcttttctTTCTtTccccttCtCCctcttcttCTtTcCTcCTCTcCTCttccTCccctTCttttCCttCTtcttccctcTtccCCtctccccTTTCCCcTcttcCTtTTCtCCcTtccCtccTTTttcCTtCTTCcttCCcTccctCttTtTtCcTCttttTcTCtcCCCttccctttcCcttcccttccctc	C<????C@CFBBB>GBA@FGBFFGGBGBGCFGGB:BBDGDGDDBG<GGBGGDGGG=DDBCGDGBDHEGG?BGDBBBGGDGGGGDDGGDEG=GF=BCH=FGBCDD=CHCBBCDGF@DDCFCHGCDGHGG@GD=@GHCCDH;CGGFHFCDFH<@DCBHHCDBFCCBDCGGF9FHC@CCHHHHFBFCHCCCCHHCCBHFHBCCH;CBCGGB=BF>	C	109	T	103
6	34215228	G	46	AAAGaGGAGAaaaGAAaAGaaaGaggGgGggaGggaAAAgggGgGg	@EEEFEEF@>FFFEFEGFEFGADGDDDCDDEGDBBGEDEDABE@A<	G	24	A	22
6	35763786	C	73	cccCCccaccCcccaacccacccccacaAacacccccccaccAcaaacccccccaaccaaccaaaaccacaac	A?@=:BDDFFDGGGDDFGGDGGGGGDGDDC>DFGGG=BGDGGHHDEEHHHGHHHDEHHEEHHBFDEHHEHEEA	C	48	A	25
6	35764943	T	98	TcCtCCCcTTttCTcTTTcCTTTcTTcCCCcccCTTCCCcTTCTcTttctTtCcTCtCcttTttccCccCCttcttTtttcCCTcttTtCcTtTTcCC	B9@E7CDBGFGGDGBGGGBDFHGBG7BD>DCBBDGGDDDBGFDECEHHCHGHDBGDHDCHHGHHCCD@BDCHHBHBFHHHCCCFCHHFHCCDGFA8CC	T	50	C	48
6	36949527	C	35	cttttttttcccttttcctccTttccccttccctt	BFEDDDCEDDCDEEEEDDEADFFEEEEEEFEDEFF	T	20	C	15
6	36976901	C	25	aCaacAcccccacccaAaccaaaaa	?ACEAFDDDDDEDDDEH?8DEFFFF	A	13	C	12
6	37237544	T	256	CccCTTccctTtTttctTTCtctTCcctTtTCCctcttCTtcctCtCtccTCcTTTTTccCCctTTCTCTCTcCTtcTTCTcccTTCCctTCtcttcttTctcccttttTTcCTtCccCTttCCtttcccTTtttcCTctcttctCtCttccccttctccctttctCctttTCcttctTttctTTcCTtTCttcCccctCtTttccCctctCctTccttcttcCcttcctcctctccccttctttctcttcccttt	DC?B@>8>=D?CADE@FC>FHCGCFBAGEFDGF?GBFGGEGBB=GGGGB>EGBEEEDDBBGEBGEEGEEEGEBFDGBEEFDBBBEEGGBGEGGBGG=;GFBGBBBGFFGBEBDEGG=BGEHGGGGGGBB>EEHGGBGECHCCHAHGCGHHCBCCGGCHCC@HGGAGDCHHHEDCHHCHEHHCHECCGE;EGHCCGCBCHFHDHHCCFBHCHFAHDCCGHCHHCGCIHBCHCBHCHCCCCHHBHHHCHCGHCB;CBC	T	135	C	121
6	37349033	G	186	GAgggaAaAGaaGGGaagAaaggaAGaaaGgaGAAaGGagaAAGAgaaAagAGaAgGGaaGagAGGAGAgggAGAGGgGaAAggGgGgaAgGgaAGGaagGggaAAGGGAAGGGggGgaAGaaagggaAgagaAGAGAgaaaGggaAggaagGAaagaAgGggaagaagggaggAAgaagaAagGa	@E@AABDDF?FEBAABDFHEFCEDHCFFECCFCHHDCCFFFHHCHFFEGFFHCFH;C=GFCFFHCCFCHGCBHCHCCFCAHHGGCGCGGHGCGGHCCGGGCGGFHHCCCHHCCCDFCGGHCGGGGGGGGFGCBGBGBGFGGGBGHFGFGFFGBGEGGEGGBGDGGG:GGGFFFFFFGGGECDBA:?	G	94	A	92
6	37617657	G	80	gaaagAGgGAgGAgAAAAAgAAaAGAGGGGaaaaaaaggAaGaaGAGgGGgAaaAGGaAgagAagAGgaGagagGGGaag	ACDEEDHFGEFGEFEEDBEFCDE=DDHHHHGGGEGFDFFEDHGFGDGGGDG:E@DCGBDDFFDG:CGG7GAE;C?@B?;A	A	43	G	37
6	38771096	T	90	TtccTctCccTttcCTTCCccCcTtTctctccccccTcTtTcTTtTtCTcctcctCCTcCTCtCttTTTTtCCTCCtCtTCTCCctCttc	B?BA?BBCDDEEEDGEEGGDDGDEEEDEDEDEDEDDDEDFDEDDFEEGEDEFEAFFFCEFDFDFFEDDDDEFFCFFFFFDFDFFDFFC@B	C	46	T	44
6	38820451	G	114	AgAaaAaGAaGgAAAAaaAAGAAgagAAAaAAGAAagGAAAgAAAAGGGAGAGaAAGAGAaGGgGAAgAAGGaaAAGGaaAGaaGagaaGGGAaaGAAGAAgAgaGAaagagAg	CAHDFHFCGFCDHFIHFEHHCHGGGGHHHGHH;HHGECHHHGHHHFCCCHCGB@HFCHCFG@BGBGGGGEBB=GGEBBGGGBGFBEEGGBBBAGGBGGBGGGFGFAGCBBB???	A	73	G	41
6	38913177	A	68	GAGAAAAGAAAGAAGGAGAaGaGgAaaGGAGAGGAAGAAgAaAgAGaagagAGAGAGAAggAGAagaA	<DAFEFFDCF?BFFEDFEEEEEEGFED9EFEEDEEFB>EGEEEGBDFEGEGEDEDEDEEGEECDAFBA	A	40	G	28
6	38957771	T	49	CCTTCTTTTCCTCTTCTTTTTCTCTTCCCCTtTTCCTCCTTCCCCCTTC	DFFEFFEEFBBFFEEFEDEEDFEEEEFEFFCFEEEEDDC5CCCCB>CCB	T	26	C	23
6	39851818	G	87	aGAggGggagaaAgagaGgaAGaAGAagggGgagaagGAGggaGgGAAGaagAagGaggGGaagaaAagaggggAAGGAgaggGgag	CB>BCCFFCECCFFCDDGFDFEDFGFDFFFE=DFCDFGFGFFDGDGFEGEECFE>GEGDGFEEGEEFEGEGGGFEDFFEGF:FFFD@	G	49	A	38
6	41204049	C	25	TCTTttTCCTCCTCTCCCCTTCccC	;DGGEEFDDGDDFCFCC@CFFCEDA	C	14	T	11
6	41204092	C	47	CCTCCTTCCCCTTCccCcCCCcCTCTcTcCCcTtCTctCccCTcTCc	><8D@GHDDDDGGDEGDGCDDCCFCFFFGCCFFDCFGFCFFBEGDBB	C	33	T	14
6	41204094	C	48	CGCCGCGCCCCGGCccCcCCCcCGCGcGcCCcGgCGcgCccCGcGCcc	DCE>FCHGGGGHHCEGGFFGGDFGFGGGGFFCGAFGGGFGGEFGFEBA	C	34	G	14
6	41652604	T	46	cctctTTCCtttcctTtTTcTcCcCcCCCCCttccCtttccctcCc	CCBCFGGEGGGGBBGGGGECEAACDAGFGGGDFCCFHBHC>@C@B>	C	27	T	19
6	42016319	G	131	GGAggagGGGgGGGgGggaagggaGGAGGaaagagaaAgggGggggggagggagggAgaaaagaaagAaAaAgAgagaagaAaaaaggggaggAggaaagGgaggAaaagagGGAAaggagagagAgAAga	BBBC?A<CEACEEEBEBCFFCCCFE>FDEFFFCFCFFECCCECCCCCCFCCCFCCCECFGFFCFEFDBGEFFDFDGDGGDGDGGGGDDDDGDDFCDDGFCEDGDDE@EGDGDDDEEGDDGDGDGDEDEECC	G	72	A	59
6	42232475	G	95	GAGAAAGAAAgGGAAgGAAAgGAaGGGGAAaAAaAGGaAaGGaGaGgGGaaAaaAAAGGGAGGGaGGGGggAagGgAAGGgAgagggGaAGAAag	<FBHHH6HGHFCCHHFBGHHFBHECCCBHHGHHGHCCGHGCCGC?BFBBFGGGGGGGBBBGBBBGBBBBGGGFFBGGFBAFGGFFG<BFE?DDAA	G	48	A	47
6	42627434	G	137	AGAAAAGAGAAGAGGAGAGgAgGGAgGaAgaAAGgGaaGGGAaagAAGGAGagAgAAggAAGaAgaGAAgaggAgggaAGAagGAaaAagaAAaAaGaGGgAaaaaGaAagGggaGGGaGGGGAAagGGgAaagAgg	F<=@AC>FB9HBH<<HCCCEHECCHDCDHFEIIDFCEECCCHFE=HHCCHCEFFF::GFGHCFHEEBHHDFFEHGEFEHCHFG?HEDH@FEGGFGFBFBB>CFFFEBEGEFBC9F@BBFB@BBGGFFAAGF@E=B>@	A	72	G	65
6	42658949	T	59	TAtAatattAAttAttaaaATaaaTaTaatATattttaaatATaatattatttttttat	B=@DEDCDDEEDDEDDDDBEEDCCEDECCDEEDDEEEDDDEECEEEBEEEEBDEEEEDE	T	31	A	28
6	42672416	A	72	ttatttaAaaTAttaTattTAtaaaaattTtaatatAaaTtttttattaaAttaatttattaaattatttat	??B:ACDDEEGFEDEEEEEFFEEEED?:EGEAEEEEFDEFEFFFFEEEFEFBEFFFDFDFFBFFEFGEFFED	T	40	A	32
6	42931224	G	194	AGAggAggggGaggAGAAAAagAaGGGGAGaGAaGAagggAgGggGAaGGGAGAAAgagGGGGaGGggGaGAGGAGGAggAagaAGAaAgAaAAGgGAGGGggGgaGAAAgGaaAGAAGGGGAGGAAAGAAAGAAAGAaAGGGgaaAaggGAGGgGGGGagGAaGGAAAAgaAGaAAAAGGAGAGaggAAgGgg	=BAA@B@CDDEFBBFEFFFF@CFFE>EAFDFEBFDFFBCCFCEDAEFAEECFE:FECFCEDEEFDDCCEFEEDDFEEFDDFGDEF@EFFADCEEE@EFEDDDDEDGEDEEDDGGEDEEDDDEEEDEEBADEADEEED=GEDDDDGFEGDDDED@DDDCDFDDEGC6CEEDBGECFFCEECDCBCBB9>AA>B?A	G	105	A	89
6	42931261	C	241	CCCCgCCccCggCGCCGCCGccGgcgGCGgGcGgGGCcCGCCCccCcgCGGGcCggGCGGCCCCGCCGGGCGGGCGGGCGgGCCCcggGgccCGCCcCCCCgcCGgCCGGGGcgGCgGGGGCCGCGCgccGGcCccGGCCccgGCgcGGgggGGcCGcccGccGGcGGcccggCcGCggGGGGccGcGGGgggggCCCgccgcccGGGccccGCgcCggccCCCGGCCgcGggggGGCccc	DCC>BA8BBDDDE=FFEFGEDDEEDEEEECEDEEEEFDGBFHGDC?DEEEEEDFEEEFEEEGGGEGFEEECDEDGEEEFAFEFFGEFFEGEEGEFCEGGFFEEGEGGEEEEEBFE6GEEEEGFEEECGBECDDFEECEEFEEFEEFEDDGGGDDEF?EEFDEEDDEDDEEEFFFEDFFFDDCDE<DDDDDGGFGFFFEGEEGEEEDDDEAEEC>E?EEEEDGGFCC=A>9BBB>>A??BAC	C	122	G	119
6	43109751	G	106	gaAgGGgGggggagagagGagGagaGGAaGGgGGAGAAGgaaAgAAgAGgaAagaagaGAAGgaGgGgGgGagaAAAaGGagaGgGGAAgaGaaGaGaAagGAggg	CC>A??CEBCCCFAFCFCEFCEFCFEEEFEECEDGEFFECFDACFEBFEDGEGDGGDGE>FECGEDEDDDDGDG?EEG:DGDGDCDDEEDGDGGCGDFCD?ABC;?	G	60	A	46
6	43747450	G	109	AaGAGGgAaGAAAAAGGGGAAAGaAGGGAGAAAAGgaGaAGAgGGAaGAAGGAAAAAAgaGAAGgGGAaGGgGGAGAGggGAGGAAaGGgAagGAAAAGgAGGGGGGGA	BEE@AEC:FEFFEDFEEEEDBEEFEEE;CEFFFDEDGEGFEEDDDEGDEEDDADEEEEEHDEEDD@DECDD9DDEDEDDDDEBDDDDDCDDGDDFEECD@BCBCAAAAA	G	56	A	53
6	44269193	C	57	cTtcccTccTCctcCcctcccCcttTCcCtcccttTCctCtccCtcCccccCCCtTc	C?CCDFEFECGFDFFFFEFFEGEEBEFFG9FFEECEEGFGFGGEFGGGGGGFFDEC:	C	39	T	18
6	44270768	G	43	tGggtgGtttTgtgttTgttttGgtgGggGttGttTTTGgtTt	BBCCEDEDEEFEDEEE@FFFFFEGFGEGFDFEDFDEEDCFA?C	T	25	G	18
6	44279111	A	38	AaAGAaaAgaaAAGaGGaAaAggaGaaGAAGGagAgaG	BCFDFDDEFDDFF@CCDEE<F9GEDEEDEEDDEGE=?@	A	24	G	14
6	45480190	G	78	gGaGaAAaGgAaggGAggaGggaaggaagagAAaggAaGAAgaaaaggAagGaggagaggggaaagggaggggaggag	C<EAGH?FBBHFCCCGCCFCCCEFCCFDCFCFI=CCHFCHHDFGEGBCHGC=GDDGDGDD8DGFADDDHEDDDGDDG@	G	42	A	36
6	47649222	T	129	ggTtgtgtggTgTtTTTGTGTGGTtGgTGGgTTGgGGttgtGtGTTTtTTTGGgGTGTTTtttggGGTGGTggGggGTGGtGGtGTtGGGGgtGtTGGTGGGTGGgTgtTTTGgtTTTTTTTtGGTGgg	CC@7B@BBGFGEGDGGGACCGCCFDCGGCBEGGCGC<EEGCCECGGGEGG@CCFBFCGFFE>EGGACEBBFEGBFFBEBBCBBFBFEBBBBHEBEEBBFBBBFBBGFGEDEGACBCCDCAAC=CA??@B	G	67	T	62
6	47661387	A	89	GAAGgAGAGAGAAAAGGAGAGGGAGAAgGaAgaAAAAAGGGAGAGAaAGAaAAGGAaAAGagAGGAAGAGGGGAggAGGAAGaAAGGAA	FEFGFFFFH<GFFFEGDFGFGGGDFEEGGGEDGEEEEEEFFEFEFEGEFEGEEFFEGEE7GGEFFEE?EFEEEEGABFFDDFDCBC>BA	A	49	G	40
6	53364831	T	42	CCTTCTCTcTCCCCTCCCCTCtCCTTCCCCTtTTTtTCcTCT	GEGGFGGGHFFFFFFFFFFFFEFFFFFEEDEEFDFACBB?>C	C	23	T	19
6	53883843	G	42	GAGGGGgAAgAGAGAAGaGGggAgGaGaGaAAAaGGAGGAgG	>;BCCCFHHFGCHCGHCGACGCGG=GAEBGGGGGBBGABDBC	G	24	A	18
6	54002231	A	47	cACCcacaAcaaaaaaaaaAAcccacaAAccAAccaCCCaaACaAAA	?@BDGCFCFGDDDDDDDDDGFGGGDHEEEHHFFGHEFFEEEEEEEDD	A	29	C	18
6	55381262	G	61	AAGGGAGAGGAGGGGGGGGGGGGgGAgGGAaGAGGaAGgGGAAggggagGGAAGggGGAGG	GFCCCHCHCCHCCBCBCBCCCCCGBGGBBGEBGBBEGBGBBGGGCGFED?@DEAC<=CCC?	G	44	A	17
6	56482704	A	26	AACACCCCCCAACCACAAACAacCAA	EFEFGFGGGGEECFEFEEEFEGD>C@	A	13	C	13
6	56482801	C	150	GCCCCCGCCCcCgCCCGGCCGcGCCGcCgGGCGCGCGgCCcGGgGCcCcGCgCGCgGGCGGgGGgGgGGGccGgGggGCGgcgcCGcGcggCGGGGGgcGCcgcCGCgcGcccCcCCCCCcCCcgCCgGGGcCCGCGGGcCGCCCCgGgc	DDDCEFEGGGDGEGGGGFFGGDEFEGDAFGGBGGGFFECDDFGEGGDGCBGGGEG9AFFGGFFGGGFEGGDEGEGGFGGGEECEFEEGEGGFFFFFFCDFFEGECFFGEFFFFFEFFFFFDCFEFFFFFFFEFFFFFDFDEFGBCB>@CB	C	77	G	73
6	56496649	A	84	CCCACAACACACCACAACAACAACAACCAAcACACCCaaAcCaACAAAAaAcAacAAacacAACCAACCCCCAAAAAACACcAa	DBB:EEDGEGEGAEFEEGEEGEEGECGEEECDDDFFFGGDCFHDFDDDDGDCDGCDDGCGCCDFFCDEFEEFDCEDD7C@A>?@	A	48	C	36
6	56507135	T	55	CTTTCTCTCCCTCTCCCcCCCTCCTTTTCCTtCTCCTTCCTCCTCCTTCTccTCC	B=EEFFGFFFFFFFEFFHEGG6GDEEEEEEEEFEEFEEFFDFDDDFDCBC@@CC?	C	32	T	23
6	56557822	T	167	TcctCCCTCCtccTCtttTCtcccTCttctTtttTcctcCcttccttCTccCcTCtttTttctcTTcttCcTCcCtTCCTCCCtcTtTtCCTtCcCtcCCtCtctcctctcTttcCCCtTctCtCCCCttCttTcTTcTttccttTtCtcTttTcCTCTcCtccCCT	B?@B8A@<@CEFECEEDEEGDFEFEEEEFEDEEEEFFDBEFEEFFEEGEFFGFFHEEEEEEFDGEEFEEGFEGFGEEGGDGGGEFEFEFGGEEFGGEGEGFGFGFDGFGFGD6FGFAFFDGFFFEFFCEFCFFDGDDGDEFGGFFDEEFGDFFDEGDCCB9?;;BBA	T	84	C	83
6	56569104	A	44	AAAGAAaGAGGaGaaGagAAGAgGAaAAgaGGAGGAGaGGggGA	?EFGFFCGFGDDGEDGEGFFGFGGEEEEEEFFEFFCFEFFGB?@	A	23	G	21
6	57393199	C	39	cCCCCCCCCCAcaCaCacaCcAcCaaaCccccccccccc	>ACEFGGGFGEFFEEGDFGGGEGGE<GGGGG@GDFFGE@	C	30	A	9
6	62391015	A	55	gggGGGgagAggGggaGGaaAGaaggaagAagagagAGggAAgagAaagggaaga	CBFFFF>CFFFFGD@DGGDDFFDCFFDCFFDGCEEEEGFGFFGEEFEEGGGEEGD	G	31	A	24
6	62995920	T	45	gggtgtggtggtGTtttggttgggtgttgggttggtgggggttTg	@@A=CDEFDDFECGEEEFF=DFFFEFFFGGGF=GGDGGGGEF>CD	G	26	T	19
6	70589630	G	44	GcccgCGgCgcgcgCGGggccccgggggccgcggcgccggcccc	CDCECDHFFFFFFFGHHDFGGGGFGGGGHGGHGFHEHGGGHHHH	C	22	G	22
6	71665986	G	93	gAGAaagggGGGaagaGAAggGgaGaGAaggaAAGGaAggagaggaAAaaGggggaAAggAGGaaaGAgAGaAAGgaAAGgGGAgAgaGgggG	>C:>FEDDEACCEEDEC:FEFCFECECHCEEEHHCCED8EEEEGDDFGEFBGG=FFHHFG;CAFEFBGADBFBG;EEGGBFBBGF>@>>B<>C	G	50	A	43
6	74125888	A	91	AAaGaGaAGAaGaGaAGGAAAggaGAgaGgAgGGaAAGaGGaGGGaAAGAAgaaGaAAgaAAAgagagGAAagGagggAggAAAAggGgGa	E@C;ECFHCHFCFAFHCCGHHCCECGCF>?ACCBFGGBFCCFBCBGGHCHHDGG;GHGDGFGHDGDCDBGGGDBHBDBGDDGGGFDDADB?	A	49	G	42
6	75994151	A	134	AGAAGgAAGGGGaAGaaGgGAGAgAGggAGAagAGagaagGAAAaAGAaGGGaAaAAaAGAAGGAGAAaGAGAAAagaAAaaAGgagAAAAAAgAgGGGagggaGgGGAAaAAAAGaGggAaaGaaGGAaaggg	C?>@CDBFGG;EDFGDDGFFFFEFFGFFE5FDFFGEGCEFGFEFEFGFEGBEEFEEFEEFEFCFEGEFEFECEAEEG9EBEDDFFEHBDEEEEGEGFFFEGGGEFGEFEEEDEEEEEEEE>@?B??A?A?BD=@	A	76	G	58
6	76545684	T	67	TTtTCCCCccTCTCTtcTCTTtTTCTtTCtTTCccccCcctcCctTTtTctTctTCCctcTtttcct	DBCCEGGGFFGGGGGEFHGGCEG>FFFEGFGGG=GGGGGGEGFGEECFFFFFGEFFFGFGEFFFGBD	T	36	C	31
6	79595097	A	35	GGGGAGAAggGAAAAAaGagggaGGAGAGgAAAaa	6=CCH6GHDCCEHHGHGCGDDDG=BGBEBDBGGAD	A	18	G	17
6	79692751	G	51	AgAGAAGGAaGAgAAGGAGAGGAGGGGAgGAAGGggAGGaaGgAaGgGagA	=FGE?EAEFG@EGFFED<DEEDDDADDCGDEEDDGEEDDCG@GDDBA@@:C	G	29	A	22
6	79713390	C	25	cCAACCACACCACCCACCAAAAAAC	AEFECGFGEDFDFFAEFFEEDDCB?	C	13	A	12
6	79787655	G	28	AAAGAGagaagaAgAaAaaAAAagaaaa	?FFFEGDFDDFCGFFDF@EFEFBBEB>7	A	22	G	6
6	80196848	C	131	TtCTTcCTTtTTTTCtCccTCTCTTTTcCTTtTcTCtCTtTTcctCccTCcCTCTCCTCCtCTTTttcttCtCCtcTCCtCcTTcCcctcCtTTcTcCCCCcCCtcTTTtTtTTtCCccTTTttTtTCctt	CCB=BADFEEFFFFFEEDDFEFFEGGFDBFFEFDFEEFEFF;E@FGEDFFDGDEF5GEGGF?FEEFFEEFEE8DFDEFAFEEEEDFEEGFFFEEEDEFD<EDEEFEEEEFEFEEEDFEEBD6EBDBBA=AB	T	72	C	59
6	80228535	T	219	GGggggTTgtgTgtTTgTggGtgTgtGGggtTGGTtgggttGgGgTTTTGtgggTgTTGTgTgttTTtgTggGTtgtGtgggtTGgggtTgTgTGGtGTGtTgtGGGggtgttGTGtGTttgtggTTggtggTtgtTTGgTgggGGTgGtgggGTttgtttggttgttttttTtgtgtgtttGggtgtTtGttTTgtGtggtgtgttggtgtgTggttg	DBCC?CBABCC?CDFFFGFEFDEGEDGGFFEGGGGDBEFEEGEGFCCFEGDE?FGFGGGGEGEDDGGBCGFFCGFEEGEEFEEGGGGEEGFFFF>GEBGGFGFFGGGGGFFFFFFFFGDEF9FFGGFGF9GFGFEFGGGFEFGCGGFFGEFFFGGFEBEFFFGFEGDFFFFFFF?FGFGFFFFEFFFFFEFFEFFGFFE?BFGFFFFGEDFDDDDA?BD	G	111	T	108
6	80837253	G	64	TTGTTGTTGGGGTGTGGTGTTTTGTTGGTTTTTTTGTGTGGTTTTTTGGttTTTtggtGTTTGg	EDHEEBEEEHGHEAEGGDHDDDDGDDGFDADDCDDGDGDFGD@<D:DGF>EDDDCGGEGCD@@=	T	40	G	24
6	81053642	G	66	aggaaGgagagaaaagGgaggaaaggaagggagagggaaggggaggggagaagggggggaagggaa	CC>=ABCFFFEEFFFFEFFFFFFEFFFFFFFFFFFCFFFFFFFFGGG;GGGEGGGFFFGGGBGGGG	G	39	A	27
6	84108065	A	35	AAAATTTTAATTATTAATaATAAATATTTAtATAt	EEEEEC;EEDDDDDDDDDGDDDBDDDDDDDEDDAC	A	18	T	17
6	84284880	T	74	ATAtAattTTTTTtattaaTAatttaTtaTTAttatTaaAaaATTtTaatttatatAatAttttttataattaa	CB?A>CACFFEGGEDEEEEGFEEEEEFEEGGEEEDEFFD?FFDGFFGFFFDFFBEEFEEFFFFFFFFFE5FFF?	T	43	A	31
6	84884494	T	63	TTTTTTTTTTTTTTTTTttTTTTTTtTTTcCCCCCCCCCCTCCCCCCCCcCTTTTCCttTCct	EECEFCEEDEDEEEEDD@FDDDDDDFDDDGFFFFFDGGGGDFFGF:FFFGFCDCCCB@A>?DD	T	38	C	25
6	85139305	T	43	TTTGTGGGTTGTGTGgTtgTgttTgTTGGGtgTTtttTttgtt	GGFBGCCCGFBGC=CDGFGFGCFFBFFBB?FEFFFFEFFF@EE	T	27	G	16
6	87969737	C	170	tCCCTTTTCCCctTccCccttTCTtCtTtcCcctctTTTcccTcCtttcCttccCCcTTtccTCCCccctCccTcTTtTCttcttcCTccTtcCtTcCCcccCCtttttcCccccctccTTCtCcCtTCtccccCctccctcttttctCCTttCcTcCttttttTTccTC	?B@B@??BBFGFEEFCGFFEEGEFEGEGEFGFFEFE8FFFFFGFGDEEFCEEFFEGFEFFFFGG?EFFFDFFGGB<GEGGEFGFFGDGGGFFDGFGGEGGGGGGFEEFFGFGGGD6FBGGFFFDF;EEDFGGGGFFEGGGFGDBFFGFFFFF=FGFGFFFEEEACDB?CC	C	93	T	77
6	88182704	G	39	cGgcGGGgcCCggCCcGGCgcCCgcggCgCcGCCCcGGc	AECBEEECBFBDDGFAE?FD?EEDCDEEAFADFEE>EC6	C	21	G	18
6	88221103	T	60	TCCCCCCCCTTTTCtTCCTCCCCCCCCCcCCTCCTTTCTCCCCTTcCCcCCTTCtCTCCC	DGA@HHEGEEEDEGFEGFEE>GFFFFFFGDBDD=DCDFDFFFFDDGFFGFECCFFED9AC	C	41	T	19
6	89793894	G	93	cgGcGccCcccgGGgccCgcggcgcGcgCggGcGgccgggcgCccgGCgcgggCcgcggggggcccGgggccggccgggcccggcccGggccc	CC;@9BB@DDBGACECCDEDFEDEDCCEDFECDAFDDE?FDCDCDECDFDEGFDDEEFFFFFF?EECFDFAEGFEEFFEEEEGFEEDBEGEDE	G	49	C	44
6	89974063	T	61	CCTCCTCTTCCtCTcTCTCTTCTtcTCTTCcttcttTTcCccCTcTCcCctctTTTCCctt	<DGAD5EGGDDH8ECCD7ADGDGHCGDGGDCHHCHH@FCCCCCFCFCCCCCCHFFFCCCHF	C	31	T	30
6	90461123	G	138	AAAaagGgGaaAAaAGgGGgAAGaGAgaaGAAAGGAgAGGgGGGGAGaaAAAAaGGAAAaggaaGAAAgAAgGAagaAAagAAGgaAGaggaaAGAgaGaAGaAgGggGAGGGAaGAgGaaagggaaGgGAagAGAGa	CCADDAC:8FEHHFHBCCCCHHBFBHCFFBGHHCCGCHCCCCC6CHCFGGH?GECCHHHFDCFGCHHGDHH?AFGDGHHGDHGCDGEBGBDGDGBFD?BFG@FGDB;BB?BBBGFBGDBGGFDDDGEAC@DD>BCC?D	A	75	G	63
6	90468465	C	42	ACCACCAACACCCCAAAACAAAACAAACaCACCCAAACCAcc	CGHFGGEFGCGGGGFEEEFFEEEFAEEFEFEFFFDDEEEEFC	A	22	C	20
6	90497589	A	52	CCccaCCaAaAaaaccAAAcaCaacAaaaaAacaCAAaCccAaCCaCCaCcA	@CEDEFGDFDF;EDDDFFFDBGEBEFF5FEF=EFFFEFFEEEDFF:FF>E@A	A	30	C	22
6	90529343	C	85	TccctcttTtctTCtcttTcCcctTCCtCCCCCctTTccccTTttcCTcttcCCcttTcttTctccccTcttttcctTccctcct	DC89BABBCEDDGDDDECGDDDB?GDC?DDDDADDGGDDDDGEE=DDGD:DEDDEFFGEFFGEFEEEEFEF:EFDBFFDEED=9:	C	44	T	41
6	91266350	A	51	tatttataaTTtaaAaattaTtaaAttaaaTAtAttTATTattttttttta	=CBCEDDCDEFDDDEDDDDDEDDDCDEDEEE?EEE7EEEDEBCDEEEECD=	T	30	A	21
6	99353272	A	64	GGAAGAAaAAGAAAGgAgAGGGaGGGAGaaGGAGGGAGAGGGAGgaGAGAAAGGGGAGAAAGaA	EEFFEEFEFA@EE9EGFGFDEDDEDDFDEEDDEBDDEDEDDDEBFEDEDDDDCCDDDABBB><?	G	33	A	31
6	99781218	G	39	GGAGGAGAGAAGGAGGGAAAAGGAAGAgGGAgGGGGAAG	BBBEEFEFEFEDDEDDDEEEEDDEEDEDDDEDDCDDAAC	G	23	A	16
6	99825227	T	105	TCCCCTTCTCCCCTTCCTCCTCCTTTCCTTCCTTTCTCTCCCCTtTCCCTTCCTTTTTcTCcTTTTCTTCTCcCCttcccCCTCcCCTTCcccCcTCTTTCttCC	E6D9DGGCF@@DAGFDDFDDGDDGGGDCGECCFFFAFAFCDCCFFFCCCAFCCFFEFEFFAEDFFFCFFCFBECCFDEEECCFBECCFFCDDDCDDBFCCA?>CC	C	58	T	47
6	99825348	T	106	CCCctTtttCCTCctcttttCCtcttctcttcccTttccCccTTCCTctcctcTtCtCcTtctcTtccccttcTcctccccccccttcTctctttttctcctcttc	DADC?=BBCDDDECEDEEEEFGEDEEDEDEEDDDEEEDDGDDEECGEDEDDECEEGDGEEFEFEEFEEDEFFEEEEFDEEDEEEDFFECEFEFFFFFCFCA@E@@A	C	56	T	50
6	99852445	C	117	TTTCTCTCTTTTTTTCCTCCcCCCcTctTtCCTTcCCcttCCTTTTTTtCCcTtcCcttTTtTTCcTttTCTCCttcTtCCTtttCCcTTCccccTTCcCCTCctCccCCctcCttt	==CAFCGD@GGEGGGDEHDDG>EEGFGBFBDDDGHDDHECDDGBBGFDADDGGEHBGE@GFEEDAHDCEFDFCCEDGFEDCFEEFCCHCF=FFHHFFCHCCFCFEBHHDCFDDA?>@	T	60	C	57
6	99956560	T	120	CcTTCcTCTTtTCTCTCCCCCTcCTTCCcCCtCCtCtTCCCCcCTcctttctCCtCTCcttCTCCccTCtccTCCcTCcccTtCtCccCtCCctctttcccCtCCccccccttCttcCcc	;BAACGEGDDEEEEEEFGGGHDF?EEGGFG:DGGEGEEGG>FFGDFGEEFGFEGFGEGGEFFDGGFGEGCGGEGEGDFGGGCFFFFFGFFFFFFGFFFGGGDF5FGGG?FGDECAC@>?C	C	77	T	43
6	100895344	C	95	cCCtTTTCTCccCCtCTcCtTTtcttccTTCcTTTTtcTcTttcTcCctttccccTcctccCtCTccCTttcttttcccCTtttccctttttCtt	A>>A=?BC??C@GFEFE9GE?FED=EDDFFEEFFFFEDFAFBDE:EFEFBFEDDEFEDEEEFCGDEDCDEEEFFFFEEEFDFEFEEEFFDDEFB?	T	50	C	45
6	108026402	A	95	AACACACACaACcACACcCAAACCACacAACAAaCaCaACACAAAAAcAACccCAcccaaaaAccaAaAacAAAaaaAACCCACacccCCAccAC	?>BBEFDFGFFBBFGFG?G<FFGGFGFBFFGCFGGFGGFFEGFFFFF=FFGCCCECCCGGGGECCEEGEHCE@@GGGEEFFFEFFCCCFFE@;BC	A	53	C	42
6	108028967	T	29	TTTCCCTcTTCtTCTTttTTCCCTCTCTC	FGAD>DGEFFCFFC<FFFFFBBCFDD=A@	T	17	C	12
6	108224599	C	112	CccccccccccccccCccCccCcCCcCcCCCcCCCccccccCCccCcaCCccaccCccCaCcacccacccccccCccccCccCcccccccCcaccccccccccccccccccc	ACAC@BDDDDDDDCD<DE>FEBGD;GECDA@FE@DG@FGFGDDACDADEDGFDGGDGBCDBC;DEFDGH;C8BH?DG<G;HBDHAGHHG;DG<FCBGG7CHHGGDEHFCHCH	C	106	A	6
6	109629420	A	31	aatatattatatattatAatataaattatat	CEEFGFGGFGFGFEGFGFGGGH@BGHHF@GG	A	16	T	15
6	109761437	A	134	AAGAaAAgaAggGAAAGAgaAGgAGgaggAgaAAAAAaGagagaaAgAgaAgaAGAgAaggGAGaAAaAGgggaaaGagaaaAaggaaAGagaaGGaaAGgAGaagAaaaaaAagAgaGAGgaAagaaaaAaaA	C?B@C?<<EEDBE;DFFFCFFECFGCFCCFCFFEBCEFGFC=CFFFCFCFFDGFGFD?GCDGEGFFFG<G=DDGGGGGDDGFFGD@GGEGGDF>GEEGEFDEFEG>EDGGHHEHEEDFFEFDGEFDGGF8DCCB	A	86	G	48
6	109762236	G	26	GAGAGAGAGAGGAAGAGGAAGGaGGA	HEHD:BGEGEFGDCECG?DDGFGGF>	G	14	A	12
6	109764535	G	146	tGGTTGtttgtTtgGGgTGtTGGTGTTGGtTttTgtGGgTGGTGgTtgggGGggGttgGGgTTTTgTgGgTgggGgGgggTTtGgGttTTTtGtTttgTTGTtGTGTttGTgGgtGTGtgGgttggtgtgtgGtttGttggGGtgt	B@DEDDEGFCGDFCEDCEEGEEEFEEFEEGFGG5CGF:@FE@FECFGCCCEDDDDHHDECBFEFF>DD@DEDDCEDE?DDBFHACDGHEEEHDHEHHDEEDEADEDEHHDEDDDHBEDHDDDHF<DGDH@HDCHGGDF@><A@@=E	G	76	T	70
6	109815351	T	64	TcCccccctctTTCttcctcccccccctcTTcTccCTcCttttctccccttTttctcttcttcc	@B@BBCDDDDEEEGEEDDEDDDDDDDDEDEEDEDDEEDGEFFDEFDAEEFFCFFEFEFFEF?@>	C	36	T	28
6	109886005	T	65	TCTtttcTTCCTttCtTTtCttCCtCccTccTTctCtcTcTCtcctcttttcCcctcctttcTtc	BA<DAHBEEGGEGGEGFEGGEGGGGGBBECBCECHA:CEBEGHCCHCHHGHCF5>HCCGHHCE@;	T	36	C	29
6	111283791	T	119	AttTAAAAatAtaaaatTtattttaATAaaaTAaAataAatTtaTAAAaaaAAaTtattaaaaTttaaATattaaaaatattttataaaaattattaattaaattttataatataaaat	EACACFFCFDHEFFFFEGDFEEEEFGGHFFFGHFHFE@GFDHEFHHHGFFFH<FGEFEEFFF=?EFGFBGGFFGGGGGFGFFEFGFGFFGFFFBFCGGFF7GGFFFFFFDFEGEGGCBC	A	70	T	49
6	111346701	G	42	GaaGgaAAAAaAaGAAgAaAaAggAagGgGAaaagagAagaG	@@BC<DFFFF@FADBFGF<EDFGECEDEFDEEEEGEGEEGCB	A	27	G	15
6	111912641	G	119	TGTtgGgGGGggGttgTTTggtttgTtTTTggggggTGGgggtGTGtTTtTgtgtGGgGTgGTTtTTGGttgtGTtGtTGGgGTTggTTGtTTTGttGTTTgTTGTttGGgGTTgTTTG	CB<BA>=AABFEDDEEFAAEEEEDFFEFFFEEEFCEFEEEDEEEEEFDFFFEFFFEEG5FGEEFFFFEEFFEEBFDDFE;DGDEEECEEDFEEDDF=D9EEDEEDEEFCCBCBB8?BBA	T	62	G	57
6	111918865	G	31	AGAAGAGGAGAAGAGGAAAAAGAGGAGAGGG	FGEFDFGGEGFFFEFAEEEEE>E>FBFED:B	A	16	G	15
6	111918868	A	35	ACACCACAACACCACAACCCCCACAACACAAAAAC	AGFGGFGEEGFGFEGEEF?FFFEFBE;EFDDEBAB	A	18	C	17
6	112443134	G	29	GGAAGGGAAGAGGGAGGAAGGAGAGAAAA	DHEEHHGDDHDGGFDGGDDGGDGDGDBBA	G	15	A	14
6	116864570	A	106	CAaACAACccACcaAaAAccAacaCaaacACaaAcACcaccCACcAaaaacCcaCaaaaaaccacCacaccAaccccAaccaaCCCcacAAAaaCAAccaCccaca	>=CDFDFFGG9FCDFDEFGGFDGDGDCDFCFDDFGDGHEGEFBGGFEEEDGFHEFDEBEEDDHEGFEGEHHFEHHGHEEGHEEFEEEEHDE<EEEEEHHEEFC?<B	A	56	C	50
6	116950833	T	59	TCTcCcttttcTcTTTCccttctCTTttCCctCtctCttcctttctcCcttctcctccc	=<@EDFEEEEFGFGFGDAFEEFE>=BEFDDGF@FG?DFFG5FFFGEG@GFFEFGGFFFC	T	30	C	29
6	117215300	G	69	gagGgaaagagggaggGgGaAgggagaggggagaaagaggggaagaagaaggagggaaggagaaagaag	CCEGFCDCFDDFFCFFHFHDEFFFDFDFFFDDFDDDFDFEFFDDGEDFECGGEGGGEE?GEGEEEGEEG	G	39	A	30
6	117587054	T	62	cTcTtctctCTttCcCtctCtctCcccTTcTccttctccctccctcctcttccctccttctt	?9?CEEDFEGEEEGAECFEGDFDGFFFFFGFBGCDFFG@GFGG:FGGFGFDGG;<GEF<A=B	C	34	T	28
6	119177480	T	29	GAGAGAAAGGGGaGAAAAGAAAAAgaGGG	DICHCHH:BAABABBGGABGGGGDD=>:=	A	16	G	13
6	119300477	A	25	GAGAAAGGAGAAAAGAAAAAGGGAA	GFGFFEFFEFEEEE<EEEDFEBB?C	A	16	G	9
6	119510941	C	83	AccaaAaccAcaAAcAACcCAcaCAccCcaCACacACaacccACacACccaacAccCCcAAcAcaCcAaAaACaCcaacCAaa	BACCCC<>>B@GBH7HHCBDGBFDHBBEBFDHDFBH?FFBBAH6FCGC=CGGBHCBDB8FGCGCG;CGGGGGCGCCGGABEDB	C	42	A	41
6	119522353	T	107	TCTTTTTCCCTTCCTCCCCTCtTCTCCTcCCTTCcCCTCCtcTCtcTctCtTTTTCCTTCTTcTTTccCtTCtTTTCCCCCCCCcCCCCTttCtTcCctCTCTCtcc	A?BFFFFEGBDF;EF6BFGFFGFDEGFFBFGFFGCGFFFFHCEFFCECHFHFEEEFFEEFEECEEE=CFDEEHEDEEFFEEAFECFFEFEHCEHDCDBBCABB?E@?	C	58	T	49
6	121625832	T	26	ctCccctttcCccTCCTCCttCTcTT	EDGEBFEEEFFGGFGGGFFCEFFGFC	C	15	T	11
6	125232333	T	61	ttTtccTTttTCttCttTtTtTtCtCCTCTtcCCtCCTTttcctTTttTTCCtccCTcctT	?@FDFGFGDDGFDDGEDGDGEG5AECGFFFEGEG6GGGDBEHHEEEEECFFFDCGE?FHE>	T	39	C	22
6	125475139	G	188	GAAGaaAGGgGGaGAAgGgggGAaGAgGgGAAAGAaGGgAGaGgGGGgaaaGGAAAAaGGAagaAagaaaAGaGaaAGAGAgAGGAGGGggGAaAaGaAaaGgAgaaGGGaGgGAgAGAaGaagAAGAgggaGagggAGGggGAaAggAGAaGAAGAAgaAaGGGggGaAagGAgGGAggAaGAggGA	@BA=CCFBAECCCCCHFAFFFCHDBHFCFBHGH@HDCCFIC9CFCC?FDDDC=AGHHD<CBDGDHAGEEEEBECEE;BFCHGGCCGCCCGG9@@HACEHEEBGGG@EBBBEBEBGGGBGE8:EGEFBBGFGE@EEGGGBBBGBGEGGEEBGEBGGBGGGEGEAABGGAEGD@BGE?9CBBB@:BBBCA	G	99	A	89
6	126288023	T	64	CCTTCCTCCCCCTCTTCTCTTCCCcTCCCCTTTCTTTTCTTCCCCcCTTCcTCCcCCCCCCcTT	B@ECGHEGGFGGEAECGEGE=EGGGDFFFFDDCF@DDDFDDF7FFGF@DFFDFFGEFEDBCAA@	C	40	T	24
6	127471791	C	62	TctcCCccCcCTCttctttccCcccTCtcTctcCtTtCtctccttcctctctttccctccct	ABBB?@BABDEDFEEDEEEDDFDDDFFEDFDEDFEFDFF;EEDFFEDFEC;FFGFFEFE:ED	C	36	T	26
6	127768762	G	138	ggggaaAAAaAaGGGGgaagAGAAaGAggagAGAAagaggAAGGAGGgaggAAAGaGagAAGGgggagGGgggGaGGAAaaaGGAggGgGgAGaaggGagGagAGAaaaggAaaaggaaAgGGaaAaGagggAaAgAa	C?C>BA??>CBCFFBHEECFEHEEFHCCFFFEHEEEFFFFEEHHEGHFFFFEDDBFHFFEEGHGGGGGHHGFGHDHHEEFFFHGEGGGDGGBGGGGAGFFGGGDF?GGGBGDGGGGGGF@GDGDFDGGFGEFB?AB5B	G	71	A	67
6	128324241	T	54	TTTTCtCTcTCTTTCTCtTTtcCCCCcCTTCTCtCCTCTCttTCcCTcTTcCCT	DEEGGEGGDGEGFGE<GFGGFEGEFGEF<FFFFFFDFFFDFFFCEFF<ED@AB?	T	28	C	26
6	128841382	G	48	aAGAGAAAAGGAAAGGAAGGGGAGAGAGaAAGAAGAGAAAggAagAGA	DC;FECFFFDCFFFEEFEDDDDEDEDEDHEDDEDDEDEECDBC@>BA?	A	28	G	20
6	129571488	A	27	ttaaataAatattTatattaattttaa	C?BBCCD8GEFEEAEEGFDGFFBFFGG	T	14	A	13
6	129724942	T	189	ATTTTTTTTTAATATATATAtTATTATTTTtTTTAAAAtaTATaTAAATTATTaaTaattaTtTAAttTTTtAATATTttAAtATTAaaTTTTtAaaaTATTtTAttaaTTatTATaaatatTTTaaAAAAAaAtatattTATAaAtttAaATTaaaATTttATTTtAttttattTTTTttTTTtTttt	BA>@DEDDEEEEEECEEEEEEEEEDEEEEEEFF=EEDBFEEEEEEEEEEE<EEEFEFFFBFEFEE><FEEDFDEEDEEFEEEFCEEEFFEEEDFEFFFEBECEEEFFFFEEFADDEFFFEFFDDDFFDDDDDFDFDFEECDDDDGDEFEDFDDDFFFDDDFFDDDDFDFFFBFFFCCCC?FDEBA@<>C	T	114	A	75
6	129724944	C	189	CCCCCCTTCTCTCTCTcCTCCTCCCCcCCCTTTTctCTCtCTcTTCCTCCttCttcctCcCTTccCCCcTTCTCCccTTcTCCTttCCCCcTtttCTCCcCTccttCCtcCTCtttctcCCCttTTTTTtcTctctccCTCTtTcccTtTCCtttTCCccTCCCcTcccctccCCCCccCCCcCccccc	?A@BDCGGDGDGDGDGFDGDDGDDDDFDEEHGGGFGDGDGDGFGGDDGDDHHCGGGGHDFCGGFGDD?GFGDDDDGGFGGGD?GHHD:DD;GHHHD?DCFDGGFHHDDHFDGCHGGGHFDDCHHFFFGFHGFGHGHGFCFCFHFGGGFDFCCHHHFCCGGFCCCGFGGFFGGGCCCAGGCCCFA@AADD	C	115	T	74
6	129724945	T	190	TTTTTTTGGTGTGTGTGtTGTTGTTTTtTTTGGGGtgTGTgTGtGGTTGTTggTggttgTtTGGttTTTtGGTGTTttGGtGTTGggTTTTtGgggTGTTtTGttggTTgTGTgggtgtTTTggGGGGGgtGtgtgttTGTGgGtttGgGTTgggGTTttGTTTtGttttgttTTTTttTTTtTtttttg	DAAEDFEHGGHGHGHGHEGHGGHGGGFEGGFHHHHEFGHGFGHEHHGGGGGFGGFFDEFGFFHHFFGGGFHHGGFGFFHHFCG=GGGGEGEDHGGGGCGGEGHFFGGGGGGHGGGGFGEGGFGGGGGHGDFGFGFEFEFGFGGFFFFGGGFFFFGGFFFEGFFFFGFEFFGFDFFFFFFFFEEE?BA>>D	T	115	G	75
6	129762112	G	77	GagaAGgAAaggaaaggaAgGgAAaaaagaaggGGgGggGgaaAGGagaGggaaGgggGGggaaGgGAgaGggAGag	@ACCDAF:HDFFDDDFFDHFCFHFDDDCFDDFFCCDCFGCGDEHCCEGEBGFEECGGGACG:EEBFBGGEBGEFABD	G	45	A	32
6	129932648	A	43	CAAACACCAAACCAAaACACaCAACaAACACACaCCAaAacCa	GFFFGEGDEFFGGFFGEFDFFFEBFF@EFEFEFGFFDECBA>B	A	26	C	17
6	129937456	A	54	agggagaaaGaAggAaaGggggaagagaagaggagggAAgaggggaagAaaAaa	C?>CBFEEEDCFEFEDDEFFFFDDECEDDFEFFEEFGFFGEGGGGEEGEDEEE@	A	28	G	26
6	131148541	A	77	aAagaAAAaaggGGAGgGAAgGGGAGGgAggAgAAgGAAaAAggAaAagaaAGAGGaGaaaGGGGaGGaGaaAAagg	BBFFFFFFFEFFGGFGFGFEGGGGEGGGFFGFGFFGGDEGE6G<EGEFG?CEFEFFGFGGGFFFFEFFG?EACCAB?	A	41	G	36
6	131276473	A	27	aagaggagggggagagggagagagaga	CCFDFFCFFDFFDFDFFFCFDGEGEGA	G	16	A	11
6	132785224	A	170	AcCCAcCCACaaCCcCCAaccAACACcAcccAcCACCaaaaccAcCCCAAacAAcAcAcccCcacCCAcAAAcacAcAccacaCCacccaacaAcaACACCccaccAcccacCccACccaaccaacaccaAcaAaAaccacaCaaaaacaccaaaacaacaccacaaacc	B?BB>EEFCGCCGGGGG8DGGEEFEGGDGGGEGGEFGDDDCFGEGGGGEEDGEEGEDEGGHG?DGGG8GDEEFEHEGEGHEHEG@EHGHEEHECHDEGEGGH;DGHEHHH<HGHHBGBGEEHHDEHEHHEDHCDEDEHHEIBFFEEDEHEHHCDEEHEEHDH?DGDDCB>	C	92	A	78
6	134304023	C	26	CctctCtccCctTtttttCtcTtccc	@@:BGGGBBGBGGGGGHHGGCFHCC>	C	13	T	13
6	135299959	T	57	TctcttcccCttccttTccTCtCcTcctcttTtttcCCTcctCtttttTtttttccc	>CA<CC=>>?CGBBGEEBB>AGEBEBBGBGGAGGGCGGCCCHG=HHGHDHHHHFCAC	T	32	C	25
6	136977568	T	49	CTTttCTccccctCccctTccCcttTtttccctcccttCCctctTctct	@DDDDGDGGGGGDGGGGDEGGHGDDEDCEHHHEHGHEEGG<EHBDHECC	C	27	T	22
6	139576544	G	37	GAGGAGGGGAaAAGgAGAGGGaGGagGAgaGGgGgAA	HEGDEFHHHEEDDGGDFAGGEDGFEGFDGEFHCFCA?	G	23	A	14
6	139581461	C	159	TTCCCCcCcTCTTTCCCCtTTCTCCCTCCCTCTTTCCTTTcCTCcCCCCCCCTTCCTCTCTTTCcTTCTctCtTCcCcCTtctTCTCcTTCtTCTCcCTcCttcTtTtccCCCTcccCtTCttTCcCcccttTcTctctTTTcctCctcTTCtctTttt	@B:><<C<DDAEEFCDD8EGGDGDDCGDDDGDGGGDEHGGFEFEFDDDDD?DGGDDGDDDFFGDGGGDFGFCFFC@DBDGFGFGCGDGGGDCGDGDG7GGCFFGFFGFGGCC?FGGGCFFCFEFC>CGGGFFFGFGFFFFF@GGFBEFGEDCEFEEC>A	C	85	T	74
6	145124151	A	35	AGAgGGGAGGGgAGGGAGAGAAGaaAAagAgAAgA	EGFFGGGFGGGEEGDGFGFGFEEGGEEG;EGD@>C	G	18	A	17
6	146244743	A	42	GAAGGAAAAAGGgGGGGAGGgAGAAGAGGGGGAAgAGaAgAg	GFEFGFEFFFGGGGGGFFFFDEFEEFEFFFFEEEGEFGB@A@	G	24	A	18
6	146262697	G	112	TTGTTTTTTGGGGGGGGTGTGGTTTTGGTTgGgGGTGGgTGtGTgttTGTGTtGTgGGgGggtgtTgGtTTTGGGTGggGTTtGTGtGttGtTTGTGTTTGTGTgGtTGTTT	BFDEFFCDCEEEEEEEEFBEEEDECF9AFFGEFEEFBEGEEFEFGFFEEDEEFDCFECGDGGEFFEGDBDEEDDDEDGADEEFDEDEDFE@FEEDDCDEEDEBCCBAA>?BC	G	56	T	56
6	146755140	G	118	aaAGAAaGgggGGAGgaaAAGgAaGGgaGAgaGgGgAGGAGGGGAAGAgAGgaAagGaGGAaGGgGGGAgAGAGGGAGaAGAAGGAaaaaGggGGGgagAGAAGgGGGGggAaGagga	C?A:>ABDCCFGGEGFEDFFEFCEGGFEGFEEGFGFFG@FFEFGFFGFGFFFFEFEGFGGEEFFFFGFDGFGEF>FEFFEFEEEFEFEFFFFFFFF?FGEEEEEFDEDDBBB=??BBB	G	69	A	49
6	146755842	C	153	ACaAaACACCaccCACaaacCCaCCAccccCacCaccaCaacaccaCaAACaacACacCcAcccaCaCAACcCcccAcaAACAaAcAcacacaaCccacaCACAAaacCaACcCaaAcCAaCaaCacaaaCCaAaCcacAccCCacaccaccc	?<D;D;<;ABGB@DGDFEEBDDEDDABBABDFBCCBBFDFFBF@BFDFFHDFFB;DECDBHBBBFDFDHCDBDBBC;CGHGDHGACHC>CFCDGD@BFBGDHCFGGGC?GGB?CGHGCCGGCGFCFCFGDCCGGGC@G=GCBBBGB@B>?;;@	C	81	A	72
6	146993445	T	76	CCcctccCctTcTtccCtttTctTtttctctccCtttCCTtTTTCccccTTTtcCcTcttCtttctCCCtttttCC	>AEEDGG7GDGGGDGGGDC?GGDGDDDGDGCGGGDEEGGGEGGDGHHHHGGEEGGHFHEED6ECHCFFFE9EEDE=	T	40	C	36
6	148829952	G	86	CGCCCGcGGGGGGGGGcGGCGCGCGcCGGCcCGCCCGGGGGGCcGCGGGCGGGCCCGGCCGGGcccGGcCcGGGCCGGCCGGGGGC	B9DEEEBADE8FBEEEBEEFEFEGECEDDFCGEFF5?EDEEEECCFDDEDDB<FFED?EEA@DCC=DDC9CDD:FFDDEFCDCB@A	G	49	C	37
6	149903597	A	153	GaGAAGAGAGAAGAaAAAAAAGAAGGGAGGAAGAAAAAGAGGAGGAAAAAAgGGAAAAGGgAgAaGAAGAAAGgGAaaaAAAAAAAAAAGAGGgGgggGGAGGaAGgAGagaaGAAaaAgGAAaaaaaAaAaAAaggGGaaAgaaGAGaaAAg	?ADFFGAGEGFFGFDFFFFFFBBFGGG?:GFFBFFFEFGECGFGGFFFDBBGGFFFEEGGGFGFEGFFGFBFFGFDEEEEEEEFFFEE:FEFFGF?GDFFEFFBEFGEFDGEEFEEEEEGFEDCEAECEEDEDDDEEFFDDADBADBD@@AAB	A	96	G	57
6	151125724	C	30	AACCAACCCCcCAcCACAaAAAACACACCA	FFGDEE;C=@DFEDDECB@BABA=?>?>>C	A	15	C	15
6	151152257	A	107	ggGaGgGAggGgaAaaaGaaggagAGgagggAgGGgAAaAagGAaAaGAGaAAggggAgaggaagggAAGagAAAGagagaAgAgAAGgGAGgAAaGaaAAAAagga	>BAFEFFFDFGFEFEDEGEBFFDFFGFEFEFFEGGGEFEFDGDFFFFGFGFFFFFFFFGFGGFFGFFDFFBFFFEG7FDGDEFEGFEEGFEFGEE;F;FEEEB?A>C	A	55	G	52
6	151669875	A	41	gAGAAAAGGAAGGGAAAAGGGAGgAGAAAAGaAGGAAgAaG	EHCHFHG;BCHBCBGGGGBB?GBG@BGGGGBEGBAGDBC>C	A	23	G	18
6	151726756	T	28	TTTTCCTTTCCTCCTTCTCTTCtTTTTT	EEEDGADEEGGEEGCDFAEDDFFCDDD@	T	19	C	9
6	151789868	G	150	AaGgAGGGaaAaAGAAGAGAAGaAAGAGAGAGGAAgGagaGGAaGGGggAAGGgGGggGGAAAAGAAaGgAGGGgaGgagGAGaaAAgaAggAAaGGaagGAgGAAGGaAGGAGAAgGGGGGGagAgggGAGaGGGAaGgAGaaaaAGAg	CB@CDDDEEDFEEEFFEFEFFDEFFDFEEBFEDFFGEEFEEE@EEDEFFEBEEFEEGGEEEFFFEEFFDFFEEEFEEGFG=EEEFEEGDEGFEDFDDFFFDEGADBDCF9DDEDCEFDDDDDDFFEGGGDECFDDCDE@EECEEDCBBA>	G	80	A	70
6	152464839	A	95	AaGAgAAGAaGAgaGaGaAAAGggaagaAAaaAAGAGaAGaAaGAGAGaGGAaaagGaaGAGGgagAGGgAgGAagaaGGAAgaaaGgGaAAGGa	DC@BEFFEFCGFFEGEGEFFFG?DDCGEFFFECFEFGEF?FFFGFGFGEGGFFFFF:F@FFGFFFGDFFFEE@EDDFFFFEEF@EFFGEFDDCC>	A	55	G	40
6	152466582	A	32	GGGGAAaAGGgAGGAgAAGGGAAGGAGAGGAG	CCCCDHFGC@DHBCGDGBBBBGGB@GBFB>@A	G	19	A	13
6	152469331	C	129	tcctTTttCTcTctTcTctCtCtttCtttCCtttcttccTtCttttcCttTcttCttcttcCCtTCttcttctcTCtTCcCCTtTtCtCCCtTCtCcTTtTcTCCCcccCTCCTTcCTcttctctTcct	ACCB<ACD@EAGBFDBGBGDGDGGGDGGGDDGDFBGGBBFCDGGGGCDGGGBGGCHH=EHACAFEBHHCHHCHCGCHGDBDDGGDGDGCDDHDBFCCFFHFDFCC>CCCCFCCFF>CABHHCCCDE>=C	T	72	C	57
6	152658142	T	61	TtCcctCcCccCCcCCCCtCCcCTTCcTctctCtctcCctctTttccTcccTccCtcCctc	DC@DFDDFDF=DDFD@DD@DDGDGGDFGGFGFDFFFGCGFGDFFFGFFGEGFEGCEGCFDE	C	41	T	20
6	152671475	A	90	aCAaaaaCaaAACaAACaaaCaAAAAAaCaACCCCAcaaaCCaaccAAaAcacaaCccacAacACacccacAACcaAaaaCaccaacaCC	A=CCCDCDDCHHDDHHEDCDDDHHHDGDDDEDDCDHH@EECDEEHHGGEHGEHEDDGGEHFEHGCDHHGECGGCHDGEEECEHFDCC;AC	A	55	C	35
6	154771449	T	96	CTTTtTCtcTCcTCctcTcttCTTTTttTCccCTTTTTCCCTtcCTccCccTTtTCtCccctctctctcCCCctcctctttctttttccttccttt	AA<@EDCGBEDAGCBFBG7GFDHGEGGFEDBBDHGHFGDDDGG<DGBBCCC?GHGDHDBBCHCF:HCHCCCCAFC@HCHHHCHGHHGC=FG;?DCC	T	51	C	45
6	154897838	A	45	AAAaaAAGAAggaGGaagagaagaGgAgGAaagaaGAgagGagGg	D>EDCFFDF?FFDGGEDGEEEE:EGFFFGFEEGEEEEGEGFEGBA	A	25	G	20
6	155575546	C	120	CGGCGGCGCGCCCgGGGCCCGGCCgccGGCGCCCCCCGgGGGCGGGGGGGGGCGCCGGCccgGGGggCGCCCCGCGGGccGGCcCCCcGCCCGCcCCGGcGCGCGcGGCCgCCGcCCGGG	AAADCCD?D=DDBF:CCDDDCCC9EGHCCDCDDDBDDCGACCCCC<BBBBCACCD>BACHFGB?BGGCACCCCBCBBBHGBBCGCCCCBCCCBCGCCAAF@BABBGBB>BDA@=ACAACC	C	60	G	60
6	155579246	A	42	AAcaCcaaaacaaCAaaccacaacccAAAAacCAcaaCAaac	B@FDGGDDDD?CCGEDDG@DHEEHHHEEEEEHGCGEEFAEEG	A	26	C	16
6	155596901	T	97	TttccCTcTCcctCccTCtCCTtTcccctCccTtCtcCtcTTCTTCCCttcCtTtttCctttTtcttcTttttCTtctTCcCCTtccCtTctTtTCc	5C?>?@C@EBBAGDBBDDGCDGGGBB>BGDBBG?DGBDGBGGDFFDDDHGCDHG:GGDCGHGGHAHHCGHHHHCCH?IFCCCCFHCCCHFCFCCA?@	T	51	C	46
6	157405930	G	118	AAGGgAGGAAGAgaagagaagaGAagggaGgaGaAAgAaAAggAAgGGaaaaGgGGAGaGAgGGagaGGGggGaaggAgGGaAAGaGagaGAAaAGAgagAGGggGGaagggAAggAa	>A><@>??EFBGEEFF@FFFFFCG>F7FFCFECFHIFFFHHAFHHF=CEGCCCGCCHC:CFGCCGGGCCCGGCGGGGG8BBGGGBHBGGFBGGFG9GEDGGBBGGB@EBGGGGEB9A>	G	62	A	56
6	157963842	C	27	ccaaacaaaAaaaaAaaaaCCaaacca	<?FFEBFFFFFFFFFGGBGFGGGGCCG	A	20	C	7
6	158490779	C	34	ccccttccTCtTtttcctttttctttcccctttt	CAB@DDDDGD?GEDADDEEEFFEFFCEEDEFDF:	T	20	C	14
6	158541618	G	46	gaAAGggAGGaGagGgAagagagGgGAgaggAaaggAGgaaaaaag	@A@??DFFFGFGFFGFFFF>FFAFGFFGFCGF<GGEBFEGGAE??D	G	24	A	22
6	159188282	T	47	ggTTGGtgGGttGGTGGTGTGGGGGTGGTTTgTGGGGTTTTGGTGGt	AEGGCAEF<CF9<BDCCGBGBBB>?FBBFFFGFBABBFGEC>>C?@A	G	28	T	19
6	160106088	C	26	CcCacAccaAACCaccacaccaccaa	CDGDDCCDEEFGGAEEEEFEEDEEFE	C	15	A	11
6	160113872	A	73	GaaAgggggaaGaagGggggAaaGgggAgaagggGaagggaagaagAaaaagAgaaaaagggaaagggaagga	@ABAB9BDGDDGBEEGFFDEAEEBFEEGFEDFEECDDDFG?DFDEGFDF=FFFEFEFD7EFG=CDGGAECF@?	G	37	A	36
6	160174456	T	131	GGGGTTGGTTTGTTTtGTGTGTGgTTGTtGGGTGgGTTtttGGGgTgTGGGGtTTTgtGttTtGtttttttTGTGtgggGTgTGGTGGTTTgGGGGGGGTtggTGTTTgTTTgGGTTgtTTTTTGgggtGg	>>ACEDDEFEEDFFFEEFEE@FEEFEEFDEDEE8FDCFFFCEEEGDG9EEEECFFEGFDFFDEEFFFFFFFEDEBFEGGDEGEDDECDEDEFDD@DDDDEFFFED?EE@EEEGCCDEEFEDDDCDD?BAA@	T	67	G	64
6	160196343	A	83	gaggGagAAgggaaaAGAaAGggAGaggGgaAaagAaAagaaAgAgaaAggaggggagaaGagggaggggaagaaaagaaagg	CCDGFDFEFFFFCDDFGFDEGFFFCDFFFFDGDDFFDFAFDAEFFFDDFG?EGG>GEGEDGEGGEEGGGGEDGDEADFCC?@?	A	43	G	40
6	160229867	C	66	tCcCTctcCCTTcCGcTTTCTTCTTTTcCTCccTCtgtcTCtCctTtCTtTctCtTCTcttcCtTC	CA@FGAFB9GGEBGHBGBFGGFGGGGFCGGGCCFGHDCCGCHF:IFHCFHFCHFHFFFCHDAFAC9	T	34	C	30
6	160524773	T	85	ATAAAAATATATATTAaTAAATTTAtATAaAAaaaaAAaataTaTAAaATaTTaATTtTAAaaTaAatAttaTTaaaatTtaAAt	@?EEEB=EEEDCEEE?EDEEEEEDEBEB=EDEEEE@DEEEEADEEDDEDDDDDFDAD>DDDEDD@CEDD5E<DCCDEEAEA@<<>	A	53	T	32
6	160579527	C	66	CCCTTCCTTCTTTTTCCTTccTcCTTctTcCCTTCCTTcCCCCCTCCCCCtCTTTccCTCCCcCCT	?FEGGDGGGG8GDGGGGFGGAEGGGFGFFGFFFFFFFFGFEFFF;FFFFFF@EFFG?FFCFCC9CC	C	39	T	27
6	160888021	G	39	gtgtGtgTtGgTgtgtgggggtgggtGttTgttgGtttt	CAF9EEF=EFFECEFEFFEFFEGGGE@FF@GDFGDFFE@	G	20	T	19
6	161010766	A	98	TaAATtTtaAAtataTaaatAatAaaAAATTAattataatTttattaAttttaaaAttTaatATAatatAtttattataattTaaaTTaataatAtta	BBABCCFEDFEEEDEFEEEEFEEFEEFFFGGFEEEEEE5=GDEEEFEF@EFAEEEFEEGFEFEFFFCFFFFFFDD<F@EFEFFFFFFFFEFEEDFC=C	A	51	T	47
6	166579270	C	82	TCtTtTTCcTcttcCTCcTCTcTCTCTTcCTCCCTCTCtTtTTCTCCCCTTttTCTccTtCtcCTttCTTTCTcTTTCtCcC	C;?BCEGGDGDEEDG@BDDFFEFGEFGDE9GGGGGGGGFFEFFDFGGEFEFFECFEEEFDFFEFFEFEFFEE@CEEBGDC?A	T	45	C	37
6	166721211	G	71	GtGGTTtGGTGGGTttGgGgTGgGgggGGgGGtgGGGGtgGttgGTtgGggGGtgtgtTGgggtggtGggt	=BDEDCGEECEEEFGGECEC?@CDBBDEEDDDHC@EEEHDDGHDEDHDDDDDDDDEDHCDDDDHCADA><>	G	49	T	22
6	167622284	C	67	CcCcccCTTCCTCcttTcCcCccCcCCCTTcCCCcccctcccCcCccCCcCcccCcCccttCCcccC	B@GBBBEGFGGGGBGGGBGBGBBGBGGGGFCFE;CCBCBBCCGCDCCFF;FDACFCFCCBHEF@?;A	C	56	T	11
6	167728774	T	49	ttTtTTTTCtTccttTtTtTTTTTTTTCTTTtCTTCTttCtTcCtTCTt	CDEHGF>FGG<GGGGGHGHFEGGEEFEFFDFHFF>FEHHFHFHF@FFGA	T	39	C	10
6	167728775	G	51	ggGgGGGGGgGaaGggGGgGgGGGGGGGGGGGgAGGAgGggAgGaAgGAGg	CADDGHCHCFHFE;=FHGFHGHHHCHHHGHFGGGGDGAGGGGFGGGFGGGA	G	43	A	8
6	167754661	A	158	GGGGaaAAgggAgggAgagGaggGAAggagAagaagGgggAAagAGAgAagAAGGgGAaAAaGAAaGagaaaAgaagGgAAgaaGAgagaAgGaGgGGggGGaAaagAggaagAAgAaaagAaaAggGGaaaAgaaAAgAAAGgAAGgAGaaGAaaag	BBB=AC@?A=CABCCECFBEFCCEFDCCDCFFCFFCECCCEEFCFEFCFFCF@E=CAAFFFF@CCFEGCFFFFCGGDCDAEDGGBFDGDGFDEFEDE?DDCEGEGG?>DDGGDEEEEFFGDEGFEDDDDGGFEDGGEEDEEEDD<ECDDDFEC=DBA?	A	85	G	73
6	168349011	C	82	tTtCTTCcTCtttCctcTCtctcTTcctTCcttctTcTTCcTtTctCCttCcCTtCCccCtCCtCCCcCtttcTCtcTTTtc	<CF@C6GCEGEEAGDEDEG?DEDEEDDEEGDECEDEEEDGEEEEEEG@EEGEGEFGGCEFEFFFFFFDF;FEEDFFEDDCAB	T	42	C	40
6	168459790	G	40	GtTttGGGGtGGGTTtTgTGtTtTGtTGTGTGGgTGtgGG	GGFGGDHEHGHGHE=HEDE?HDH8?HDGDGDFGDDFC?;C	G	20	T	20
6	168459792	G	41	GaAGaaGGGGaGGGAAaAgAGaAaAGaAGAGAGGgAGgGGG	CFFEFEEEEEGEEDEFGFDEEGDG9DGEDEDEDDDECB@BC	G	22	A	19
6	168711170	A	56	gAAagaAgaagGgAgAgggAggagaAAagagAaaaGaaAGggaggagagGaaaaaa	<A@CDCECDDFFFFFFFFFFFDDADF9DFDFFEDEGEEFGGGDEDAGDGCFEEEEE	A	32	G	24
6	170592293	C	69	GGcGGcCGGGcGCGGcgCccgcgGgCCccgcgcgGgcgGcccGgcgcGgcgCgcCgggCgcCCGGCCGG	CEC@AABDDDBFD7HDE>DDEAFGFGGCD<DEDFHFDEHECEHGEFEHFEGGFDFGFFDFEDFFGEGEC	G	37	C	32
7	896142	C	45	TtctccTtcTtccCTctTttcTtTCccttccttcctcctcttttt	DCC@<>@>BDGBADFBGGGGBGGFDBB;ECCHECCH@CEAAE><5	T	26	C	19
7	939585	G	25	AGAagGgGGAGGAaGGAAAAAAGGG	CAHFCADCAH9BFDBBGEGGCE=A?	G	13	A	12
7	1097394	T	120	CTCctcCCctTCcTtCTctcctccCCTCCTtctCccTtcTccCCCTCcTTtTCCcTCtccCTtTCCcCTTCTttttTTCTCCTTCCtTTCTTTTttCCCTCCTCTTCCTcCtTTCTTTCt	ADDBGBDDBGGDBCGDGBGBBGBBEDHCEG9BGD@CGGCGBCDDDGDBEGHGDDCGCGCCDG:<CDBBGFCFBHHHFFBFCCFFCCHFFCEFFFHHC?CFCCFCFFBCDBBHGFCFDC@B	C	61	T	59
7	1476520	C	82	ccAcaccccAaAacCCcCCaAAaAAcaCcaAccCCCACacACaCccaaCcaCAacAcaAcAAacAcAcAaaaCaAACcaccc	?CCCED@DDCEHEDDDDDDEHHDH:EEDEE;EDC@DHDFEHDFDEDFFDEFCGBEGEFDEGGFEFEGEGFFFCEBFC?ABBB	C	42	A	40
7	1522157	T	49	CCTTTTTTCCCCTTCCTTTCTTCcCTCCCCTtCCCCtTcctCTTCTTtC	CCHHGGGGDDDDGGDDF>GCFFCCCFCCCCFHCCCCHCCCE?FFDFDB@	C	25	T	24
7	1528945	C	140	CCcCccCcccccccCCccCcCCcCcCcccCCCCCcCCCcccccCCcCCccCCCcCCCcccccccccccccCcCcCCCCCaccCcccCccCCaAAAAAAAAAAAAAAaaaaaaaaaaaaaaaaaaaaaaCaacAaaCcccC	<<9<CD?DFHHGGGBDGGDDDDGDGDGGGDDCDDEDADCGGGHD?GDDHH>DDHDDDHGHBGCGHH=HHHCH?HCCCCC5GICHHHCAHCCGHG?HCGG@FGGGGGFGFGG<GFGFGG=GCGFGG;@GCGG<DGEC>GDC	C	97	A	43
7	1528946	A	145	AAaAaaAaaaaaaaAAaaAaAAaAaAaaaAAAAAaAAAAaaaaaAAaAAaaAAAaAAaAaaaaaaaaaaaaAaAaAAAAAaaAaaaAaaAAggGGGGGGGGGGGGGGGggggggggggggggggggggggggAggGgggAaaaaA	@D=@?CBBCDDDDGFHEEHCHHEDFHFFEHGHHHEHHHFFFEFFH<FHGFFGHHGHH:HGFGFGEEGGFFDHGGGEGGGG7GGFAGFEEGGBFGFFECFFG?FFFFF6FGDGEGGGBGFEFFFCDF7FD<7GGFFFFFDG=F==F	A	98	G	47
7	1528947	T	138	TttTtttttttTTttTtTTtTtTtttTTTTTtTTTTtttttTTtTTttTTTtTTtTtttttttttttTtTtTTTTTtTttTtTTcccCCCCCCCCCCCCCCCcccccccccccccccccccccccTcctTCcccTtTt	DAC@CB?CBBDCFDEGDGGEGEGEEDGGEFGCGGGFEEDBEG@DGFEFGGGEGE;GFEFEFBFFBDFFDE>FFFFFEEEFFBFFDDEGC=EF=EFCEEEEF=DEDEDEEEEEDBEEEEEBEED?EFEE?CFEDDEDE?	T	91	C	47
7	1533513	A	91	aAGAAAaGAgaagGGaaaGAAagaAAaaGaGGaagAAgAAGAgGaAaaaAAagaGaaGaAAggAagAagaGAAaaaAAAaggGggagggaa	@AB@BD<FFFDDFFGDDDGFFDFDFFD@GDCGDEEBFGFFGFEGEEE@EEEAGEGE<FEEEGCEEGEFGGFEEEF>=EEEGEGFF@DEC?B	A	59	G	32
7	1533556	T	69	CCtTtttTTtctCttCtTTcTttcTtctCTTtttTTTtccCcctcccttCttttTCcctCtTcctctcc	:BFEFDCEEGBGFGGGGF;BE:EBB?CGFFBHFCFF5HBCGCCHBBBB:G8HHHFFCCGEHEBCHCC><	T	42	C	27
7	1536717	T	47	CTCCCCTCCTTCCCCCTTCTTCCtcTctcCCTTTCCTTTCcTCCTcT	B<FFDFEGGGEGGGGGGEFFEFCHCFCFCFFFFEFFFEEFBFFCB>C	C	27	T	20
7	1542814	T	66	tcCtcTttCCcttCTcCtTtcTtcccTttTTCtccttCTtttcctccTTcctccttttttcttcct	C?<B<@FGCBAGGDHBDGGGBGGB@BGGGGCDHABGHDG=@HBAHCCGGCCHCCFFGBHHAGGB>B	T	38	C	28
7	2414365	A	41	AgAaGAagGggggaaGGaAggaaAggaaggagagaaaagaa	CBDFC>ECCCC=CFFBDFICCFFGDDDGDDGAGDFGGGCDC	A	22	G	19
7	2419210	C	56	TCttCctTccttttTCttTctTtcttcccCttccctCcctcTttctcTccttctct	D<@B=?DCCCGFGG=CGGD:GHC=GGBB@DHGCCBGD=?H8FBH>HCFCCHHB7BC	T	31	C	25
7	2582153	C	55	cccCCcCCcccCcCccTTTTTTTTTTTTTTTTTTTTTTTTTTTtttttTtttTTT	DDDGFDGGDCDGDBEEEDDAEBEEEEFEEFDEEEEE@FEEEEEFFFFFBA?:BCC	T	39	C	16
7	2686455	C	31	CAAACCAAcACCCCCaCCCAAAaAaAACAAa	GFEFDFFFEFGFDFFFFFFEEEFEEECCAB>	A	18	C	13
7	4051677	G	54	GaGAGaAaGgAAAAaAAAgaAGGAgAAAaaGAagAGGGaAAaaaAaGGgGGaaG	CECHCEHECGHDHHFBHHEDHCCGEGHG7FCF<EGBBBDGGEFFGFBB7BA?=A	A	34	G	20
7	4107697	A	25	TttAattaaaTaAttaAttaaatta	ADFDFGGFFDGFFGGGFFGGG>HHG	A	13	T	12
7	4119285	A	25	aggaAaaaaagaaaagaggGAgaga	BCBCCE9EEEFBEE>>EFGCEGFGE	A	16	G	9
7	4171827	G	102	GTGGTGGGGTGGTGTTTGGGGTTGGGGTGTGTgGGTTGTGTTTTGGGGTTGGTTTTTTGTtTGGGGTGGTGGgGAGTTGTGTTTTgTTTggGGTGTgTGTgG	=E9EFEEDEFEDFDFDFEEEEFFEA9DFEFEFGEEB;EDDEFFFEDDDEEDDDEBEEDDEEEDDDDDDDEDDDDEDDEDED<EEDGD6DGGCDEBCCBBB@A	G	55	T	46
7	4189123	G	75	aAagAgaaggaaaGGaggaAggaGAaaAgaaaggggggaaaggagaaaGaGaaggaaaAggaggaaaaagggagg	>@CADBFACCFFECCFCCFCCCFCHFFBCEEFCC@CCCFDFCCFCFGFCECFGD8GGFFCDGDCGGGFGDDD<D?	A	41	G	34
7	4249626	G	34	GGtTgtTtGTTgGgGtGGTGttgtTtTGggTGTG	@=A=FDEEHEEGBGHFHHEGFFDFDDDGFGCFCF	G	17	T	17
7	4266963	C	40	TCTCTTTCCTcTcCCTCCcCCCCCtctCCCCCCcCCCCcc	CDGEGGGDBGDGDDDFDDE7DCCDF?FCCCCCCECCCB@?	C	30	T	10
7	4267072	T	88	AaataATtTTaaatAATTATATTTaTtTAaAATatTTAtTtAATtAtttTAtttAttATTtattaAataaAttaTttaAaattattta	=BBACCECEDCDDDEEEEEEEDEEDDCE<DE7DDDEEADDDEEEEDDCEEDEEEEEEEEECDEDECEEEEDEBEDEFADDEDEED@@6	T	49	A	39
7	7645806	A	108	GagGaggaaggaGgAAgaggagaaGaaagaaaaaagaagggGgaggagaaaagaGggaaaaggggaagagagaaaagaaagggaagggaggggggggaggggagaggg	ACC;@BBCDGFDDFEFFDFFDFD;EDDDFDDDDDDFDDFFFEFDFFDFDDDDFDEFFDDDEGGFFEEEEGCGECEEGBEDFGGEEGGGEGGGGGGGGEGFG<EGEAB?	G	58	A	50
7	14027829	G	87	ggTgggggTtggTTttgtgggtttttggggggTTTGtttttggttttgggGtgttgtggtgggtggtttgtttgtttggtggttttg	CB=6CFGFGDFDGDCDFDFFFDDDDDFFFFFFGGGGDDDDDFFDDDDFFFBDFDDFBFGDFAGCGGEEEFDEDAEEFGGEGG@EEDG	T	45	G	42
7	14789844	A	36	AaccaacaaaaAccCcccacacaaaacaaaaaacca	CACCDDGDFFFFFFFFFFFFDFFFFFFFGGGGGG?G	A	22	C	14
7	16445673	A	86	TTTATAAATAtATATaAaTaaTATTtttAtATTATTAATTAtaaAaTAAAAAttAATTTAtaaAtTTTaTtTtAaaATAAATaTaA	BA>@BEFFEFDFFFDDFCFDEFFFFDEEDEFFFFFEFFFEEEEDEDEEEEECE@FEDEEEEEDEEEEDEEEEBAEEDDEECDBB=?	A	45	T	41
7	16736479	C	56	GCCCCCGCCCGGCGgcCGGCCcCGGggcCCGGgcGGCcGCCCGGgCcCGGGCGCCC	8GGGFGE@FEDDFDD@FEDEEBFDDDDCAEDEBCDDFCCFFEDDDFCCC=CB>AA?	C	31	G	25
7	16793668	A	193	GGAgaGAgaGgaGGGAaAAGaGgggaaGGgGgaAGgAggGaGggGggGGAGgGGGaggAgaagGGAGagagGgGGGGGAgaaAggaGaGgGAGggaggggggggAAgAAagaggagAGaGAggGgaggagAggaAGAaggaggaaGGagaGAgGggGAAAAggaagAagaAAagaAgaggagAAaaAaaggga	@>;?C>CCDACEA;AFEHHBFCCCCFFCCCCC@HCCHCCBFCC>BCACA<CC@CDFCBH@FF:CCHBF?FCCCCC>@9HDF9DDDGCGBDCGCDDGDDDDDDDDGHDHGGDDDDGCECGCHADCDGDDGDH8DGHCFGDDF9AGGBBGDGBGDBDD?GGGGEDGGDGH9C@GEDFGCG;DBDGFFFDDC??>=	G	114	A	79
7	16816000	T	48	ttttcCCTctcCCtTTtcTttttTttCctcTcccctTcctccctcctt	CA?C@@:?@DFGAEEEEFEEDEEEEEGFEGE?FGGFEGFFGGGFGGFD	T	26	C	22
7	16899197	C	40	CTCtTCTCCCCTCTTTCtCtcCttctcctctccttcCcCt	>GCCFDGDDDDGDGGGDEDEHDEDHEHHEGEGGEEHCBCE	C	22	T	18
7	20444532	C	57	ccccCcTTttTtTtcttTcTcttctctcctttcccTCcttcCctcttctcttctttc	CCEDCFDEFFEGEGGGFEGEGGGGGGGGGGGHGGG6GGHGGGHHHHHHBHHFHGEHE	T	31	C	26
7	20444533	G	56	aaAaGGGggGgGgaggGaGaggagagaagggaaagAaggaAagaggagaggaggga	B>C@B7HFEHFHFFFFGFHFFFFFFFFFFFFFFEBHGFGEHGGGCGGGGGGGGGG?	G	32	A	24
7	21467812	A	34	CCaCCCCCaaaCCCaaCaCaCaaaaaaaaaAAAA	DDEDBC?DFBF7C5CF?FCDCBEFFF7FFDC?BB	A	21	C	13
7	21583282	T	48	TTtgttTGttggtGgggtGgTggtttttTgtTgGtggttgggtgtttG	C@?DDEFCEEFFECFEFEDFGFFFFEEEGGFGF=CFEFFFFGFFFF:A	T	26	G	22
7	21640618	C	102	ccggCgcgggGCggcggGccgcccGgccGgCggccgGccccgggGGgGGGCcccccCGGcCgGgcGgGgcCcCCccGggggCgGGcgGCcggCGCgCGGggg	CCC>?ABAACHFFCEE;HEFFFFFHFFFIEGFCFFFHFFFFFFFHHFHHG@GGGGFGHHGFGHGGHDHDGEGFFGGGG?GGFGGGFGGFGGGFGCGFGDB@?	G	58	C	44
7	21727186	A	57	AaGAAGGGaaGgaGaGAGgaggagaAggGaggaagggaaaggagaagggagaggaag	CCAABCFGEEGEEGEEFAFEFEEEEGFFGEFFDFGGFFFFAGFGFFFFEFCF@FEDA	G	31	A	26
7	21857776	A	25	TTATATTTTAATATAATATAAAAAA	GGEGFGFGFEEFEFEEFEFEDEFBB	A	14	T	11
7	21939089	C	47	acaacaaaccacacccacCaacccAcaaaccaacacaCcccaaaacC	C@B=AAABABDDEACDDDDEEDDDHDEEEDDFFEFEFDE6EFEEDEA	C	24	A	23
7	22202196	T	36	attATaAataTTaAtttttTattttatttttaataa	CBFFGFFFEFGFFFEEEEEEFEEDFGFFEFE@GFG?	T	22	A	14
7	22896363	G	44	ccCcggcggCcgCccGccCCCCgggcggccccgccccccgcccc	CDC@DFCFFDAFDDD6DCDDADG@GCGFEEEEF;EEE>E>FCD=	C	31	G	13
7	23347414	A	89	ACCACACCCCACCCcCCCCCCCcAcCCACCCACaCCCCCCCACCCCaCCACCCCCccCCCcACACcCAaACCcaCCCCcccCCCAccAC	=GGFGFFGHDEGGGHDGEGGGGHEDG<>FFF8FEFFFFFFF:FFFFDFFEFFFFFHHFFFHDFDFHFEEEEFGCFFFDDDDAABAC@A?	C	70	A	19
7	23602915	G	48	AAgGGAaGAgAGaGGaGaGGAgGaAgGGgGagAGaGgAAAaaGggAga	>FCGGDFGECFGFFGGGGGGFDCGFDGB>GGDEBGFDEEEGGFDDC>D	G	26	A	22
7	25266400	G	170	AAaGagaaagGggggaggGGGAgGAAaGgggAagaAGgGggGGaggAAaAgaggAgAaGAgaaaggaagagaGAgaAGAgaaGAGGggAaAaaGaAAgGggAAAGGaGAAGgaAaaaaGagAGGaAaGGggAGaAaggGAgAaGgGGggGGGaGGGGaAAaAgGaAGAGA	?>D>EBCDEBECBCCFCCDDBFCEFEFECCCFFCFFDCECCEDFCCEFFG;CCCFCFFE>CFGFDCGFDGDGBF:GFDEDGGEFEDCCDF<=FE<FEDCDCEEFDDGEDEEDEEGGGGDDEEBDGEGDDD5EDGBFDDAECEGDD:CDDCDC@DEDDFCCCB?A>A>>BA	G	88	A	82
7	26224068	A	28	GGGGAAGAAAAGGAAAAGGAGAAAGGAA	GGGGFFFDFFEBGEDEEFFEFEDDEEAA	A	16	G	12
7	28857606	G	51	AGGAAAAAAGGGAgaaAAGGAgaAAAGAAAGAAGgaGgAGAgGGGGGaaga	@@GEBFEEFGGGEGGEFEFG:GGEEEBEEEFECFGFFGEFEGFEGBB@<AB	A	28	G	23
7	28858456	A	86	aAGGgGagGgGaGAGGagAAaGAGgGGAAaAGAGGGagagAggGAaaGAAgaagagaagaAAagaGgGagaGggagggggGgGggA	ABEEEGDDGFGDGFGADFFFDGFGFFGGGAFGFGGGDFEFFGFGFDDGFFGEEGEGE@G;FFEGEGGFEGEEGGEEBGGGFGEGDA	G	49	A	37
7	29111879	C	26	GGCGGGCGCCCGCGgGGGGCcGgGCG	8BDC?CDCDCCBC?FBBBBCGAFC@A	G	17	C	9
7	29606316	C	35	CCcCCAcAccccacaccaacaccccacaccaaacc	A?@BBFDHDDDDEDEDDEEDEDDEEEDFEEFFFEA	C	23	A	12
7	30113706	A	233	GAAAGAGAGAGAAGAGGGGGGgGAAGAAGGAAGGAGGAGgAGGGGAAGAAAAAAAAAAGAaAGAGgAAAgAAAAAAAAgAGAaGaGGAgGGaGAGGAGGGAaaaaAAaGgGAGagaGAAaAgggAAaaGGagaaGAGGagGGGAAAgaAGGAGAAgGAGGAaaAGGaAGGAGgGGgGAgaaAaaaAAAGAgaAAaaGAAAaaaaaaAaaGAGaaAGagGAAaaGgggaGaagG	@>EC=<;A>B?GA;FC;@CCCFCHFCHH8CHH@CE8AHAFHBCCCHHCHHHHHHHHHHCHGHCGBFGHHGHHHHFHHHGDBGG@DBBHGCCDCHCCHCCBHFGGGGHGCF;HCGGG;HGFGGFGHHGF=BGGGGBG5BGGABBGGGGGGB?GBFGHBGBBGEGFBBGGBBGBGABDBGGFFFGAGEGGAGGGGGGDBGGGGGGGGGFEECGBE@EADD9DDAA=BBA?<?=AC	A	133	G	100
7	30492237	C	135	TCCtTCTccTCtccCcctcTcctccTCcTtctCcTTttCCTTCTCTCTCCcTTctTCcTtCCCcTTcttCCCTTctTCCTCcTCTTccCTTCTcTTTtcTTCcCTcTCtcctCttTTCttcccccTCtTcTtCtc	ADAB?FBCACGGBBGBBGBEBBGBBEEBFGBGGBEEGHFGDEFEDEFDFGCEECGAGCECFFFCECCHHFFDDDCHDFDDFCDFDDCDFDDFDCDDCHBDDF6FDCDFHCCHFHHDDFHEBCCCCECDB>B@AB=	C	70	T	65
7	30536874	G	58	AggAGgAGGAgGgGAAaGAaaGAAgggGggaGGaAAgAgaaaAaagGGaggaaaaagg	ACAFGFFGFFFGFGFFCGFDEGEEGGGGGEEGGEEEGE@E?EEEEEFFDGGEEEACDB	A	29	G	29
7	30705105	G	32	GGGAGAAAAAAAAAGGAAAGgAGAaaGaAAaG	EE9FEEFFEEFEDEEDEDEDDEDCFGA>C>@C	A	21	G	11
7	30739525	G	26	AGgGAAggaaAAAGaAGAaAGGGAga	HCDCHHFAFFHGFBFG5GFGBBADFD	A	15	G	11
7	30912007	C	35	aacccCcccaaccacaaaaaaccaaccccacaccc	CCBEDBFBGDDFGDGDDDDDDGGDDHHHHEHEEHE	C	20	A	15
7	31102966	G	117	gGGCGCGGGGCgGgggGgcCcgCCCCcgggGggccGGGGcgcgCCGCGCggcGgGGgGGCGgcCCGgGCGCGcGgggCGggggGgccgcCGCgggGgggggCCgcCCCccgccgGGG	?@<CCFCEGGGCGCCC=CBFBCGGGGBCCCDC@B?G:GGBCBCGGG8GGCCCGCGFDDGEG=BGGGDGGFGGCFDADDFCDDDGDCCDBFFCDE6FADCDDFFDCDFCCCBA><?CC	G	74	C	43
7	31102978	T	117	tTtttTtcCctCCCCctttTttccTTTctctCCTCTCttcTtTTtTCTtcCCTtTCTCTccTtttCTtttTtcctcCTCtttTttttCCtcCCCcctcctTTTttcctTcCtctCtc	?>CCCBFEEDDFFGGDEEECEEDDFFEDEDEGEBFFGEEDGEFFEECFEDGGFEFFAF@EEEFFFBEEFEFEDEFEFEFFFEFFFFFGEEEEFEEEFEEFEEEEFEEFEEGDDBA>?	T	69	C	48
7	31104564	G	49	GGGgaGaGgggAgGgaaagaggggaaagggggaagaagaaaggggaagg	===BEAEBC?CHCCCFFFBFCCCCFFF@CDCDGGDGGDGGG5DDDGGCB	G	30	A	19
7	31378933	A	54	AggggaggaagagggggaggaaagagaGagggagaggaggagagggagaaaaag	CC?@@CAADGDFCCCCCFACFFFCFCFEFCCCFCFCCFCDFDGDDDGBGGGGFD	G	31	A	23
7	31855503	C	189	TCTTTTcTTTTtTTCCtTTTCtTTtCCCTcCccTTTccTtCTTcttcTCTTTCCCTTCccTTCTtCTTTTtcTctcCtTTCTTcccCTTCCCTCcTCttTtTCtTtccCtCTTCtTcTcTtttCCTTtctcttCCTTttTTCTcCtCCCCtttcTCcCTCtttCCCttTttTTctCctTCtCTCCTccC	DFEEF>BFFDBFFFFFGFFFFGFFGGGFFBGBBF?FBAGG><FBGEBFGEF7=EGFEFCCFFFEHGFFF5HCFCGBFCFFFEFB?@EFEFFGFFCFFHHEHEA;EHCCFHFEEEHEBECEHGHCEDDGAH6HHFFEEHHEEEEA9HDEFFHHHCEFCFEEHGGFEEHHDGHEDBGFAECDBBBABC<=C	T	109	C	80
7	31904506	A	30	AGAGAAAAGGAGGAAAAAaAGaGGGAgGAg	FG9GFF?FGFFGGEEBFEDDFFFFFEGGB?	A	17	G	13
7	36278749	A	102	agaaAggaaGGGaaaggAGgGAgaAGaAAAaaGAAAAaGagGGAgAGgaggaAagagAGaaaggaGaaaggaaagGaAgAaaagaGagAgaagagaaaaggg	ABA?BGFDDDE<EEEDDFEDEFEEFEEFFFEEEFFFAEDEFFEFEFBEEDEDFEFFEECFFFGEFEFFFFGFEBEEFFGFFFFFFEFFEGFDGFGFFFFFB@	A	59	G	43
7	37299056	C	29	cCtTtcctcccttttttccccctttccct	C9C>C@AFBB@GGGGGGBACABHHHCBCH	C	15	T	14
7	37901490	C	34	CTTTCCTTCCCTTTCTCCCCTTCCTCCTTCCCTC	BHGGDGGFFFF;FFFFFFFFFEDCBB@AABBAAB	C	19	T	15
7	37924737	T	78	GTGTGGTGGGTTTGGGGTGTGTTTgTTTGtTTTGGGTGTGGtGtGGgTtTgGGTGttgTgGTTTgTTTtTtgTGTgTt	=@A@FHEHHGEDEHHHHEHECEEDGEEEHFEACGGGEFDFGFGFGGFAFDGGGD@FFGDGGDCCGCDDECBCBD9:CC	T	42	G	36
7	38385007	A	135	AatTtAAaTtTTTAAtaAAaatatTTaTaaTtAttTTATaTTTtatatttATtTAAtTAAttTTaTaTATtaTAaAataTATATAATTtTTaAtTTATtataattttaTttTtataaAttaatatataaAttata	>DEFDFFDFDEDEFFDDDDDDDDDDDDFACBDBBDEFFFDFF@EDECED;FDE;EFEEDFE?FFEFEFFFEE;FDFEEEFEF;=DFEFE?FEEEBEEEEEEEEEEFFEEEBEEECED:DEEEEEEEECEE>>=BB	T	76	A	59
7	38389290	T	131	TtTTTTtTtTTTTTtTTtTTTTtTttTTtTttTtTtttTtTAAAAtAttTTTAAtATTTAtttTTttttttAtTTAAtAAttAATAtAttaAtATTTTATAtATtTAAAAttTTAATATattATTttTttt	CDEEECDDEEEEEEEEEEE@FFEEEEEEEEEFEFEFFFCFEEEEEFEFFDEEEEFDEDEEEFFDDFFFFFFDFDDDDFDDEEDDDDE>GGGDFDCDDCDDDFDDADDDDDFFDDDCCDCFDFEECA>CCCC	T	98	A	33
7	38908876	T	124	CCcTTctctcctccTTTccttcccccctttTcccTtCctCCtCTttCCtCCTtctCtTttTcTCctCTccCtcTTcccCtcCcccTTTtctTTctccCttttCCtCcccCtccccTtccttttc	DB:A;CF@FAAGBBGGGBBGGBBBBBBGGGGBBBFGGBGGGGGAGGGDGGGGEBGGGDGGGCGG@GGGCCGGCGGCC=GHCGCC;GGFHAHGG>EABGHHHHFFHFCCCFHCBCCFGCBFGDA@	C	67	T	57
7	39379325	C	36	ccctCtccTttttctctttcCctccctcctcttCTc	A??C?GBBGGGGGBGBGGGA@CHCBCHCCHCHGCFB	C	19	T	17
7	40899967	G	205	GCGgcCGCCGccggcgggGCGCCCGcCGCggGGCcccCCGGGCGgGccCGggCCCCGgGCCgggCCCggGCcGCCCGCCGCCCCggcGCcgggcCCCcggcgccCCCggGgcCCGGGGGCCGCGcgGGcccgccgcgGCgcGccccgccccggcGcgCGggccgcggGcgGCCggccCCccGggGGGccCGGgggCGgcCgcgGG	>A;>><=>BBDCDEDDEEC@CDDDCDDCDEF;CDDDDDDCCCDCFCDDDCEEDDDDCECDDFEE@DDGEC>DADDD@D@CADDD>GDCDEFFFEDDDEGGEGEEDDDGFCFCDDCCCC?CCBCBDFAADEEGEEF;GBCGEBEEEEFEEBEFFEBE?AAHGEEGEFGBEGBCCEEEECCEEBFFBBBEECBAGEFCADDDB?<CC	C	104	G	101
7	42084829	A	26	AAGAGaAAGAAGGGGGaGGAGAGGGG	FFGFGEFEFEDFFFFF?FFEFEFFDB	G	15	A	11
7	42088222	T	41	TTcCTCTTTCCTcTTcCTccTttCtCTttTTCtCCccCtTc	FFBGFGFEFFFFB<FCFF8BFCHEHF?EHE>FHFECCFGB=	T	22	C	19
7	43659182	G	77	AAGAAGGAAAGGAGAAGGAAAAgGggAGagggGgaaAGGAAAGGgGAAAAAaaAAaAGGAGAaGAGGAGAAGGAAaa	=:AEEGHEEFHHEGEAHHEEEEGG8FEHGGGGGGGGDGGDDDGFGG6DDDDGGDCGDGCCGDAGCFGAFBBDC@A?D	A	44	G	33
7	43917274	A	165	aaGaaagaAAAgaAAgaAGgaaGgAaagGgAaagaaGAGAgaagGGGggGaggaaaaaAaaaggAGgaggGaaAGaagaagGAgagAAgaAgaagGgAaagaGgagGAaGgaaAaaaGaaaagAaAAaagGagagGggaagaaagGGAGaggagGaAgaGAGGaa	A?8?BBBBC>?BDE>CDDAEFECEHFFECF59EFFBCHCGFFFFCBBFFCFFFEEFEEHEF>CFHCFFBF>FFHCF=FFGGCHFDGCCEDHFGEG@GGGGGFCG?G@HGCGGFHFFFBG>GGGECG7EGGBGGGG?GHGGGGGAGBBGBGGGGGB>HE>?B7AD<	A	94	G	71
7	44180652	G	157	GTgtTTGGGtgtggtggGgtggTgGgGGTGGgtTTgGGTTGGTgGTGtggGGttGgggtTttgGTtGGGgtTtTTtgGGtTTgtgtggttgGTgtttTGTTGgggTTGGGGGGtTgTgtggggttGtgtTTgggttgTGgtgGTGtTGGGgTgTGGt	@?=C?BBBCGCFBCG?CCCGCCGCCCCCDCCCGGGCCDD;CCGCCGCHCCCCGGCCCCHGHGCB5GCCCCHGHDEH?CCGGGDHDHDDHHCCG6FHHGCGFBCDDFF=BBBBAGFDGDFDDDDIFBEDHFFDDDHHDFBDE?BF?HF>CCCE=AC?C	G	89	T	68
7	44185088	G	76	AAGGAGAgAGAAaAAagAagAgAGGAAgGGaAagGAGGagaAGGgGaGgGgAgaaaaAGgGGAAAGgAGGAaGgGA	FHCCHADCHCHH@HHG@GEDHDFCCHHDCCFGGDCHCBGDGG6BCBGBDBDGCHGGGGBDB@GGGB@GA>EC<?CC	A	38	G	38
7	44555573	T	61	GggTTTGtTtgtgttTtGgGttggGGttttTGttgggTTTTggGgGtTTTgGGGtTTGGTt	BA??=<ABFEFEFEEFEEFECEFGEEFFFDFEFF<GFAE@FGGDGDFEE;DDDDFDEDCCB	T	33	G	28
7	45125775	G	25	agaggGaagGaAgGgaaaagggggG	DAE9CCF@CCFHCCC>GGFDBDDDB	G	15	A	10
7	45144494	T	28	TTCCCCTCTTCCTCTTTTCCTCcTTCTC	GFDDDDGDGGDCFCEBFFCCFCCFFABA	C	14	T	14
7	45148773	C	93	cAcCCAAcCACCCACCACACCcCCCaaCCcaCacCcaaacCAcaacCcaacaaccccAcccaaCcccCcACAacCacaccaccaACcAcccaa	A>FEDBFGGFGFGEEFF@FGFGD<FDC@FGDFDGGGDDEGGEGEE:FHEEHEDHGGHFHHHEEGHGHFHEDEEHEEHEFGEEHEDDHD<GEA@	C	58	A	35
7	45747933	A	34	GgGGGGaGAGGAAAGGGGGgAgAgGAGggGAAAG	:C;CACFCGC?HHCCBBBBFGGGGBGBGGBBC??	G	23	A	11
7	47851654	A	62	aaggGgaGGggagaaagaaAgagAggaagggagaGaGgagAgaAggaaAgaaGaagaAagAg	?CCBCDDGGAFCFDCDFDDEFDFEFFCDFFFDFDHDHGEFEGE?GGEEEGEEGEEFEDEGC;	A	32	G	30
7	47854956	C	105	tTTTCCcCTTCCTTCTCCCTCCCTTtTTTTTCTCTCcTCTccCTTCCTTTCtTTtTCTCtcTtCCCTTttcccTTtCtTCCCtTCCTTcCTTTCCTTtccTccTT	AB<BBFAEEGFDGGGEBFGHGGGGGGGFFFGGGGGGCGGGCCGF?FCEEFFCGEHFFFFFAECFFFFFFHCCCFFHFEFFFFHFFBFFCFFFEFFFFHBAD8=AA	T	58	C	47
7	47874062	G	68	AaaGaaggggaagaagaGaagAagaaAgaaagaaAgagagggagaaggGgagagagaaaagaagaaaa	EAC<DD@BABFGCEECFCFFCGACFFHCFBFCFFH?FCFCDDGDFGCDCDGDGCGDGGGGDGGDGGHD	A	41	G	27
7	47874065	G	59	aaaggaggagggaGgagggGaggaggGagagaaagaggaaAagagagaggggaggaggg	C?>CBA@CDFFFDE65FFFEDFEDFFE<9DFDEEFDFGDEFCGEGEDEFGGGEGGEGGG	G	35	A	24
7	47874630	G	100	AgGAAAGAGGAgGAaGAGGGAAgAGaAAAGGAgagGgGgAGAGAaAgGGGAgaAAGgAAGAGaGaGAAAAAgGaAGGgGGGgGaaGGaaGAgagAgGaAa	EBCHEHCHCBHCBFF@CC<CHHDHCGHGGCCGDGDCDCDHCH<HGHDCACHC=GGBDGG=GBH=GBGGGGGCBGGBBDBBBDAGGBAGFAGDF?D>>@AD	G	51	A	49
7	48546011	T	165	cCCctttCCtTCCCTctCCCccCTTTTCcCTtttCtcTCCCTTcTCTTtTCTtTTtTCCCCcCTtTCTCTctcTcTCctttTcccccTTCTCcttTTcccttCTCTTcCccCCtCTCccCCTttTccTTtCtCcTtCTctCcctcccTCCtCCcTCcCttTtttt	CBA?EEEFFFEGFFCBGGGGBB8F;5EFBFEGGCGGB=GFGEF;FGABFFFFHFFHFFFFFBFFHBE;GFCGCFCFFCG6HECCCCB@FFEFCHH;ECCBHHGFFEE>GACFFHFEFC?FG?DHECCE?FEHFCEHFDAHCCCHCCCEFEHEEBDEACDDBBBAE	C	86	T	79
7	48654761	G	32	AGAAAGGGGGGGGGGAAGAGGAgaGGGAGGAg	@FDE>HHHGGHEGGGDDGDGFDFFE;BACAAA	G	21	A	11
7	50173777	A	66	aaAGGagaGAAGAgAAGAAaGggGGGAGGAagGaaAGGAagggaagGgaGaggaAagGagaaggag	CABFEDE@GFAGDFFFGFFEGEFGGGEGGEEFGFEFGGFFGEFFFFFGFFAGGFEF6FF?FFDA?D	G	34	A	32
7	50467767	C	195	AccaAcacaAaccaAAacacACacAaACcaccAAacaCaACcAccaaaAaccaaaaaCCAaaCaaaaCaaaACaacACcCcaacaacaaaCaCCaaCAcCacAaAaaaccaccCCacaaacaaaaCcAAaAAaCcaAAcAACaccAAaacaccCccacacaCCCcacaCAaaaAacCcaCCcCAcAcCCcCCCAC	@C@C@<A@ABB>BBDDCDDDGCEDEEHCDEDDDHEDEDEHDDHDDEEEG9DDEDEEEDCEEDDEADDDEEEHDFEDHCDDDEDDEFDFFFDFDBFFCAEC?EGEHEC;EEEEEDDFEBF=EFEEE@AGCCGGDCEFGCEGGCDEEGGFEEFEFCEBBCFEFCCCEF@FCGEFFGEECEFACCDG=EBBB>?AAAC	A	108	C	87
7	50685625	A	31	CCCCTTCCCTTTTCCTCTCCCTTTCTCCCTT	ADDDFGCCCFFFF<CFCFC@CFFEBCA<@CC	C	17	T	14
7	51150852	T	42	ttttttttTtTTtTtTtTttTttttgTttTtggtTggggggg	???@BFC?D<CDFEBF6FB?;F;6:BB=CDA?:ADD:CAC?:	T	32	G	10
7	53103571	G	90	GggaAGggagGGggggGGGaGGAggGGagggaaaGaaaGAgAGggaggggggGaAaAGAggaGGAGGgggGgagAGgaggaggGggAgaA	B@>;EDFEDDDDEDDEEEEDEEFEEEDEFEE;EE@EEDAAE?EFFDFFEFEEEBFFFDFGGEEEFEDGGGE=FFBDFFDGCFGD@BEEAA	G	61	A	29
7	53103673	C	78	CaacCcCACCAAACCAAACaAaccacCCAAcCAACCCAACCAcccAAacACaacaaaccAcACACaaaAACccaaAaa	<FEADBDHDDHHGDDHHGDFHFACGCDDEHCDHHDDCHHDDDABAGFGBGCGGCGGGCCGCGCGCGGGGEB@9B@@B@	A	42	C	36
7	70765496	A	69	GagGAgGGGAaGGGAAagGGGAaagaAaGgAgaagagGAagggAaaGgaggagaAaagagggggagggg	@CCHEFFHGEFHAHEEFFFGHEGFFFEFHGBGGGGGGHEGGGGEGDHGGGGGGGDGGGGGGGEBGBECB	G	39	A	30
7	75183403	A	27	GGAGAAGGAAAGGAAGAgaGAaGGgAa	=AHCEHBBHGGCBHHCGDFBGEBBDB5	A	14	G	13
7	75441108	C	67	CTCCCCTCCCTTCCTTTTTCTCTTcCttTCTCTtCCtttTCtCCtcCtTTCcCCtCtCtcccCCTtC	BAFEGGDEEEFFG9FFEFEFF@EEBGGHFGFEEEFFHIHEEHEEHCEHBCECDFHFGDFCABCC>@C	C	35	T	32
7	75441111	G	72	GGGGGGGGTTGGTTTTTGTGTTgGttTGTGTTtGGtttTGtGGtgGtTTGgGGtGtGtgTggGGTGTTGGGG	E<DDCEEAFFEEDFFCEEFBFFCDDHEEFCEDHDEHGHEDHDDHDDH;9DDDDHDGAHDDDDCCDCAAAA@@	G	39	T	33
7	75442730	T	45	GgtTtgTtTtTggtgtGTTtgtGgttGGgttggggtgtgTgTtTg	ECGGGCGGGEGC:ECHGDFCCGDCHHGGCHHDDD?=DE?EDFDF<	T	24	G	21
7	75614288	C	145	ctcttttcccCtcCttcCccCtcCTTccTtttcttCTtCTCCTTTTcCcTcccTCCCCTCtcCtctttTtcccCctcctTTccTTTTCCTCCTtTcCCtTTCCcTTTtcCtTTtccTCTctttcCCCttccTctCCctCttCTTt	C>BA5@BFGGADCGBDGEGGG6GGEEGGBDDDGADAE?GEGFBEEEGAHEGGGE?GGCEGCHGEHEEEEEHHHEBEHG<EEHGE=DEF=DFFDEEH<<EDDCDHDDCEH>DDDEEHDFCGCEEGEEE>CDBBB?9A<=C@:?C>@	C	73	T	72
7	75614296	G	123	gaagGggGgGAAGggaaagaaAaGAGAAggAgggAGGGagGagaaaAaggGgaggaggAAAAGAaAgGaAAGgAAagGaAAaggAGAgaagGGagaggAgaaGGgaGaaGAAaGGAAGaGgAA	@=AC<DF6EAHF<FDEEEFEEEE<F@G?DFFFFEFA;;EEBFEFDFDFGGCGFGG=GC:HDBBCEHGBEF7>?CG;FBFGGF5GGBGGDFGBB<6?FFGFCFBBGFBDCAGGFBBGD>@=>C?	A	62	G	61
7	76908199	A	50	ACaaAcaACAcCCccCCCaCaCCAccacaAAcAAaCCCCcACaAcCcaaC	FFDDFGAFEFGG6HHFCEEGBFG?GHEDDEE@EEEFEEFHEFEEDFF=?>	C	28	A	22
7	76991935	C	57	TTCTtCTCTCTTtCCtcTTcccCtCtTTCttCCCCctTTCTCTCtcCCCcctctTtT	BBEE=AEFEEEEE8GFDEEDDDEFDBEEEFEGGFEAEDDFDFDFF<FFFDCEDFDFA	T	29	C	28
7	77469486	C	140	CTtCCccCTttCTCCTCCcCTTTcCTcCcCtTtcTcTTCCcCTCCCtcCCTTCCtTTTttccCtTCTCTTCtccCCCTCccTCCTccCCCcctTCCcctTtttctCcTtcctCcCcctCTtCCccCTtcTCctCttcTTt	?ADDDFECGEEDG@DGCCFDGGHFCGFDF@EGEFGFGGDDGDGDDDFGDD=GCDFGFFFFGEBFGDFDGGCFGG=DDGDGGGCCGGGCDCFFF@CCDGFBFFFGFCGEFGHGCGCGGFCFFCCGECFFFFBGFBFEECCA	C	81	T	59
7	77539744	G	58	ggGGaggGaGgGgaaggGaaGgggaAaggagggGggGGggggagGagagaaagagggg	A>@?DFG@E<EEFFFFFEFFEFFFFFFFFFFFFEGFEEGGGDFGEGGEGEGGGGGFBD	G	41	A	17
7	77764591	C	71	AccaaaaaccaAAaCaAaccaCaccAaaccAcccaAacaacacccacccccaacccaaaaaacccaaaaca	EC??@AABCDCDFBCDFDGGA9DGGHDCGGHGFGCHCGDDGEGFFDHHHHHEEHHHEDEEEEGHHDEEEE@	A	39	C	32
7	80285850	T	29	CCCTTCTCTTTTTCcCCTCTTCCttTCCC	GGFDE@DFDDDDCFEFFDFDDECBBCAAA	C	15	T	14
7	83037731	C	85	GcGGgCCgccGCcGcgCggCcgGGgGcCGcCgcgcGCCgcggGgCgGCgccGGgcCcccgCCCgccCCccgGcgggcgccgcgCc	>@GGCFEBABGFBHBCGCCGBCHGC?B?GBGCBD;HGGCCCDHDFDHGDCCHHCAECCBDGFF6ACFFCCDGCBCDCDCCDCDF?	C	45	G	40
7	83631376	T	82	CTcCCTttcCttcccCtttTCttTctTTCCTcCCTcCctTctctTcccttctCcttctCCtcctTcttCctcctcctctttt	DB>BBEGFAGGGBBBFGGGFFGGDBGFFGFFBEGECGBGBBHCH;;CBHEBGECHGCHFFHCCGFAHHECGCCHDDH6HHHB	C	41	T	41
7	83764113	T	93	CCCTCCTTCCTTTCCCCCCTTCTCCCCCTTCCCCCTTTTCTTCCtcCCcTTcTCcTtTctTTccCTTTTTTTTtctCCCTCTCTccCCTccTt	DFFEDGEEGFEEEGGGGGGEEGEGGGGGEDEFFFFEDDDFDDFFFHFF?DDGDFGDFDGFDDGGFDCDDDDDDFGFFF6CECFDCCBA@?@@A	C	50	T	43
7	92732769	T	41	CtccTcccttTttCtCCCTcctCCTtTCCCcCCTCCTccCC	@CCEEDDDEEGADFEGGGGEEFGAGFFFFFEFFFFF=DDB>	C	26	T	15
7	93116299	A	28	GgagaGaGaaaGagGgagggGgAGgaag	?<GFFEFEFFFEFFEFFGGGEGFEGEGA	G	17	A	11
7	95035582	A	47	tatttaatattttaatTaAtttTattaatAatatatTaatttttaat	?9@DDCDDCDDDD=DDGDFDCDGCEDDDEEECEEEDGEAEEEEEECD	T	28	A	19
7	95039445	C	33	tttCCcctcctcttCcccctTtcccCtCcccct	CC=AAHFCFFBGDCHGFCGCGEHHAG=FFHHC=	C	21	T	12
7	99686873	G	75	gTtttGgtTtttTtTgTTGgTTGTtTTGTTGgGTTTtGTGTtTTTTTGTgGgtgGTGTTTGGGggTTGTtGTTTT	BABDCEEEDEEECEFEFFEGFF?FFEFDFFEGDEFBFCEDEFBEEEEDEGDEFFDEDEEDDCCDFEFDFDB@BA@	T	48	G	27
7	100173481	A	54	AGaAaGaAgaAgaaGaAAAaGGaaAAaaggAGaggaaGGAAggaaAGAAGAGgG	>@?CC?AGBFECFFCEGHHF@CGEHHGGDDHC=DDDGBBGGDDEEG=FCBG;>5	A	33	G	21
7	100175473	T	185	CCTCTTcTctcTttCccTCtCTttCtTTcCcCccCTtTTTCCCCcctCTCTCctTTTccCCTtTtcttcCCttttCttTtcCCtTcTTcTTCTTCTcTcTCTCCcTCTcctttttTtttCCtctcTCccctTctCctCTTTtCCCCTTttTttTCCCCTtCCtcctcttttcccCtCcTCcTCcc	C@ABA>>:ACCBCDFDCEFEECEEFEE>D@DFDDGFEFFFGFFFDDEGGGFGDEFFFDDFFFEFDD?F;FEFFFEGFF;FEFDBEEFC@FFGFEFFDD9FEEFFEFFFEDBE@EFEFAEEEEE?;BF?EEFD@@FEFCBEE8EEEF5EFFDFFEEFEFEEFFCEEBEFFFFEEDGDDACC@B@BB	T	95	C	90
7	100182242	T	74	TTTTTTTTTTTTTTTTTTTTTTTTTTTTTTTTTTTTTTTTTTTTTTTTTTTTTTggTTTTTTgTTTggTTggTg	:?DC>DFC;?FCBFDCF=;F=EE@D?AFEE?ED?DDEEEEDDCDBDDD9DDBED9?DADEDDCDDD;:>589C>	T	66	G	8
7	100182248	T	85	TTTTTTTTTTTTTTTTTTTTTTTTTTTTTTTTTTTTTTTTTTTTTTTTTTTTTTTgTTTTTTTTTTggTTggTTTgTTTgTtTTt	>?:E;CEFCEEF=DE<:D<E;CEEC;D9DFEBFEFDDCBE;EEC?EB?DBEDDB;9E><DDD?DE@@@C5?@C>C:C?C9>;???	T	78	G	7
7	100410597	G	221	AGGGGaAGGgaaGAGaAGgAGGGGGAGAAaaAAaaaaAGAGgAAGGGggaaAGGAGGGGgaGGAGAGAgAAAGgGAagAAAAaAgAaagaGgGGagAgAGaGAgAGAaagGAaAGgGAggGaagaagAGgGgaAgagGgggGgGGggggGaaggagaAggaagagaaAAAAgaAaggagGgGgaaggaagaaagGgAggAaaaGAGaAGaGgAggAGAAag	=B@=?AAADEDEEEEEFDFCAEEDEFEFFEEFF>EEEECDDFFEEEEDFEEFDBAE@EEFCEE8ECECFEFFCEECEEFFCFDFEFFEFEEFEAFFEGFEFEFGFEFFFGDDEFDGAFGGEEFFFEFEEFA9FFG@6EGFGEFDDFFGGE@FFGEGFDGFFFGFFDGEEEEFFEFEFEGDFCGEEEGFFFFFFGDGEFFEFFFCEDEEDDCBC@AA@BBAB	G	114	A	107
7	100552644	C	361	AcccACAAAcCAAcAACCccAAAAcaaaCAcaAACAACAcAaaCACaaAAaccAAAcaaACCCccCCAcACAcACAACAaCcacaACAcaACCCAAcacaaCCACccAAccCcaaCAAaAccACACcAAACCCcaaACcAACACCaCcaAcccAACcCACCccAAaAACCcccAaaCCAaccAAAaCAAaaCAAacCACCcaaCAACAacACCCCAaCcaAAAAaaaAAaAaACcCaaACAAACaAAacccaACAacAACCAcacACaACCCCACAaCACCcccacaCCaaCCAaCCAaAAccCCcacAAaCCAacaCacccaCACcacCAAAcCaCCCACCaACAcCAcacCAcacaCAA	>CBCB>EDDDCGFGFGBDEEHHDHEFFFDHFFDGDHHDHFH=BDDDFEHHFFFHHHFFCHDDDFFDDHFHDHABDHIEHDDFFFFHDCCFDDDDHHFEFEADDHDFFHHFFDE;GCHHGH5FHDH6GHHGDDDFDEHDFGGDHDDGDGGHGEGHHDGDHDDGGEHDHHDDGFFCGFDDH8EGGD?GCGHEECE@B@CGCCGDGDHF5GGCGCCDCGDCGGGGGCEGDGGGGGGCGCBGECGGG@DGGGGHFGGCGEDGGACGGGEGCDECCCCGCGBCGCCAEG6C9CCFGCC<FCCGEGG>GCCGGBGGBBBGBGGCFFGF9BFB@=BBFFGFCCB?BECBDDBCB<DB9@?BB:?;AC@	A	189	C	172
7	100731184	C	75	CTctcctTTTCctcTTtCcCtcCTTTTtttctcctCCTCcTtCctCcCCTCTttTccctCcctCTtctTcCtTtc	B<@BBB=GAG<D@DFGDGDDDDGGGGGEEEEDDEEGGGFDGFGEFCEGGGGGEF<EEEBFE8FFEFEEFEFBFC<	T	38	C	37
7	101839065	C	25	cctcccttTcttccctcccttcCCc	@BGBBBGGGBGEBBBHBCCAH=DC;	C	16	T	9
7	101926087	G	59	GgtggtGtttgtgGggggtGtttTggtgGGtGgttGgtgtggtgtgggttgggggtgtt	BAC>>ABEFEDEDEFDFFEBDDDBFFEEEEDECEE9FEF:EGEFFGGFFFAFG?GFGEB	G	35	T	24
7	102098010	G	116	GGGAGgAagGAgGaaGGAGggggaaGGGaggagggggAAGaggAGgAgAagGAGAgAaAGagAagAgGGAAgAAaaagAaagaGAagAggaggaaAggGaaAAaGaaggaaGaAGg	@@;?:CDCDBFECEE;CHCEFFFEECCCEAFBFEFDFHHCEEDGCD;AHEECHAHGHFHBFGHF7BGA@HHFCHFE@GGEFGFBGFGGGDFGFFFGFGBFFGGAB>FGG>EBED@B	G	60	A	56
7	102106201	G	37	aGgaAGAaaAgAgGGAAGaGGAaAAagAAAaAaGgAG	FCCFGCHFFGCHDCBHHBGBAGFGGGDFGGGFGBCD=	A	23	G	14
7	103280896	C	49	CCCTCTCCTCTTCTCTCTCTTCTTTTCcCTCTTCccCCCtCctCTCTTT	ADDGAGADGDGGDGCGCFD=FCFFFFCBCFCFFCBBCCCHB:DAB@AC?	C	26	T	23
7	103417139	A	48	AaaaAcaaAcaAcAcaacaacaacAcacacacaaacaaacaaacaaac	>A@B?ECDEGDEGFGDDGCDGDDGFGCGDGDGDCEHEEEHBAEHEEEH	A	33	C	15
7	104753240	A	44	aaaaaaaaaaaaaaaaaaCCaCCCaaCaaCaaCaCaaCaaaaaa	?AB::BEBDEBEE<DEA;9DB9?<DEDDF>59BBCFE:?BCB?<	A	34	C	10
7	104753246	A	47	aaaaaaaaCaCaaCCaCCCaaCCaaCCaCCaCCaCaaaaaaaaAAaA	B>CBBD>@@?@?<D;ED9DEA7AD@B?DDDFBA<CEA6;F7=C<;:?	A	31	C	16
7	105131849	C	28	GCGCCGCCGGGCCCCCCCCGCGgCGcGC	FFGGCGGAEDGEFFFFFFEEFE>EE@CC	C	17	G	11
7	105250904	A	42	aAAAAGaaGGAAAGAgaaGAGGaGgaGaGaggaaGgggAGgA	CHDHFCDCC5HHHCHFDEBGCCEBGEAEBEFGEEBGGAGAEC	A	22	G	20
7	105752691	G	30	AAgaAAAggAGggaagaaaaaagaGaggaa	A@@F9HHCCHCCCGGDGGFGGGDHBFDDGG	A	19	G	11
7	107545322	T	34	aAaTtTaAaATtTaTTATtTAtttTTatTTTTAt	?EEEEEGEFEEFEFEEEEECDF5FDDGEDDDCAF	T	22	A	12
7	107545799	T	70	TTTTCCCCTTTCCCCTCCTCcttCTCTCCCCCTCTTCCTCcTCCCCtCcCccCCCTCcTtTcTtCCCTtC	EEEEGGDGEAEGFGGEGGEGCHHCDFDFEEFFDFABFFDFCDFFFFH?CFCCFFDDFADHDCCG>DDB@>	C	43	T	27
7	107564539	G	36	gGgggggggggGgaaggagaagggggaggggaAGAG	CACBC9CCCCCECFFCCFCF?CCCDDGDDADHECC@	G	27	A	9
7	107564542	G	37	gGgggggggggGgttggtgttgggggtggggtTGTGG	BCEEEDFFEEF9FDDFFDFDDEFDAGDEGGGEFEEFC	G	28	T	9
7	107599806	C	118	CtccccctccCTcttCccttCCcccTcttTttTccCccctttCcctctcCCtcCCTCCctCCCctTCCCcTtCTTTTTTCTCcCcTccTtcCtctCccTcCCCtttCTtCccTCcttC	A@DECDDEDDDEDDED>DDEDDDCDGCAEGEEGEDDDDDDEDDDEFDFECDFDDDGDDCFDDDEFGDDDEGABFFFFFGDFCECEFEEFFECF9FCEEFECCCCDFCFFBD<CA=@;A	C	71	T	47
7	107746246	T	49	TTTTTTTctCCTCCCCCCCCCCCCCTTTCTTCCTCCTTCCTCTTCTccT	BEEEEEECHGGEGGFFGFFFFF<FFDDDFDDFDDFFDDFFCFCDD<;;A	C	27	T	22
7	107849908	G	87	gAGGAAAAAGAgAGAGAAagAAGGGAAGGAGAGGgAaAAgGagGAGAGAAGGAGGAgGgAAAGGAaaAGAGGgaGGGaGAGAaAGgG	BC?CACHHHCDFHCCCHHEFHHC@C@GC=HCHCCGHGHHGBGGBHBGBGGBBGCBGFBEGGABBGEAGBGBBGGBABGAFCHFD@CA	G	44	A	43
7	110762899	A	173	aGgGGaGGAaAAGGAGggggaagaGAAGAgaAaGgAGAaggAGgGGAGgGgAaaGaAGGAGgGgGGAgaAAAgaAAAAaaGaGgGggaGgGgGgGAaAaggaaAaAGGAAGaGAaAAGAGgAAgaGGAAAGagAGgggGAaggaAGGaGgAgaaGGGGGGGAGAAgGAAGaaA	C=A@DFEDFFFFEEFAFFFFFFFEEEEEFFEFFEFFCEFFFGDFEEFEFEFFFGEEFDDFEGEGEDEGGFFFGGFFFF=GEGE:EDBGDDEGDGEEFEGGGGGEGECDEEBHDEGEEDEDGEEGGDDEEEDC:BDGGGDEGFFGDDDGCGEGGGDCEDCCCBBA=?@CCBB<C	G	91	A	82
7	111386365	G	37	gCGGCCGGcCGGGCCCGCGGCGcGCCGgCcgGGGCCg	CGGGGGDGCGGGG5FFFFFFFFCFEEEDCA@CB?@@A	G	20	C	17
7	112095782	T	30	TTTTGTGGTGGTGgTTTTtttGTTTGTTTG	DGGG=FEFFCFFFGFF:FEEEFFEEEEBBA	T	20	G	10
7	112107999	T	36	TCCTCTCCtCTCCTTCtCCcTtTttTCTTTCcCCTC	;?GEGGGGDAFGGGGGEFGHEEEEEFFFFEFHFE=D	C	18	T	18
7	115897287	T	50	TTgTGGGTTGGGTGGGTGTGGTTTgTTGGtTTTGGtTttTTTGgTGTGGg	GGCGFGGGFDGGCFFGFFFFFDGEDFFFFHFFFFEGFH@EEEFCCDCD?A	T	26	G	24
7	116528240	C	69	TTCTccctTtCTCtCTcCttTCcttCcCCtTTtcCctctctTTCCtttctcccttctCtttctttcccc	>B??HGFDEDGEFDGEGGDBEGGEDGGGGDEEDGGGDHEHEEEEGEEEHEHGHEEH@FEEEHCEEHGEB	T	36	C	33
7	116918060	G	31	GAGaaGGAgAGgAAGGGAGGGAAAAAAAaGA	EFEBEEEFGEEFFFDDDEDDDEEEEED??B?	A	17	G	14
7	117307108	G	37	AGGaaaaGagGgGGGagGgAGgAgaAAaGGaAAgGaa	?;EDDDD?DFGDGGGCGGGCDGFGEFEEFFEEE;E;B	G	19	A	18
7	120428607	G	47	GGAAAGAAGGGGGAAGAGGGGGAAAAAGAGGAAAAAAAAAaAAGGAG	GGFADGEFGFFGFFFFFFFFFFEEEEBCEEFEDEEEEEEEGDCEAB?	A	27	G	20
7	120428799	C	102	CAaccaacCaaccAaaCcAccaCAaacCcccCcAcCcacaAcCaaccaCcaacAcccaaaCcCCcccacCcAACacAacccccaccAaaaaacaaacCAcca	ABC?:?C?@DE=@GGE?BHBBFDHEFBDBBBDBHBCBFBFGB=FFBBGDBGGC9CCBGGGDCDDCBCGBDCGHDGCGGCCC>CGCCG?GGDFCGFGBCG>@A	C	57	A	45
7	120776211	A	27	GaGGAAGaGgAAGggggagGaggggag	ACFFFFGAGFFFGFFFGDFGE8GGEEF	G	18	A	9
7	121617017	A	66	gaaaAaaagagAggGGgAagaagggGagaagagagaggggaaaggggggaagaaggagaagagggg	AAAB<EEDEDFDFEHH5EDFDDFFFHAFACFEFEFDFFFGCDDEGGGGGE>GEDGGEGEEGEGGGF	G	36	A	30
7	121719586	C	27	TTCTTTCCCCCTTTCCCtTCtCtTTTT	EEGEDEFGGGDDEE=FFFDEDABBAAA	T	16	C	11
7	127224286	A	85	GgAGGaaGGagGGAAAgGAGAGGaAAGGAggGGgAGGgAgaGAGaAGaAAAAaAGAaaGgaAGgAGaaGAGaaGGAAAAGgGggg	;A>DEFDEEFFEDDFEFEFEEEEFEFEDFGGED=FDDGFGEDFDGEDDEEEEGEDEGG@F>EDGEDEGCDDEGCDFFEEB@BA?E	G	44	A	41
7	127991133	G	82	GGAaaaAGgaGGGAAGAaAAGAAgGaAGaGGaAGaAAGAaAAgGAGAaggaGagggagagAGgGAgaAAGaaaAaggAaAGG	@@;CDGHBCECCCHHCEFHHCHHDCGCCDCBGHCGHHCGGGGCBG9GGDDGBGDDDGAGDGBDBGDDGGBGBGAF@DGG8?C	A	46	G	36
7	128312463	C	46	GGGCCCGCGGCGCGCCGCCCCCCGGCccGGCcGCCGGGGGGGGCgG	EDDGGGHGHHGHGHGGHGEGAGGGGFHIGGFHGFFGFGGFFCCA?C	G	24	C	22
7	128531765	C	37	tTTTtCTTTCcCTCCTtcTTTtctTCCtCcctTTTtC	DC?FGFFDBEBEFGFFHCEEDHCHEFE?FC<HEEEBA	T	23	C	14
7	128802526	C	29	ttctctttcccccctCctcccCtttCCTt	CC@B=DDFCDDDDDEDDFEEEDFFF?CC<	C	16	T	13
7	128845325	G	41	AGGGggAGAAAAGAAGAAAAAGGGGAAGGAGAAGGGAGGAA	FAEEFF>DFFFED?E@EEBBEDD:DEEDDEDED@CDFDCCC	A	21	G	20
7	128846469	A	50	aggagGaagGGggagggagaagaaagGggggggggaaaaggagaagggga	CBBBCFFFFHGEFFFFFEFFFFFFFFGFFFF@FFFDGFGGGFGGGFGGFE	G	31	A	19
7	129938598	G	130	GTTGtgtGGtTgTTGGGGTgTGTTgGTGtTGTtgTgtgtgGgtGGgTggTgGtTtTttTgtgtGgGTTTgGttTtgtTTGTGTGGTGTGGggGttGtGTtGTtgTggtTGggTTttTGggtTgtgggGTg	BBB@@CDFHCECEEHEGHC<EGEBFGDHDEEFDFEEDFDFGFDHCEEGGEGB;DEEEEEGEEEGFHEEBGHEEEEGEDE@EGDGHDGDG5GGGCD?FGDCGDEGDGFEDGFGDDEEDGGG?DEEFGFGD;	G	65	T	65
7	129987722	C	57	TcCtTtTTcCtcCtcTCCtCttccCtcttccctcccCcccttcTcttctcctctCct	?><6CDGGDDDDDED;DCCDEEDD?=DD?DDDEDDDDDDEFFEGEFFDEDEEEECDD	C	32	T	25
7	131193863	G	91	CcccGgcccccGGccCgcGGcGcggcgggGGCcgcCgcCcgggCgcGgcgCcggccGGgcgcCgcgcccggcgcCcggccccgccgccgcg	ACCDDDGFFFGHHGGGFGFHGHGFDG@FFF9HGEGEFGGGFFFA5EFEGFGHFGHHHGGHGHGFHEHHH=GHG;FHFHIHCCGBGAHCGH:	C	50	G	41
7	135099901	G	82	ggAGAgGAGAGGgAGggGGGgaGgGAggGAGaAaAAagGaGaGaaAaAGgagaGgaagGaggaGgagggggGGAGggAaaag	CC?=?9GFGFFGEFGEFFHGFE?FGF6FGFGFEFFFFFED:FGFEFFFGAEGFFFFAGFFFEGFGEFFFGFFFEEDDCCC@<	G	49	A	33
7	135262533	T	59	TTTCTTCCTCTCTCTcCCCCCtCTtCcCCCTTTttTCtTTctCTTTTCtTtTtTCcCTt	CCEGF=H>DEEGEEEGFGGEEFGEFGGFDFDDDFEDFFDCG<FDDDDFFDFCFDFGBCC	T	34	C	25
7	135311167	G	34	AAGggaggagGaagggaagAaaggagaggaagag	E@CBFDFFDFGDDFDFDDFFDEE<EFEEGFFDEB	G	18	A	16
7	135661689	A	29	CCCCCCaCCAAAAAAAAAAAaAAaAAAAA	:9D7@:F@=GEGGGGGGFGGEEFBEDBAC	A	21	C	8
7	138719231	T	88	TTTCCTCcTCcCCTTTCtcTcTCcCCcTCccTcTcTtCCcTTCCCCtTCccTcCCcttcTcTctTtCttTTTCTTCTcTcTCTctttc	CGEGGGGGGGGGGGGGFEGGFGGHGGFGGHHGHGHBEFF>GFFG=F@FFH;F=FFIFBHFHFAEFEFEEFFFFF:EDHEHFDCA;>=E	C	46	T	42
7	139164345	C	101	ccCACACaAAaCAAcACcACAcaaACAAAcAcaaCCcAAACaCAcACcACCACaAcAACacaCCcCACCaaccCAAaCcAcaCCcCaccaAaaCcACACca	CC?A>B>EHGECFHDHDDGDHDB@IEHHHDHDEFDBDHHHDEDHEE?EHDDHDFHDHHD=EECC=CGCCDCEECGGCCDGEFBBAC7EEEF@BDCFAD@=A	C	51	A	50
7	139801777	T	58	TTTTGTTGTGGGGGTTTTtTGGgGGGgTGTgtTTtTGGTTGGGgGgGGGGGGGTGTTG	DGGFCGECGCC:CBFF:FFFB?GAABEFBFGEFFFFBBFFBABGBFBBBAAB@D?DAC	G	33	T	25
7	140051848	C	58	cctccCTCtcTtTCttcTTCtcCCtTccTTttTCtTTtcCcCTTcTtcctccCCcTtT	CBFBBFFFGBFGBGGGBFFEHCGGHFCC;FHHEEHEEGBE<EEEAEHCCHCCFFBEGC	T	30	C	28
7	141805522	G	136	AGGGAGGAGAGGAGAGGAGAGGGAAAaGAAAAAGAgAAGGAGgaggGaAGGGAGggGAAGGAGAAAGGAGAgAAaGAgaAAGAaAGAGgGAAGAgaAGgAGAaGGGGGAAAgAAAggAGAGGGaAAAGgaaaaAGA	:AEEFDAFAEEEDEEEEFDFEEEFFFFEFFFFEDFDEFDEFECD?DCGFDDD?DDDDEEDD6DEEDDDEDEDAEHDEDGEEDDGED9DDDDEDEDGE:DEDEGDDCDCEED@DDDDDEDEDEDED>CB?@@?BCCC	A	70	G	66
7	141857725	A	70	AATTTAATtTATAATAAATTTAAAAATTAAtTAtTATaTATTtATAATAAAAATaTTTaATTATattatA	HHGGGHH;FGHGGGGGHHGGGHHHHBFEFFFFGFFEFGGEFFFFFFEFGGGGGFGFFFGGFFFF@DBC>C	A	36	T	34
7	141897595	T	52	cTCTccttccccCccctctttccctcttccttttcctctcctctttccttcc	?><CGGDDGGGCGGGGDGBDDGGDDGDDGGDCDEHHEHEHHEHEEEGHEEHE	C	29	T	23
7	141954756	A	30	GAAAAGGAAAGAGGGGAGAAGAGAAGAAGG	HFFE<FGFFFFDFEFFEFEBFBFEDFEDDE	A	16	G	14
7	142013130	C	87	TCCTTTCtCcTCCctCcTtCtttTcccTCtTTCCCTCTCTTcCttCTCCCTttctTCcCCcCCTcTTTcCTcCtcTcTCTCTtTTCC	@>;@BE@ECFGDDFEDFG:DEEEGGFFGDEDDCDDFCBDGGGCFDDGDDBFFFGFFCFCCGCCFGFFFGCFGCEGFGECFCEACDA?	C	45	T	42
7	142197897	C	79	cctCCtttCTCcCCtTTTcTtTCCccCCTttttCCTCCTCTTccctccctcCccctctcTCtcctTtccCctctCtttT	?C>@EECDFEGGGGBGGEGGDGFGGGHEGDDBDCGGGBGGGGHHGEGHHEHGHHH7HEGFFEHIDFEHHCHEHEFEEEA	C	43	T	36
7	142242442	C	59	acaaAcaaCaacACacaAAaaacAAcccaAccaccccCcCCCaaacaAaaAAACACaac	A@>B>BDFDEEDHDEDDGHEDEDHB<DDDHEDEEEEECEC?CFEFEFGFFGGGBGCBB=	A	34	C	25
7	142247148	C	112	TTCCtCTTTCCCCCTCTtCTCCCCtcCCTtTCTtCTtTTccCCcTttCcCtcTCtCtTCcccTtctTCTTTcCTtttCTCcTccccTTTCTCcCCCTCtTTTccttCCTcTc	B@@BFEGFGDCDDDHDHGDGDDDAGBADGGGD>GDGGGGCCBDCGHHDCDHCGDHDGFDCC>FHCHFCFFFCCFHFHCECAFCCCAEFFCFCCCCCFC5GEF?7CCA@?<D>	C	58	T	54
7	142247347	A	106	CacccaaAcccaaAAaaCaaccaaAcaAAAaacaAcaAccCACCacCcCAaccAAcAcCAAAAACCcccAAcaACAacaaaacCCaAAaaaccaAACacACaAaaa	BBCDFEFCFEFFFECFFGF;FFF@CFFECEFFFFEFF:FFGEGGG?GFEEFEGDEGCFGEEEE;FEFFFDDGGDFDGDG=GDGFFGDDFGGGFEDDFGGDFEDGGE	A	63	C	43
7	142498735	A	138	AAAAaAAaAaAAAAAAAaAaaAaAAAAAAAAAAAaAAaAaaAaAaAaAAAAAaCCCCCCCCCCCCCCcaccccccAAcaCCcccccacCCccaAaacACCaAACAAAAAcAAaCccaCAaCCaAcACACCaACAcaAA	FFFFDFF<DDFFCCFFFAFDDFEC<EFFFFFFFFEFEEFEEEEEEEEEEDEEDGGFGGGGGEGFGBGHEHHHHHHDEIEFFHEIHHDHFFHFCEEEHEFFEEEFEEEEDEEEDFHGFFEEFFEDCEEEFGABBBB=??	A	87	C	51
7	142498738	C	150	CCCCCcCcCcCCCCCCCcCccCcCCCCCCCCCCCcCCcCccCcCcCcCCCCCcGGGGGGGGGGGGGGgcggggggCCgcGGgggggcgGGggcCccgCGGcCCGCCCCCgCCcGggcGCcGGcCgCGCGGcCGCgcCCGCgCGCCGcCGg	GG=GGBFBCBHGGGGGGBGBBGCGGGGGFGGGGGCGGC?ACFBGCFCFFFFFCGFFFFFGGGFFGGEDCDCDDDDFFDCFFDDDD@CDFFDBCFCBDFFFAFFFFFFFFDFFCFDDCFFCFFBFDFEFEFAEFECBB?CB>@?BBB>CCA	C	93	G	57
7	142498833	A	242	AATAtAAAaATTtTTAATAatTATTAATAaTaaAtAAAtaaTAATAttTATtTTAATaTaAAtaATAatAAAaTAATATaaTtAaataATtaaaAatataatTataAtaATtAtTtaatATAaAAAaataTtaatAaaTTTtaataatTataaAAtatatTaaaaAAAaAataAttTTAAAaaTAAtataaATttATtTataTaaaTaTaTaATtAAaaTTtAAattTattaAAaTATTtAa	>;@?BBAADDDDEDDECDDDCEDEDEEDDEEDDEEEEEEEEDDEEEE=EDEEBECDEDEEEEECEEDEEDDEEFFFFFFEEEAEEEEEEEEED9EDFEEDDEEFFFEEE@EEEFEBFEFE=EFDDEFFFFDFFEEDFEEEE@EFFFFEEFFFFEEEFEFEEFFDFEEEEDFFFEF;EEDDEFFDDDFFFFCEEFADDFDFFFDGFGDFDFDEDDEDDFFDDFDDFFEDFF=FDCFDDDEC>B	A	142	T	100
7	142498837	C	244	CCCcCTTtTCCTCcTCTTCCTcTccCtCCCtccTCCTCttTCTtTTCCTcTcCCtCTCctCCCcTCCTCTccTtCcctcCTtcccCctctcctTctcCtcCTtCtTtcctCTCcCCCcctcTtcctCcccTTTtcctcctTctcccCCtcctTccccCCCcCctcCttTTCCCccTCCtctccCTttCTtTctcTccccTcTcTcCTtCCccTTtCCcttTcttcCCcTCTTtCccTtTTtcTT	AA@C?B?@?=8?<=D@CCA@C@EBBCFBDDFABGDDGDFFFDGGEGDDGBGBDCGDGDBGDDCBGDDGDGB@GBD@AGBDFGB@BDBFAGBBGGBGBDEADGGCGGHCBGDDDCDDDBCHCGHCCEDC?CGGFFCCHCAHGCF5BCDCHCBBFCBC=DDD@DBHBDHCDGDCDCCDCCHCHCC?GHHCFHFCGCF;@CCFBFDFCCFHCCCCFFGCCCHGFCHHCCCCEBEFHD?<D@DB@;AA	C	142	T	102
7	142499729	T	60	ttcctTctcTccttcTcTCcctctccCtcCTtCctcTtcTtCtCTtCtTccTtTttTTTT	BCA@FFAGAEBBGGBCBFGBBGBG?CFFBEFFECGBCCCEHFHFEHF:?CBEHE7AEEEC	T	34	C	26
7	142510350	G	132	GgAGaggAGGGGGGAggGAgAGGggAGAGGAAAGGGAgGagGGgAGGGgAAggAAGaAAaAAGAGgGGGgGGgaaagGggaAAgAAagaAgaAGgGaaGGGaaagAAGaAAgAGggGggGAgGgaaAaggAA	8A@;DFFE9DEEEEGFFFGFFEE;FFEFEEF:DEAEDDEGGEAGFEEEGFFGGFEDFFFDFFDECGDDDGDDGGGGGD>HEEEGEEGGGE=EDDGDDGDDDGFGGEEDCEEGDCGGDDECDFEFF>B=?8BC	G	76	A	56
7	142575067	C	230	CTTCCtccttTCctCcttctTctCccCctTCCtTTCCttCTCtCTCCttctCCctCtCCCTTctcTCTTCCCTTTttcctcccTTttCttctcCTCcttttcCtTTcttttCTctccCccTTctctcCtcTcctTtCtcctccttTTTcccctCccctTccCctctcttcctcctctccccttttccttctcttttctcttCccttttttttCccctcctTtccCttttt	D>BDDA6??C??AAACCCA@BDDFDDFCEEEEEDDDDEEGEG;GFEFEDDEFGDEGEGGGEDDEDEGEEGGECEEEEDDEDDDEFEEGEEDEDEEGDEEE:DGDEEDEEAFGEDEDDBDDEEDADECGEDEEDFE?GEDEFEDFFEDEEEDEFGEEEFEEEGE@E<EFBEEFEDFEF@EEE9>BEE?CEEFEFDCEEFEFFFEEFFFF<FDFFEEEFEEFCFEEFFEB>9	T	117	C	113
7	142636599	G	84	gGaGAaAgGGaGGgaaAgGagaaAGgggagGGaaGaGggAAAgGAaGGgGaagGAAggAgAaAGgAAGaAAgGGAaGaagGgGa	AGEGDCEFGHDHFFDCBFHDFDDFIFFFDFHHDCGDHFFEEDGHECHHGHBBGHEEGGDGDEDGEDDGECDEGFCEEBBDEBD=	G	45	A	39
7	142641382	A	72	AgaaAGgGAGgAAGgaAAgGAGGGaGaAgaaaGAAaAAgaAGaAAGgAGaAAgaAGGGgGgggGGGgGGGAA	CCBDFGFGFBFFDHFDFFFGFGGGEGEFGEDEGFEBEFGEFFEDEFEEEEEEGEDEFFAFGGGFFFGFEGCB	G	37	A	35
7	142655078	G	46	aaaAGAgGagAGGgAGaAagagAAggGaAggaagggagagAaaaaa	EFFFEFCEFCFEECFEFGFCECFFDCDF:DDDGDDDGDGDEGFGGG	A	26	G	20
7	142759986	C	172	ccctTCtTtCcTCtTcTTCcTCTTCcTctctctTcccTCcctcTTcttcTCcTCtTCtTCCcTTCTtTCCCttCtCttttTCCCTcTTccCctcTTTtctccCCTtTTCtttccccCTtcCTTtCcttcCTCctccTCCccctCtTTctCTcCTttCcctttttCCTTttcC	AC?C;>CAEEAFEGFBEFFBEFCCFBBBGBGBGFBBBFFB>GBFGBCGBEF;FEGEGG=FFBBDFDAFGEGHHGHFHHHHFEBFECFECCFCACFFFHCHCCFEFHEEEHHHCB=CEEHCEEEHFCHHCFEFCE>CEEFAC=HFHEECHFEAFEHGFCC?EFAD9=CB@=;C	T	87	C	85
7	143036548	T	87	AtAATTaTATTTaatTTAAAtTAaTATTtAATTAtTTAaTAAAATAAATATAATaTTAttAAATtTTTTTATTAaaAaaATAtTAAt	DGHHGHFGHGGGFFFGGHHHHGHGGHGGGHGGGGFFFGG>GGGGFGGGCGFGGFGFFG;CGGGFD9FFFFGFFGFGGFEFED@ABA@	A	44	T	43
7	143043377	C	31	cGgccgccccgggggggcgcccgcgcccggg	AAFADFDDDDC:E?FFEDGDEEGEFEEE;FG	G	16	C	15
7	143085822	G	137	aAAGggaaagGGgAAaaAGGaAGGAgGAggAAAGGagGAAGAAagagGaAAGGGgGaGGAAGGAgaAgGGaAgaggAGaGGGAGgGAAgAgGAgGGaaGAGGGGAaaagaAggAgaagGggAAgGggagAGggggGg	C:=@BABACCECDD?EEEHHECHHEFGEEFEEDHHEEHEEHEEFEDCHDEEGBHFH@HHEDHHEGFDEGGFEEA6FEGFGGGDGFGDDFDHGDEGGEFGDGFGFDDFFGFDFFDFFFGFEF?DDHCDC?BD@;;>?D	G	77	A	60
7	144098992	G	137	GaaAGAGagaGgGaagAAAGaGAAgAaaGAgaaaaAgaGGAaAAggAGaGaGAgaGgAgaGgGAaGaggaaGgGAGAgagagGgaAggaaGAaAaAGggGgggaGgGgaGGGAAagAgaagGgGGAgagaggaagag	CAC?ACDDCEGB?FFCFFEFFGFF>FFFGECFFFCBCGGGFAFFCCFGFGFFECGCDFDGGDGFGGGDDGFGDGEGFDGDGDFDGBDDGGG>GEGEFDDFDDDGEDFDGCFFEEGDEDFGDECEFECGCF@@BB<?@	G	70	A	67
7	146997203	T	68	TTTTTATTATTTTTTTATTAAAATATTATATAtTAAAAAAaTaAttTaTTAATtTATTATtAtTAATt	FGFGGEGGFGGGEGGFFFFF@BFGFGGEGFEEEFEEFEAEDFEEEFFCFACEF:FDEEEFCB@???C@	T	40	A	28
7	149416873	C	109	CTttcccccCCcTTCCcCTcCCCCtcTCcCCtCCTcCcTcCTTccCTtcccctccTctCCctccCCctcCCCccttcTTcttccCTTCttcccctcTCccttctttccc	DBBHABB?BGGBGFGBBGGBGGGGG@EFBGEGDHEBGBEBGGGB<GGHBBBBHBBGCHGGCHCCGG=HAGGG@CHHCGECFFCCFF:FHHCCCCGCFFCCHH=HFHB;@	C	72	T	37
7	149418856	C	59	TtccctCcCTTtCTTcttTCCTTCCTTCttTcTCCtTtcttCcTTccTttCCCCCCtCt	@GAABGDBDFGGCGGBGHGD=GFDDFGDHGGCGDDHGGBHHCCEF@CFHHCCCBBCD@A	T	31	C	28
7	149421773	A	97	GAAAGGagAgGGGaagaAaAGgGGAGGAGAAGAAgGAGGgAgggAaAaAgaggaGaAaAgagaGGGagGAAAagAagaAaAAGgaAgggagagaAaG	5>DABBCEHFCCCDFFFHFHCFCCFCCICHABEFFCHC>FHFGCDGHF?GGGGGBBGGH6DGGCBBGGBGHCGGGFGFGGGGBGEGGGEGGGFCEC?	A	51	G	46
7	149463414	C	25	ttctCTtctttttccTtttctcTct	C@:BBFFBGGGGGBBGHGHCHBFCH	T	17	C	8
7	149500027	C	46	CTTTTccCcTcTCccCCCTTcttCcTcctTccCCCtcCttTtctCc	CFGGFDD@CGDGDDDDDDGGEFFDEGDEBEEECCCFECFEFFEEA>	C	27	T	19
7	149507861	A	35	cCCCACAAAACcACCACCCCACaaCAAcCAACcaC	?GGFEFEFEF9CFFF?FFEFEFHFDEECEDEFB@?	C	20	A	15
7	149511333	G	52	AGGAGGGGGGAGGGAaAAAgAAagGAgGGGAGgAAAGAAGgGAAaGGGgGGG	B9EFEDEEFFFEEEEDEFEDFFGDDEDDA<B:DEEDDEDDDDEDECCA;BB?	G	31	A	21
7	150034378	A	179	gGaaaaGGAaAAAGGAAAAgGGAGGAaGGGaaGAAGAGAGGgaAGaaGgAAGaGAAGGGAGGAAGaAAGGAAGAGAAGGGGGAAGaAAAAGGGGAaggAGaAgaGAGGaGAgAAGAGaaGGAGGgAAaGggGGGGAGAgggGaAGGAGGAGgagGGgGAGAAagaGaGgaaagAGGGGg	B:ACEEDFBEFADEGFFFFEGGFGGCEAGGEEFE:5FCF<=GFFGFFGGBAGFGFE7GGBGGEF8EFFFGFFFDFDEFFFEFEEABE?EEFFFFDDGGEFEEGFFEFFFFEGAEFEFAFFFEFFGEEDFGGFFFFEEEFFFFEEFFEFFEAGFFFF8FDFEDDEEFDDCBAA>A??CCC	G	95	A	84
7	150324825	C	130	TtccTttCcTCcCTcTttcttctctTTcTCcCcctCTtttcctCTcTCTTCcttCTctTTccCtTCCtccttcCCCCcCTCCtttCtTCTtCTTcTTtTtCTcCcTTTtTTtCTCttCctCtCctctctc	ECDC@BBCFGCGDGGFDDGDDGDGDGGGGDGDGGDDHDDDGGDEHGGDGBDHDDDGGDGGGHDEGDDBHHEDHDDDDHDGCCDE@DEF@FECDFDFFEFECFHCHFFFEDFEBEBED?HEDBBE@B=E<>	T	69	C	61
7	150438089	T	140	TCCCcCcTTTTCTCTtttCtCTCccCCttcTTcTccCCtCTtcTctTTTttCcTcTTCCTtCcCTcctTTtttCCCctTTttTcttTccCttTttcCCCtCcTccttcTcCctTcTccccctctCTtccTTTcctctctc	BDB?BCDGGEGGAGGDEDGEGGGDDG@EEDGFDFDDGGEGHDDGDEGFGEEGDGDGGGEFEGDFFEDBFGFFFDGGEAEG:FGEF<GEDFFFGFFEFFGFFEFEEFEEFEF5FFEFBDEEEEDEFEFDEFFFEDCD@@@@	T	71	C	69
7	150444321	G	31	AGGGAAAAAGAAAAgGGaGGGaGAgGaGGGg	CCCCHGGCHAFHCFDB?=BBB?<GDBGBBA:	G	17	A	14
7	150446703	A	57	ATATAAAATAtAAAAAATtTaTTAATATAaAaAAaaTTTAAAaATaaTttttTtaaa	BBEEEEEEEDGEFEECEDGEGE=EEEEEDGCGDDGGDCDDDDGDDGFDHHHHDCE=D	A	35	T	22
7	150446936	A	70	agaGggaaaggGAgaaGaaaaGaaGggagAaAAgaGggaGGAgAgaaagagAgagaagAgagaagaAGGa	C?>ABCEFFFFGEFEFGFFFFGDFGFFFFFDFFFFGFFGGFBGFGGGGDCGFGG>GFGFEGFDGAGDFA?	A	38	G	32
7	150554887	G	118	gGGaGAAAAGaggAGGAaAAaGaggaAgaAAaAGGAgaAAGGgAggaGgAAaAAgAAgAAGaaAAaaAAagggaGAagaGAAaaAGGgGaGAGAggAAaaGGaAAAaAGGgAggGgGG	A<BECHHEHCFCCHCCHFGHE>FCCFHCGGGFGCBHDG;HCBDHDDGBDFHGHHDHHDHGCDGBGGGGGFDDDGBGGDGBAGGGCBADBHBGBGDDGGGGBBHFFFFFBCCB>=<??C	A	67	G	51
7	150558399	G	25	gaagaggggaGggggagggagaggg	CF>CFCCCCFC?DCCGDCDGDGDDD	G	18	A	7
7	150644394	C	25	cCCTTTTCTtcTCCtCtcctCCttT	GDDGGFGD<E@GDDECE<G7C=EEF	T	13	C	12
7	150696008	A	45	GAgAGAGGAGGGGAGAGGGAAgGAAGGgGGAgaGgggaAaGgaAg	AEFBEFEEFEDEDBEFEECFFGEFDDCE?DBDFDGGGEEACEECA	G	28	A	17
7	150696111	T	61	TgGgGgTgtTtgtttttgggTGGGgTTGTgTTGGgtgTTtTTTTtgTGtggGGTttGgttG	<AFEGFGEDFDEE<=D<EFBGGGFFEGFG9FGFGGBDGFEFEFFA5FEEFEFFEDEEF?:B	T	32	G	29
7	150709571	G	62	TggGGtTTtTgttGTTGgGtggtTGGGGgggTttgtgGtgtgtggttTtGgttgGgggtTtG	CC?DBFEFFECGGEFFECEFCCGAEEE9DCD<@HDGDEHDHDHCDH=FHEDBHDD>DDHECB	G	33	T	29
7	150720308	G	67	tGtggtggtgtgtgtgTttTgTtgTgggttTgtgtgggTggtgtTtggtttGtgggtggttggggGG	@@FBC=CCGCGCFCGBEGGFCFGCFCCCGGFCGCACCBFCDGDHDHDDAHHDHCCCHDDHHDDDDBA	G	36	T	31
7	150733271	T	61	CCTCctcCTcccCTcTtTCTCtTTTccTCCTTTtcTCCTccCCCcCttcttTcTttctttt	>D=BEEFG>FFFGEFCEFGEEFEDEFGEAGEEDFGEGGCFFDG=G@FFGFFDGDF;B=??C	T	31	C	30
7	150742408	G	29	ttggttggttTgtTTttTtgGgGttttGg	B:DGCBEDEDFDFFFDFEFGEFD;@EED@	T	18	G	11
7	150747650	G	87	GtggGgTGgtGtTGgttgGTGGTtTTgGTTgGgGttGgTGGgGGttGGgGggTttGtTGtTGTGGGgtgTgggTTtGTtTtggTtGg	>CA@BCFECG8GFDCGGCEF>EFFFECEE5DCCEGHEDEEDCDEHHDEDEBDEHHEHEDHECDD=DDHDEDDCEEHDEGEHDCEFAA	G	49	T	38
7	150825567	C	37	TTCTTCCCTTCCCTCCTTTTCTCCCCTCCCCCTTCgg	BDBCBGGGFEGGG;EDCEDEDEFFEEEEEEFDB;A;:	C	20	T	15
7	150935430	G	66	CggcGCGCgggggGCcCgCCGGCGgcgCCCGGgcgGGCCgGGcGcccccGCgCCGGccGGCcGGCG	FCCB:<EECCCCCEGBFDFFEEE?DBDG7GDCD<DDDDFDDDCDCCCCCDFD8FDDCBCCDBC@>C	G	35	C	31
7	151048484	G	29	GAAAAGGGAAGAGGAAAGAAAAGGAgAaG	CHHHHCB=FHBHCBFHHCG?GGBAGEEAA	A	17	G	12
7	151078845	G	39	AGGAAGAGAAGGaGaGGAGGAAGAaGGGGAAGGAagaGA	AADF@EFEFFD9GEGAEF>EFFEFGDDDCFED:DGDDAB	G	20	A	19
7	154461112	A	152	GGAAgGAAagGAAAGGGGAGgGGGGGGggAAGGAGAagAAaAgAGAgaAgGAgAAAGAGGaAGGaaAAAAaaAaGGggaAaAAGgAGaAAagAGgggaaGaaGAAaAAAAaaAgggagagAGGAAagaGAaaagagGGgagaaggaGgAagA	D?@<CEFFEDGF<EGGGGFGFGGGGGEEFFFGGFGFEEFFEEEFGFFFFFGBFFEEGEBGFFGGFFFFFFFFDFFGFGCEFEEFGEFFDEFGDFGGEFFFFFFEDFEE;EFFEGGGFGFFDFFE9FFFFAFFFG=FEEFFFFFFFDF@=A@B	A	83	G	69
7	154672679	A	74	tATtaaatAAattatTAaaAaaaatTtaataTAttataTTtaaAataTtTtataaaatTAttttatttaTTtat	ABFDDDCDFF6BDDCEEDDFDDDDDGADD>DGFDDEDEGDEEEFAEEGE:EEEEEBEEFECDFEEEEECFB=AC	T	38	A	36
7	154748908	G	38	AaGAagAGAAaAgaGaGAaAgGgaaGgGaGgGgAGGGg	BCHEDFCHEEDAFEHEHEECGGGEEGFGE7FGFDGFGB	G	20	A	18
7	156468377	G	50	GCCCGGcGCCGCGCCCCgCgCCGgCCCGggGGgCCCgGGgccGGCcggGG	6DCD=<G=DD?DC@BDBECFCC@GCCCB@BA@FC=CF@BGCHAACFCBC?	G	26	C	24
7	156468378	C	57	CCCAACCCaCCCAACACAAAACcAcCACcAAACcccCCcAAAcCCcaaCCAaccCCC	C?DHCD@GE>A?HBB;E:BA:GEFE@GCDGGGEDDC7DCGB@EFFEEFE@GCCBBAC	C	35	A	22
7	157903504	C	120	cCCtcCCCCcctTCcccTcttCTTcCcTCTTttCCtCTctcctcCttccTCcttccTCcTtTTcCCTCcTctCTcttcCccctCcctcctccCCCccCtcttTTttttTccccccttcCc	C<>7D@@BCGHDGDGFGFGDDDFFGDGGC6GDDADDEHGAFG=EDDDGGGDGDDGGGDGGEGFFDDGC;GH?DGGECGDHHHBDHHEB?EHGCCCHHCEHEE@FDEEEF@HHGHGDCCAE	C	72	T	48
7	157929294	G	186	AAGGGGAGAAGGAAAGgAaAGGaaGGGGGGAGGAGAAgAGAGGaAGGaaaGAaGAAgAAGaAGgAAGGAAGgGAgaagaGGGAGAaAAaAGGgAGAgAGAGGGGagAGGGaGGGGagaggAAggAAAgGAGaaGAGGAAaGAAgagggggggGGGggAaagAGgagggGGAAAGAgAGaaAAAGAg	:?CFGGFGFFGGFFFGFFEFFGDDFFGGGGFGGEFFFGFGFGGCEGFEECGFEGFFGFF@EFGFFFGGFFGFGFGDEGEGGGFGEEFDEFFFGEFEGEGFFFAFEDEFFFEFFFFDFEGFEEGGEEEGFEFEEFEFFDDEFEEGEFFGFGGGFFFGGE<EGEFGEFF>F>ECDCD?BD@?BB?C?B	G	99	A	87
7	158325316	C	37	CCCCAccAcACCACCCCAACCAaccaaAacAAACcaa	G@GGFCBFCDGGDFFFFEEFFEGCCGFDD==BBA>B=	C	20	A	17
8	401493	T	45	cttccctcctttctccttttttttttcttctttcctcttctttct	AB>DDEFF5DEEFEFFEEEEDD9EEEEE>GFFFGGEGFFAF@FFF	T	29	C	16
8	565232	C	105	CCCGGGGggGcCCGGCGgCcCGCGCgggCGCccgGCcGCGCgGCcGCccGCccGCcGgGcccCCCCGcggGGcccgGGgggCgcGCGcggGggcggCCccgcCgc	@BECEEEFEEDFGEEFEFEDFEFEGFAEFEFDDFEEDEGEGDEFDEE>EEFEEEEDEFEDEEGG=GCEGGBDDDEFDDGGFFBEDEDEGGDFFEFFEEEDECA<A	C	53	G	52
8	623245	T	27	AaTATAAATATATTTTtATTAATTTTT	ECEDE9EDEDDDDCCCEDDDCADDBC<	T	16	A	11
8	1581226	A	144	GagAGaaagaaAaaaaaGAggAAgagaGgAAagaaAgagagaaaGGaggaggaagGAggaaaaGgAGaggGAaAagggagaGaaagagagAaaaGGgGaggagGagAaagagaAgggaGggaggagagagggaaagAgaggaAg	@??==CB=A5BA>BEEDAGGFGFCFFFCEHHFFFFHFFFFFFFECCFFFFFFEFFCGFFFEFFCFHDFFFCIEHFFF@FFECGFFFFDFFHGGFCCGCGGGGGCGGHGGGFGFHGFGGCFGBFGGGGGGGFGGGGGGGGGGGCA	A	76	G	68
8	1791433	C	41	CTTCCCTCCTCTTCCCTTcTTcTctCccTcCCtTTtttTTt	B>EGFFFFGE>FFGBBFFBFFCECHFCCECEEHEEGFCCC@	T	22	C	19
8	1817314	G	58	CGGCCGGGCCGGGGCGCGCCCCCGGGCGGgGGGGCcGgcGCgGGCgGGCGCgCCCGCg	GGGGGGGFABGGFGGGGGGGGFFFGFFFFDFGFFFBFDCFCDFFFCFFFEF>DBDBBA	G	34	C	24
8	1828178	C	88	CGCCggGCcGcgcCCCCGccGCGCCccccGccCGcgggCGGGcgCgcCcCCGgGcgcggGgggggGCGGCcGGCGGCCgGGCCCCCcg	>>?CGFCDFCEFEDDDDCGGCDCDDGGGGCGFDCGGGGD<CBGGDG>DGCCBGBGGCEGBGFFGFBCBBCGBBCBBCCGAABBCB=@;	C	46	G	42
8	2005676	A	190	GGGAAAAaggGagagaGAAAaaGAGGGAGAGAggAGaaagAAaAgggaagGAAAaggGgaaaGgAGAggGaaaaggaGAGgGGgaaGaaGGAGgAAaagAAggGGagagaAAggGGgGaaGaAgAgAAgggAGGAggaaggagAGgAgaagaaGGGaaagggAGaAGAAaaGaGaAGaGggAgaGGGAag	@;<@CC?CBFBAFDECC;H>CDCHCCCHCH?HFFHCDDDFHHDHFFFDDFCHHHAFFCF7AECCGCHFECDEDEGGBBEBGCCGEECAECCCBGHH=EGHFGDCCDGEFDHH8GCCGC>ECE@GGGGGGGGG@BGGEEEGEEGHBGGDEEG?C9BBBCDGGG=BEFBGGEEBEB?F@A=B9;><A?C?BD	G	96	A	94
8	2005923	T	165	ttcttttcTccTCTtttTTCCCTctCTcTTtTTCCtccTTTCccttcctccctttttcTcttcctCCcctCCcctTctTcTTtttCCtCCctcTctccTTtcctcctcctcctTtctcctcCtctccctTtcCccctttctttcTccctCtcttttccctcttcc	AC?BBCC<:9@CDEGGGFDFFF=AFFBBECGFFFGCBBFF=FBBGGBBGBBBG5GBGAFBGGB@AGBBBG7GBBGFCGFBFFGGGGFHDGCHC>CGBBE;GCCH@CCBCH;@HFHCGCAHCFH?HBCCGEGCGCCCHHHCHHHCECCCHFHCHHHHC9AHCFC7;	T	84	C	81
8	2033330	C	35	TCTTTTCCcCCCTCTCCCTcTCCTTTTCCTTTCcC	GDGFGGDCCDCDGCG9CCFCFCCEDFFCCDEBB:?	C	19	T	16
8	2056569	C	94	tCtctcCTtCTTCtCTTTTtCtCtcTcTTctcctCCCTttcCCCTTCtcTttcCccttccttctTtTttCcCtcCTtccCCctctctcccctTt	ABC8CBG>FGDEEGGDECCGGGHGAEBEEBGBBGGGGEGHBGFFDEEH6EHH>ECBHGCCHH@HEHDCHFCFHCFDICCFFCHCHCF8A@BD<B	T	48	C	46
8	2091184	T	48	CTCTTTCCTcCCCTCcCCTTCCTCCTTCTTCccttCtCCcCCCcCCTT	FEGGGGFFGEGGFFCEFFAFFFFFFFFFFFFEEEEFDFFCCAA>AACA	C	30	T	18
8	2807783	G	109	GaGGAGaGGGgAgAGAGaAGaaAAggAggGGggGGAggggaaAGgaGgGGAAAgAagGAaGgAggGGAAAgGAgGGgGGAgaAagGaggAaAAaaAaAAaAGAagGaAG	@C<6B?CBBCFHEHCHC9HCDDHIEEHGGCBFFBCHEGFDECHCGE;GCBHHHEHEGCGECGHGGB@HGFEBGF?BHBBGGEGEGBEGGGDGGCECEGFEE8C=;>=A?	G	58	A	51
8	2964003	T	44	TCTCTCCTCTTCCTCCCCTTCTtCTCCCCTCTCCtCCTtcCTTC	EGEGEEGEGEEGGEGFGEDDF?FFDFFFFDFDFFFFFAFEFDDC	C	25	T	19
8	3474342	C	171	cccccttcttcctccCCCctTcttccCtccccCtCTcttTcccctcttttcttctcCctttcccccTccCctttTtTctttttttcttctcctctttcttctctccttttcCCCttcCttcccctccttttctttctcttcctcttttcCctttctctccctcttcccccc	AA@@D@A?AAEEBFAFFFGEDFDDGGGCGGGFFDGEGDDEGGGGDGDDDDGDDGDGGGDDDGGGGGBCGEFADDCDEGDDDDDDDGDDGDGGDFDDDGEDGDFDGGDEEEH@FGDDFGEDGHHHEFGEEEEGEEEHEHEEHHE7DEEBHGGEEEGEHEHHHEHEEGHGEC@	C	88	T	83
8	4495107	G	38	cgCGgggggcCcgcGgCgcggggcgGcgcggGggcggc	CBEFGFEFDDHDEDGFGFEFGGFE7G?FEFFGGFEFF9	G	25	C	13
8	6372172	T	98	CTCcTcTCtTCTCTCtcCcTTTTTCtccctCcCTTcCccCTtCTtTtCTCcctcttCcccTttTCTtctTTctCTTcTtttCtTTtCtcTctcTtTtt	A>?@?ADGEEGEGEGDCFDEDEDEGEDDDEEDEDADGBEGEFD<FDEGEEDEFEFEGEEEDF<DFDFEFACFCFDDEDFFFFFCCDE?CCECDC@A@A	T	55	C	43
8	6500544	C	147	CTCtTCCtCCctCTtTtTcCcccCCTCCCCCtCCttTtCCTttcCtttTtttcCcccttCCCttCTctctcCCTCTcccCTtTCtctCttcctcctTTTCTCTTtccccCCCtCtcTtcTCctCTtttctCcCcTcccTcCctCccT	AB8?A>=A??CCCEEGEFDDDDDDDGDBDCDEEDEEHEEBHBDDDEEEGEEEDDEDCEFD?DEEDGEFEFECDGDGDDEDFFFCFEFDFFEEEEEFGFF=FCFFFEBEEBBCF@FDDFEFCED@FFFEE<CECEEEEDFDCA8B?@A	C	81	T	66
8	8234714	C	97	TcccctcTTTCtttttCctttctttccCttttttTTCctCtccTCcTcTcCctTcTccCcTtTcTctccctccCttTtCcCCttTCttcTTTcCCCT	CCCA<B=B=CBHGGFFCBGFCBGGGABDGGFGEGGFDBGDGBBHDBGBGBDCHGBGBCCBG<CCGCHCAC@CCDHAF;7CCCGHBCCHCF@FABA=C	T	51	C	46
8	10383226	C	45	GcggCggcCgGgCGggCGCgGcggggcggGggggcggcgGcccgc	>BFCDFFEDF=FDCFFDC>FC=FFFFGGGCGGGGFGGDG7GE<GB	G	30	C	15
8	10383231	C	43	ggggcCCgGgCGggCGCgGggggcggGggggcgcgcgGccgcG	?@BBAACFHEGGFFGHFEGEFFE6EEGFGFGBEEFCGGE9;E?	G	30	C	13
8	10466482	G	102	AgaaaagaAAgaAAgAGggGagaGGGAAaAaaAGAGgGAGGGaaagAAgAAGgagaAGGagGAAAGGGgGAaGAgAGgAgGaaAgAgGAAAAAGgGaagAGg	C@BBACFEFFFEFEF<EEFEEFEEFEEFE@EEF;EEEEEEE?FFF@EFFFFEGFG<EEDFFDCE9DDDFDEEDDFEDGEFAFFEGDGCDFEFCCBB;>AAB;	A	54	G	48
8	10468172	G	185	AAGAggagGGAAaGgGaAAaaGgaaAAaAGgAgaGAggGGGGaAAGGAagGgagAgGAaggAgGaAagAGAaaaGagAGggAAGAaAaaAGGAGGgaggaGggAgAAaaAGaagAaggaAGAGAaaaaAGGGGAggGGaaagAAGAGAgGGaAGAGagaGGGgggggGGGaaAAGGGaGAgGGAA	DD=CCCC?<;@BA>CADHHDDCFDDHHDHBFHFDCHFFCC:CDHFA;GDFCGDFBFCHEFFHFCBHEGHCH;EECEFHCGGHH;HEGEEHCCHCCGDEGEBFGHGHD;EHCEBG@DGGEF:G9GEEEEGAABBFGGB;EE;GGGBGBGGBBFGBGBEGCBBBGGAGGBBA9EFGBB@??B@<A@C	G	93	A	92
8	10469030	G	67	gagaAAAggggGgaAaGaAaaaaAaGgaGaggAggaaAGgaaAAaaaggaGAgGAgaagAGGGGGGa	CA<ACEGDFFDCFEHECEGE?E?HECFFCFGGBFGFCHCGF;GHEBEFFBBGFBGF<:GG;B?AC?B	A	36	G	31
8	10469233	A	83	gggAagAaggGAAGgAGAaGGgaAaagaAAGaAaaAGgGgGAGaaaGaAGgggagggagagaaAggAaAGgaGAagaagaAgG	@BADECFFCBCHHC@GCHFCBCFHFFCFCHCFHFFHCDCC>HCGFGCGHCDDD=D>DGCGDEGGC@GHGBCGAGGDDGBFG>C	A	43	G	40
8	10531087	A	26	AAGaaAGAAGgaAGgGAGaGAggGGG	BEHFGDFEEHGGDHGGDGGFDGG?C?	G	14	A	12
8	10692158	C	124	CTTCTCTCTTTCTTTTcCTCtCcTTCCCCcTCCCTCCtTTTCCTTcCTTTCTtCCCCtTtCcccTCctcCTtTttcTTtCTTtCCTTctCcCCCCTtCTTCCCTTCTCcCCTCtCccttccCTT	?BGDG@GEGGHDGGGGBDGDHDBGGDDDDCFDCDGDDHFGGDDGDCCGFFDFH@DDDHEGCABCFC@HCDFHFHHCFFHCFFHCCFFCHCCACCCFHCFFCCCFFCFCCCCFBHC?>CC>>@DC	C	64	T	60
8	11422045	G	206	AAagAGggGGGGGgGgaGAaaAGGGgAGGGGAgGGgGGGAGAAGaAGGGGAAGAaGaAAGGGGAAAGGGgggggGGgAgggGAGGgAAAAGgGAggAAGGGaAAAAaGAAGgAGAaGGAGAgGGAgaAGAgagGggGaGAaGgGGAAAGaAgaAGAAgaGAGgGGaGGaAAAaGAGaGAAGaaGaGaggAaaGGggggaGGaagga	@?ADAFEEE@GFBAGFECFDEFF;GDFGGGGFECFFFGGFGFFBEFBGGGFF>FEGFBFGGF6EFFG@GGEFGDGG9FDFBGFFGGEEEFGFGFFCFFGFFFFEEEFEEEFGEFEBG<EFAGEFEFFBFEFF?FEGFFFEFFGFFECEFBEEEAFEEGFFEFFFFFEFDEEEEFEFEFEDEEFFFBEEFEEDEEBBBB;???ADCC	G	118	A	88
8	11619635	T	40	TtatttaTaaaaatataAtATtTTAtaattttttaataat	C?A=EEEGFFFFFEFEFHEHGFGGHFGAFFEFFEGEFEGD	T	22	A	18
8	12863700	G	143	CGcgGCGCCGcGGcGCGCCGgGCCcCcgGCgGCggGcccgcGgCcggCGcGCGccgCCgGGcGgGCcCgcCCcggCGgCGGgGGCGCgcggCGCCGCGCGCGCgCgCcCcgGgCggcgCgggcgCCggccCcgccgcGcGccc	?BCCGFFGGHFHHFGFHGGHFHGGFGFFGGFIGFCHFFFFFH:GGGFGHGHGHGGGFGGHHGHGHG>GGDGGFGGGGGFHHGFFFHFGFGG@GFFGFGFGFGFGFDFBFGGGGFCEGGFGGGFGFFGGGFE<DGGGFGFD@?<	C	72	G	71
8	12879099	G	203	GaggGGGgAGaaAaGggGGGagagGaAGaAAGGAGGAGAggGGAAgGGAGaGGAgaAGGgGAAGAaaAgaGAGAGggAAgagAAgAGAAgAaAAAGGggGGGGGGAgAAgggGGgGGaggagAAAaGgGaAgaGGGaGaAgaggGAGGaagAGAgGaGAGaaaAAGgAaggAaAgaGGAaagaGgGgGGagagAagggAGgaA	B?A@89=@CDFFDFCCB<AEFCFCEFFDFFFDEFEDFEFCCEEFFCEDFEFFFF@FFEEC9AFAFFGFCFEFEFD>CCFDCDFFDFEFFDFGFEFEED?EEEEEEFCFEDDDEEDDDGDDGDEEEGDDDGDDGDD9GDGDDGDDDEDDGHDEDEDDGDEDGGGEEDDEGDDEGEDGDDDFGCGCCCBCDECC@BA<>>BA=@A	G	113	A	90
8	12879539	A	96	AGagAGagGGGaagGAGaaAgggGAagAaaGaAGggggGAgaGAagaGaggGAgaggaggAAgagGAggaAaggagAaaggGAaAaaagAggaagg	BA?=A@@BADCGGCADEFFFCCCEFFCFFFEFFBCCCCEE@EEFFCFEGCDEFCF=DGDDFFDGCEF@DGFGDDGDEGGDC=BGEFGGDDDDGC@>	G	50	A	46
8	12952230	C	134	CtcCcTTCtTCTCTTtCTCCtTtCCCCTCCTCTCtTttCCTTcTCCCCTCCCTCCCCTCtTCCTTCCTCTCTCTTTCCCCCTccTCTCTCcTTCtctTCTTCttcCTCccTTcTtTTCtccCccCtTCtTTccc	8DD7EDDGEEGDCEEFEEGGFEFEGGGEGFEGEGFC<FFDDCBDFGGGEFFFEGFFFEFEDFFDCDFCFDFDFDDDGFFFFDEEDCDFDFEDDFFE?DFCDC@FDFDDEEDDDDFDDFDEEFD<DAAB<CCBBB	C	72	T	62
8	12958025	C	92	accaaaaaCAACACCCAcaACCACAacaCcaaCcCAaaaAAaccCcAaCCCCACCcaAacaccacAccCcCAACaaCCcaAccAccccAaCa	C?CDBFEEGBFGEFFFFBF?FFFGF?BFG@EFGAFAB<;FBF>BFBFGEGGGEGFBGF?CGCCGB=CCGCE8;F5GFF<GEA7E:CB@DGE?	C	48	A	44
8	12973078	T	103	CTTCCtCTCCTCTTCTTcCTCCccTTCTTTCTTTCTTTtTTCTTCcTCtTCcCCCCTCttCtCCCTCTCcCTtcTtTTTtctcCccCCccTTcTCTTtTCCCt	?>DGFGFFGGE?FFFFFBFFFFBBFFDEFFGFEEECFFGFFGFFFCFGHFFCGGGDDDFGFHFDFEFEECFEH;EHEEEHCHCECCFECCDDCEECDCCA??A	T	52	C	51
8	17068013	T	25	ttttgGggTttggtgggttGgtttg	CC?CBDGEEEEFFEFGDFFGGDFFG	T	13	G	12
8	17074640	C	44	GCcCGGCgCCGccgGGgGcCcGCCgGccgCccgGCGcgCggCgC	<GGGHHGDEGHGHFGHGEHFGHGG7HGHGFHHAGFGFGFGGFCB	C	23	G	21
8	17166765	A	31	AGAAGGGGGaAGGGGGAAgGGgGGaAAAGAa	BAEFGFGGDEFFGEFFEFFFFFFEBDDCACC	G	18	A	13
8	17328774	C	43	CTCcCtccCTTtctTctCCtccttccccttcccCtttCccTct	AD=GBDGGDGFDGDGGDDDEHHEEEHHHEEGHHCE7ECHHFF=	C	25	T	18
8	17732084	G	25	cgcgccgcccccccccggccgggcg	ADFFGGEFFGGEGHHGDFHHGFGHF	C	16	G	9
8	17796382	A	145	AAAAGAAGaGAGGaggagGgAGaGGAAGgggAAGAGggGAGgAAgGAGAaGgAAGAaAGgAagGaaAAgAAgAAGAaGAAAggaAAAAGGAAGGgGaaAagAggAaaGaGaGAAGaggAaGAaAaGGGaaaGGGggGGgAaAAAa	A>BCGDFFDGFBGDFFDFGDFG;?GGGHFFFAFGFG;FBFGCEFFGFFFEFFFFFFFEGGEFGGCDFFGFFGFDGEEGEEE?GFAEEEFFFFFFGFBDE=GDGGEF9FFFFFEEFEGGEEFE@ECFFD7EBFFFFEEECB<BBCB	A	78	G	67
8	17796383	C	155	CCCCTCCTcTCTTcttctTtCTcTTCCTtttCCTCTttTCTtCCCtTCTCcTtCcCTCcCTtCctTccCcCtcCCctCCTCcTCCCttcCCCCTTCCTTtTccCctCtctcCccTcTcTCCTcttCcTCcCccTTTcccTcTTttTTtCcCCCcc	D?BBEEGFDFGEED>EDEFEGFD?FDGFEECGGFGFDEFGFDE:GEEGFEDFEGAGFFE;FF<EFFE?GDGFEGGDFFFFFEEGFFDFECGFFEEFFEEFFEEFB<DF<CEFEEEEEEEFFEEFFFDEFEFEDEEDEDEEEDDFEFFBB?==B=B	C	88	T	67
8	17920807	A	60	gGaaagGgaagggagGGAAagaAgaaggagagaagggggAggaggggggggggggggggg	@@CAAAABCCBBBDDFEEEEFEEFFFFFFFFFFDFFFFFFFFFFFFFFFFFFFGGCDGDG	G	41	A	19
8	17927327	T	31	ccCCTCCCTTtTCcccTTttCtTtcCcTtcc	FEGGGGGGGGEGGFFFFFEFDFGFGFEEFGB	C	17	T	14
8	18457957	A	34	GaagggAgAAAgaaAgAggagGgAaaaAAGaAgg	=BCFFEFFFFEFDCFFFGGEGEEFEDEE?DEEGA	A	19	G	15
8	18729529	C	111	GcgGggcGcgcccggccGgcgCcgcgcgCcgCGcggGccgcggcggccCGgGcGcccCgccCcggCcgcGGGcggCCCCCCCcgCCGcccCCcgGcGccggggGgcGGccc	:ADAEEC7DFCDDFEDDCFDDDDDDEDFDDEDADFFBDDDDFFDDEDCC9EBECD@EDFDECEGFD<GECCCEDEDDDDCCDEGDCBBEECCEABE:EEDEGFBGEAC>==	C	60	G	51
8	18729817	G	128	aGGGGGggggAAAAaaAAaaaAaaaAaaaaAaAAaaAaAAaaaaaaaAaaAaAaaaAaaAAAaaaaAaAAAaaaaaAaAaaAAAAaaaAAAAAaaaAaaAAAaaAaaaaAAAAaAAAAAAAAAaaaAa	?B?;9@@ABBGAEFEFHHFFFHFFFHFFCFHFBDFFHFHHFFFFFGFHFF?FGEGG=BGHGGGGGGHGHHFFAGGGHGHDFCFGH8GGHH@GGGGGEGEEGGGGGHGG>EGGGDGGEBGF8GFGFFBD	A	119	G	9
8	18729818	T	124	TTTTttttGGGGggGGgggGgggGggggGgGggGgGGgggggggGggGgGgggGggGGGggggGgGGGgggggGgGggGGGggGGGGGgggGggGGGggGgGgggGGGGgGGGGGGGGGgggGg	A>>=?ACADEFEEFGGFFFFFFFFFFFFGFCFEGFGDFFFFFGFGFEB;DDFFF=GGDDGGGGGDGGFFGFFGGGGDDBFGGGGGFFFGEGEGGEFFGGFF9EGGFFFFGFFFFFFAFEGGFFF	G	116	T	8
8	19171376	G	48	GTGggTTtTgGGGggTggttGgTgttGgTGgtggGtGTGgttTgggtt	@B@BGDGEFFCCCFFGFFDEAFCFEFBE7BGEGGAFBDBEA;FGAGAD	G	28	T	20
8	21550768	A	121	CCCACAACCACCCACCCCACAACACAAACAAACAAACACCACAACCAAACCACAAaCAAAaCCCCaCccCAAACCCaCAAaCCAACccacAACaCAACAcAAAccACCcCcCCACaCccCA	;9B=BEE@CEDGGEGGGGEGEEG<GEEEGEEE7AEEGEFFDGEEFFECDGFDFDDGFDDDFFFFFGFGEFDDDFFFFFDDGFFDDFCGG9DDFEFDDFDGCDDGFCEFFGECDCDCCA@BC	C	64	A	57
8	21891939	G	44	GaAGGgAGGAGGAGaGgGGAaGgagaaAGAaaggGGaAGGGaGg	>E>CCCH>CHCCHCGCDCBHGCDDDGGGBGGGBCBBGCBA?B=@	G	26	A	18
8	21900402	G	113	AGAaGGGAaGGGAGAaGGAGGgAGAGAAgggAAggAGgaGaggagGAagaGgGggagAaGGaAGGGAaaaaGaAgGgagaGAaGGgagaaAGaggGGaAgAGAAGgAGaaAAg	;>EEEEEFEEDEFEEFEEEEDCFDCEFFCDDFFDDEEDGEECDGDEFGDFEDEBDGDEGDECEDDCDFCFGDGEDCDGDFDEGDDDGDGEECGDCDDGECEDEEDCDBBBACA	G	60	A	53
8	21964802	C	45	CCTTTCCTCCTCtTCTTTCCTTTCCtCTtTTcTcCtttCCCccCc	DDGGGD@GDEGDCGDGFG@DGGGDCFCFFCFEFECFFDCCB@?A>	C	23	T	22
8	21967075	G	25	ggGGtggtggTGgGtTTgggTTTGT	C@@DGBCGCCFDCEH;EDEDEEE<A	G	15	T	10
8	21984650	A	59	GGgaAaaGAAaGgGGGAagAaAGgagAAAaggGaGAAAaGagaAGGgggAGGAAagAaA	?AFDEDDEEFDEFDDEBDF:DEDFDGFFEEGGAEE:EEEDCEEED@GGGEDDDEEGC<C	A	32	G	27
8	22104691	G	98	TTGTTGTGTGGtgTtGGttGTtgtTTGGggGTGGgGTTTtttGtTgGGTgtGtGGgtgTgtttTtTggGGgtGTtgTtGtGGTtTTTtTGTGgGTGtg	;A?BA>>EEEEEFFEEAEEEFEFEFEEEGFEFEDGEFFCFFFEFFGEEFGFEFEDDFGEGFFFDFDGGCD?ACEFGEEDFDDDEEEEEDDECFACA>A	T	52	G	46
8	22389900	T	42	TtgggtGGtttTttggGtgTggtgggttttttggtggttgtt	BACBBA:CDDDEDDFFGDFFFFDFFGCDEEEEGGEGGEFGED	T	23	G	19
8	22852043	C	25	cCCTtTCCTCTCTCTCTCTTCTCTT	@DDGFGDDGDFCFCFCF>FFCEBCD	T	13	C	12
8	22885153	G	67	gGGGAGAGAGGGGAAGAAAGAAGAAAgGAAGAAGGAaAGGAagaAAGgAAGgaAGaGAaaAAgGGgg	C=:EFEFEAEEEEFBDBEFEFFEFFFGDEFDCEDDDDBDDDEGDE=DGEECGDADADEE<DCDBA@?	A	35	G	32
8	23117643	T	47	TCTTTCCTTtCCcTCCTCTCcTTCCTCCCTTTCTCCTcTcCttTcCc	?GFFFF7E=F=FDFGFFFFFEEEFFD8CEEEEFEFFECEEECEC=CB	C	25	T	22
8	23160777	C	46	CGCCCCCCGGCGGCGCCCCCGgGGGCCCGGccGCCCCCCGGccGCC	BCDDDDDDCBDCCDBCCCCCBDBBBCCCBBDEBCCCCBBAADC@@?	C	29	G	17
8	23160778	C	47	CGCCCCCCGGCGGCGCCCCCGgGGGCGCGGccGCCCCCCGGccGCCC	DDEEDDDDEEDEDDECCCCCDGDDDCBCDDEEDCCCCCCCCE@DA@C	C	29	G	18
8	23261651	C	32	AcAaaccACCAaaACaCcaacaaaCcccccac	@CGBFACDDDGEEHADDCFFEBFF7EEEAEFE	A	16	C	16
8	23290451	C	39	TCTCTctTCCCTttcttCCttTcCTCctctcCTttTCCt	B@GDEBGGDDDGGGBHGC7HHGCCFCCHCHCCFHHFCDA	T	21	C	18
8	23301340	A	127	CACCACCCCCACAAACaCAAACACCAcCAaCCCCCcACaAacAcCAcACcCAACacacCaACCccCAAACcAAcaACaAACACCACAcaACCAccaCACAAccacAcaacaCACAacAACACAcaCC	D>?ADGGEGGEEDFFGD:?EEGEGGEGGDEFGGFGHEFEDEHEGGEHEGGGEEGEHEHEEEFGHHFDDDFHDDHEDFEDDFDFFDFDHDDFFDHFEFDFDDHHEGDHEEHDECECDFEDFACCC?BA	C	67	A	60
8	23431344	C	144	CACCaACCCacCAAAAAaaaAAAccAcaAAcAaCACAACAAAAAACCCaACAcaAcCAACACaCCCaACcaCaaCCacaaCAcCaaAcCaaacaAcAAaACAcAcAcCCcaaACacaAaaaCCCCacaCcAaAcacAccAcAaa	D?@@C@CEGFFGE=F@FFFFFFFFFFFFFFDFFGFEFFEFEFFFFGGGF:GEFEFDGFFGFGGGFGF@EFFGGGGGEFD@FE5BGGFFFF9GGGEFEEFEFE:BGEGFFGGGEFEGGEEGGFFFFEFGFFEBDCEACBAA??:<	A	83	C	61
8	24199063	G	53	GAGAAAGGGGGAGGAAAAGAAGGAAGGGGGGGGGGAaAAGgGGGaaAGAGgGg	HDHEEEHH;HHBHHEEDEHEDHGADGFGGGG>GGGDGD>GGGGGGGCFCGCCD	G	32	A	21
8	25250423	A	123	GgaaggAgaaggaaAgGaggaaaagagagGaagaGagaaggaagggaagaaggagggagaGggaaagaaggaggggGgaagagaggggagagagagggggggggaggaagggaggagagggaa	BC@C@A>;DDABDCACGEBBFFFDCFCFCHFFCFHFCFFCCFFCCCFFCFFCCFCCCFCFHCCFFFAFFCCGDCC8HCFFCFCFDDDC<CF<FDGDDDDDDDD?GDD8GDDDGDDGDHDDDA?	G	71	A	52
8	25267622	A	151	GGgaGGGgGggaAGagagaGAgagaGgaaaGgaAGAAGGAaGgGGAAAAAaGgaAGAAgAGAggGGGAGaAAAGGgAaAAAAAgagGGgGaGaGGGgGggaGagaAgaGgGaAAGgaGgAGgGGAgaAAgaAAaaGGggaGggaGaAAGGa	;>A>CCCFCFFFABFFEFECEFDFFCFFFFAFFHCHHCCFECGCCGHHH:GBGGDCHHGGBHAECCCHCGHCGABGGFGGGGGDGGBBG<F8G@@@:BGGFBFHGGGHBGBGGE9GG<GGBGBBGGGFFG<FGFCAABBA5<<?=:CC??=	G	81	A	70
8	25287556	A	50	aagAAagAaagaaAagaagggAgAggaGagaaAgaagaaaAgagaaAgaa	CADEFCFFDDDDDDDFDDFFFFFFFGDFDFEDFFEEGBEEFFEGEEEGEE	A	33	G	17
8	25293858	C	28	TtCTCTTTTTCCtCCCTtccTCTctttC	ADGCGHGGGGGGEGGGFEGHFFFHEED>	T	16	C	12
8	25744257	G	95	AAAAAGAAGAAAAAGGAAAGGGGAGGAGGAggGAGAgaGAGGaGAGgggGAGaaaggAGAagaGgaAGGGaAGgaaAggGAAAAAaGagGggGGG	CFHHFCGACHHHH:DCHHHCC?CHCCHC?GCGAHCHGGCHC@CCFCFGDCHBFFGGGFAGFGGBGGGBBBGG@DGG?GGBFGFGGA>BA>B?CCC	G	49	A	46
8	27255263	A	76	AaaAggGaAgaAggGAGGAgAgGaGGAaggaagaGAAaaAaGaagAgGaaGgaaGaggaGaaaaggaGagAaAaaG	C@<BGFGCFFDFFFGFGGEFFFGDGGEDG5EDGBFEFEEEEGEDGFGGEEGGEEFEGGEFEEEEGGEF8GEEEED>	A	43	G	33
8	27312040	C	48	CCCCCTTTTTTCCcCCCCTCTTTTTCTCTCtTCTTTCTCCccCTcTtC	EGG8F:BEEEEGGEGGFFDFDDDDDFCFDFFDFDDCDDFF9EGDBBA@	C	25	T	23
8	27324822	T	83	tccTcCcTtTctTTTCttCTCctTTCccttTCctTTCtccCttCTTTtttCctccttCtctttCtcCtcccTttCtccttTcc	C????FBEGFBGFEFGGGFBFBGFFGBBGCFGCGFFFHACGCGFDEFHHGGCHC>HHFHCHCAEHCFFCABEHHFHC?DD:=@	T	46	C	37
8	27779545	C	94	tCctcTcctCTTtCCcTCCTTTtTCctCCCCTctCCCTCCTCCCcctTcCTcttTCtCttCTTTcTTccTtcCTtCcCcTTtcTccTtTtccCt	A:DBG?FGDG6BDGGG=HBGFECGGFCGGGEFH?DGGFCGGGGGHH?GHFEHCEDD?FEEFFFFHFFIHFB;FEEFFFHFFEGEFHE:GAGG??	C	49	T	45
8	27779811	C	59	TtcTcccccttctttttttctCcctcttTcTCcTCtcCctcttctTtttctcttctctt	DA@;A@=@BBDDEEE:EDEDEDDDEDEEGDGDDFDFECEEDACE:FFFF?FE?DE?E>A	T	34	C	25
8	27880826	C	56	TTTTTTCtTCcTCTCTcTCCTttTCCTTCTTCCTCTCctcTCCcTCctCTTttttC	GGGHGGDEGDDGDFCGDGDDGFECCDGGDGFCDFCF=E@EF?CCFCEF@FEFEEAA	T	32	C	24
8	28304769	C	68	CTcCtCCCCTtTCtttTTccCtctCCtCcTcccCcCctCTCtTTccccCcTttCcCccttcccTccCt	A>DDBFF8EEDBGDDDFEGGHDGDGGDGGEHHHGHGHEAEGEEEHHHHFGDEDFHCHFEDEHHACHF=	C	42	T	26
8	29005128	A	88	GGGggaagaaaAGgggAaggggGGaggggggAagAAAaagAgGGAGaGggggAaAggAagagagaggaaAgagagggagggaaaagag	:?>CBEDGGFEHAFFFGFFFFFCCFFFFFFFGEFHHGFFFHFCCH<FCGGGGHGHGGHFGGFGDGGGGFHGGGGGGGGGGDEGGGGGG	G	50	A	38
8	37418127	G	46	TgGtttgGGGggGgTggtGgGTTgtgTTgGgGTtGTtGtttgtttg	?<=CEEFC6CFFC8GFFE?FAGGG@GGGGCACF?AE;BFFEGFEF;	G	25	T	21
8	37730456	G	84	TTtgggGgtgggggtGtTtgttgggGGgggGTgGTGGgGggtTtGgGgTggGtggttgTgGgggGtGtgggtGtgggGTttGgg	>>@@A@>AGBCCCBGHGEGCGGCCCHHCCCHDC@AHHCHCCGDHHDHCEDDHH9DH@DED8DDDGHGHDDDHFFDDDGD<GG<A	G	57	T	27
8	38835456	T	32	TTCCTCCCTTTCCTTCTtTTCcCCCCCCCCcT	BFGGEDGFEEEDFDDFDFDDFGFF7AFEEBAC	C	19	T	13
8	38851204	A	115	AAAaccaCcaCaaCCCCcaacaccAACCAAaCcaAcaACaaacccCAaCcCcacacaaaaaaCccCCAcAcaCcaAccaacacCCAcAcaaAcCAaaAaCcCaaccaacAcCcca	AABDFFAGFDGDAGGGGGDDGDEGFFGG9G@GGEFGDFGCADGFHFFCGHGGEHCFEE<EEEGHHGGFHFHEGHEDGHEEFEHFFEHEEEEEHFEEEBEFHFFDFHE>EEBFE;B	C	58	A	57
8	38947482	A	53	AAGGGAGGGGAGAAGGAAAGGGGGGGAGAGAAGGGgGAGGAGGAggAAGGAAg	FFHGGFGGGAFGFDGGFFBGFFFFBFEFEFEEFFFGFEFFEFEDEFABCDABB	G	33	A	20
8	39463823	T	46	TTCCTCCTCCTTTCTtttTcccTcTttcTTCtCtcCCTTcTctTtT	EDGHEGGDGGEEDGEDEECH8HEH=EEGDDFEF7GFFDDHDEED9A	T	27	C	19
8	40389823	C	94	CCaCcacccccCaaAcaaAaacAcccaccCaaaACaacaaaCaACcACAacccccaccCaacaAccccCaaCacccAaaccacaccccCccaca	B>:BCDDCCDDEDE>DDEEE;D@DCDEDDDEEEFGDEDEE=GEEADDGEFEDE>EBEE9FDEEEEDEEEEEFFDEE7BFFEBEDEEEDDDDE@>	C	53	A	41
8	42037630	C	40	CtcTttccTtcttccTttctccCTCtCcccCtCTTTCTTc	@?ABB@DDGEDE9DDH9EDFCEDFCECE>ACECFEGBCC=	C	20	T	20
8	55542540	G	56	AAgaaAAGAAgaAgAGAAggAgAgAGAGGagaGGAaGGGAAaagAGAgGGagagaA	>?CEEEEHEEFFCDFGEECFEFDGEHEHHFGGHFEGGGGCDGGGDGDGFG?CB=A@	A	31	G	25
8	56365320	G	41	TTGtTgttGTGtttTtGggTgGgGggtgTttgggtTgGTtT	AA>DGFEECGCEEEEECGGGGCDBGGCGDFEG:EGFGAEBC	T	22	G	19
8	63976754	A	60	AGGGAAaAAAGAAGGAGAGAgGGAAaGAGGGAgAGGGGgggAGAgAgagGaagaaagAAa	?GGHEEF;EEHECGHEHEHEGHHEDGHEHHHDGEGGGGGGCDGDFDGGGGGFGEFCA?=@	A	30	G	30
8	67361264	T	34	cTCcCtcTtcttTCctCccTtcCCCctccCttcT	A?D@FFBEGBGGFCBGGCBEGBDGFCHCCFHHCD	C	20	T	14
8	69104521	A	39	AAGGGGAAGaGGGGAGGGGAGAGgGAAaAggGAgGAGAG	FFEEBEFFEDDDDDEDCDDEDEDEDE?EDEFCDCB:AAA	G	24	A	15
8	69136871	T	105	ATATtTAaTtTttTttAaaATtaTAtTTtatATTTttaAAAaATtaattatattATttTtAataTAaATATTaTATTaTTtTTTtttAAattaaTAAAAATaTtt	<@9AD9DEEEGCEBEEFEEFGEEGFEEGEE=FGG@DEEFFFEFGFBFFEEFFFFFGCFGEFFFFGFFEGEFFEFCFFGEFEFFEFFFEEFFEFDFDEFEC@AA==	T	61	A	44
8	69136959	G	94	ggaaGAAAAAGaGggAAAggAggAGggaGGgGgaAaaGGgaagAggGGGaGgAgaagAgAaggGaaAggGaAgGagAagagaaggagaggggaa	BBDDBGFHGE=EBFFHHHFCHFFCCFFFCCF?DEIFDBCFFFFGF=;CCFBGHAGFGHGHFFGBGGHGGBBHAAGGGEHEGGGGGAGGGFGEB;	G	51	A	43
8	71512377	C	60	TctTTCctTtTctCtctTtTTtCCtCCCcCcctTTtCTTCccccTtCtCttctctcTttc	BAG>EGBFBGFAGEGBGEHECGGFHGEGCGACHDEHEDEFCCC=DHFHFHGCHBHCCCC@	T	33	C	27
8	71550708	C	25	CcTccctCCTTCCCCtCctCcctTt	GDEDDEFGGDDFFCFFFEFFDDE@@	C	16	T	9
8	72975801	T	36	tggggGtgggGGgtgTTgGttgttgttGgGgtgggg	CBDGFHEFFFHHFEF7EFHD=EFFGFEHGHEFGGGB	G	24	T	12
8	73150491	G	30	GgaaaaggAgaaGgggaaggagaGGAGgAG	C=FDGFCCFCFFGCCCFFCDGDGEFEFDDD	G	17	A	13
8	73982161	A	83	GGgAAaAgaagGgAAgAgAgggaGGAGggaGagggaaaggAggGaGAGGAAGAgaAaAaaagAgggaAAAgaaaaggaagaaa	>>;DEFFDEFBCCHCCHCHCCCFCCHCCCFCFDCCFFEBCE=CBGCH;CHHCHDGGGGEGGDGDDDGGFGDGGFGCCCB<@;C	A	44	G	39
8	73983994	A	33	AAAATATAtAAATTAaATaTTAAaTTATAaAaT	@<DEGBFEEEFFGG>EECEFFDDEEEEEECEDA	A	21	T	12
8	74791162	G	48	CgccggcgggGcgCggcgcCcgcggcgcggccgcggcCGGcgcGcgCg	>>@>BCBCC@EBCGCCB7BG;CBDCBDBDACBDCDCCEDDBD@C@9=>	G	26	C	22
8	75924820	A	60	ccaacAAacAcCCaCcaaaaaaacacaaACccaAaaaaccccaAAccaccaacaaccaac	C?C?C>?@CBEFEEEGDDDCCDDGCGDCFGGGDFDDDDGFGGEFEHHEHHEEGEEGHEEE	A	34	C	26
8	81905294	G	105	GAgAGAGAAAAaGGAGAaAGAAAAgAaAGAGGgGGGGGAGagGGAGAGGGaGGaaAgGGAAGAgGaGAGAGAagaagAGAGaGGAGGaAAgAAGGagggGGGGGa	@FFEEFCDFFFDEAFEFD5EEFCFFFDFBFEEEDEEEAFEDGEEFCEDDDECDEEEGDDEEDDBDDDADEDCDGEEGEDEDECCDCCEDDFFCBCBCCCB@AA@?	G	56	A	49
8	82627395	A	127	AacaCcacaccCaccacaaAcccaaaCaaccaccaACCcCcaaaaaaacaaaccccaacccccaaccccaaaaaaCccacCccacccacccaccaaaaacaaccaccccaccccacacccccaccac	BACCAABBEEDGEDDDDEEFDDDEEEGEEDCEDDEFBGDGDEEDEEAEDEEECDDDEEDDDDDEEDEECEEEEECGDDEEGECFEEEFED8FEE;FDE@EFE9;E@DCEFED:DFEFEEDEEFE<EA	C	72	A	55
8	87060672	A	47	aAAGgAAAGGGAGAaGGGAAGAgagAAGGagAgGAAAAgGGGGAGGG	FEEHCDEAGGHEHEGHHGD>GDDGDDDGGGDDDGDDDDDGGGGCGFF	G	25	A	22
8	87519315	T	81	GTGGtGGgTtTTTGTGGgtgGtTggtGgTGGGgggtgtttgtgtTttGttTgttGtgtgtGGTGTtgggTGttgtgtGtgt	DAAE?DGEEEECEHFHHFEFDEFFEEHFEGHHEGEFGEFFCFGFD>FHFFEGEEGFGFGFGCCHD?GGDDGE=GFGFFDF?	G	41	T	40
8	87540872	G	40	gAAAGGgggAgggAaaagggaaaagaaggaaagaaagaag	BADCHHFFFEFAFDFFFEGDGGBGDGGGGGGGGGDGGGGC	A	22	G	18
8	87544832	A	65	GGAGAGAAAAGagagGgggaaAaGAgGgaaAAGAGaAAggAGaagGAgaaaGGgagaaagagagg	@BEGFGFFFFGDFDFGFFCDDFDGFFGFDE?@FFGEFF>GFG7EGFEGEEEF>GEGECCGEGEFF	A	34	G	31
8	87570728	C	57	Tccctctttttctccccctcttcccttttcctcttccccctttcctcttcttcttcc	D>BBBBCDCDFDECCDCDEDECDDDEDEEDDEDEEDDDADFFFECFEFEEEEE8EEE	C	29	T	28
8	87899960	A	26	gGAAgaggGAagAgAagaaaaaaaaa	=BEFFFFFEFFFFFFGGGGGGGGGFF	A	17	G	9
8	89087045	G	32	GGaAagaGaggaaaagagaagaggggaggaag	==?GEEDCEEEEEEEFEEEBFEE?EFFGGEFF	A	16	G	16
8	91940446	C	101	CTtcCtTCCCCtcTTTcTCTCCTtcTcTctccccccCTcctTTctCCtCtCCTCCTctTTTtTcCtCttCCCCcCTTccCCtCCCtctcttctCtTCccct	>?ECGDDDDDDDDGCHDHCHEDGEDGDGDFDEDEDDDGEEFGGEDDDFDFDDGDDGEFFFFF@AC<C?FCC:CECFFEECCFCCC>EED=EDFCDGB@A:@	C	57	T	44
8	91963472	T	28	GttTGTggttttggGgtggggttggtgg	DCDFEFFFDDDDE9EGEFEGGDDGGEGG	G	16	T	12
8	94752754	G	37	aagagAgagaagaagaagggaagGagagagggaggag	@CFDEFFDFDDFDEED>FFFDDGGEGEFEGGGD@GC?	G	19	A	18
8	95143138	A	82	ggAggaaAaAaAaaGaaggagaGagGaaaGAAgagggAgAGAaagaGaAAggaagGGagaAaGAAaaggAgAggaAagaaaG	AB:CFEEFBFEDEEEEEEEEEEFEFEEEEEFEFEFEAFGDEFFFGDDCEDGEFFFDDEGFEFDEDFEFDE;EEEFDEFEDBA	A	48	G	34
8	95158259	G	116	AAAgAGaGggaagaAgAaAagGAaaaaaaaaaGAaAAaAAgGaAGgAGgGaGGgggAGgGaggaaaGgagGGgagaAagGGGgagaAggaaagGgaaagaaaaAaggagaGAggAg	AA@@A9>BFFDEFDHEHCHDFCHDDDDCDDCDCHDHHCIHCCDGCFHBFCE@CEDFGCGBEGGEEECGDDBCGEGEFEGCCBG:GEHGAE=EGBGEDEG7EEEFDGGEFE?ECA@E	A	63	G	53
8	95188850	T	85	CTcctCCCctTCCTCCcCCtCcCccTCttTCCtcCCtCCTTCCcTtTCtTtTcccTcTcTTTCCTCCctccTCCCCcctCCcTcc	B>CDCFGEFEE@GEHHFGGEGFGFFDGFEEGGEGGFFGGEEGGGEFEGFEFCGGEDGDGCDDFFDFFCEFGDFFFFGGFFEBCGC	C	54	T	31
8	95206799	G	34	GGTTTGgGGggTGTTGGGGGGTgGTTGGTTTgGg	HCEFEHD;HDDDHDDFGG?GFD?GDDGGDCDB;?	G	22	T	12
8	95419698	A	39	GGGGGAGGGaGGAAGGAAAGGGAAGAGGAGAAAggGGAa	HGF@G<EEFFEEFFFFEC<CFFEEFEFFDEEDDEB?BBD	G	23	A	16
8	97321898	T	28	ttaTTTTaaAttatttaatattattaat	?CCEGGGFDFEEFFEEGGFGFFFFFGBA	T	17	A	11
8	100844758	T	49	ttctTcCtcctCcTtTtcCtCCCCCTTCCttccTcctTTTcccCcctCt	CDEFBDDEDDEDDGEGEDDFDDDDDFGDDFFE@FEEEFFFE:DBA@<?B	C	27	T	22
8	101117554	T	30	GGTGGTGGTTGGtTGTGtgggGTTGGTGgT	>FGGGAGGGGDGFFFFFFGGBFCFFEGDBC	G	18	T	12
8	101232701	T	33	tTTcctttcctCtcctccctttccccctttttt	C;DGGDDCFGDEDGGDGGCCEDGHHHGEDEEE=	T	18	C	15
8	105263979	C	118	CTcCCTCcccCcCcCTCtctCCtCCccTCTTTTccTtcCTcCCcCcTctTCCCtTtCCtTTtccCCtCCtcCtctCTcccccCcTcttCCccTtcTctTttCccTCctcCTctCcctc	@EECDGDCDDDDDDD=DEDEDDEDBDDGDGBG=EDFEDBG9CDEDEGEFGDDDFGFDDFGGFEBDDDDDFDCFEFDFCEEEECDAEDFCCEEFFEFEFFEDCEEECCCDCDCB<@BBB	C	74	T	44
8	107371924	C	77	aAAaacaaccACAcaccaaacaaacaaaAccccaaaaAcCaaacaaacaacccaaaaacccaaccacaccaaaacaa	C>=CCCBGFFDEECFFFFFFFFFFFFFEEFFFFFFEFEFDFEFFGFFFE>FFFGG<GG;GGGGGFECGGFGGGFGGA	A	48	C	29
8	109009081	T	35	CCTTCCTTCTTTcCCCCTCTtTCCTTCCTCcTCTC	BGDFGFFFGEFEFFEFFEFEFDFEEEFEEEECB:@	C	19	T	16
8	110348249	A	78	TTTAAAATAAATTTTATTATTAATTATaaTATttTAAAaATAAtTatTAAtTTATAttATTTATaAAAaTTAAAATTt	GGGHHH9GHHH6FGGH=>HGGHHGGHG:FGHFFFFGG?FGFGGFFFFFGGEEFGFGFFGFFFGFFFAGEFDDD@BAC?	T	40	A	38
8	116504323	A	34	TTAAAAAATTTTaTAtTTATAAAAAATAATATAA	GGFFFFEFGGGGGFEFFEEFEEEEEEFCEEECDC	A	20	T	14
8	117875557	C	79	tcTtcCCCctCcttccTtcCccctcTtcCctCcCcctcTCCtTtTCcTccctccTctCtTcctcttcctctctttcttc	ACBEFDFGFEEFEEFFEEFGFFCEFEAFGFEGFGFFEGDGGEDFDDGDFGGEGGEGFGEEGGFGFEFGFGFFFEEGFE?	C	45	T	34
8	117887130	T	100	cCctTtTttCTttTTTtttttCtttttTttttttTtttttTTTCTtttCttttcTttCttttCTttttttttCttttctttctttccccccccccccttt	C;B=@E7EEDAEEBGEEDDEDDDAEEEAED?FDCDEEEDB@DA@B7FE7F@FEDCFF8EFEFBGEDEFEDFDBCFFEDF>EAFEFE@DEBDEEEECE;@9	T	75	C	25
8	118185041	C	31	CctcTttcTTctttttcTcttctcctctttt	B?ADCAEEGGGDDDDDGGGDDGDHHEGEEEE	T	20	C	11
8	118533382	T	27	aATtttatttttttaaATaattTaaat	C>7BDEDDEEE;EBEEEGFFFAGF7FF	T	16	A	11
8	119941173	A	69	AGAagAAGagagagGgGAagaagaAGggggaaaAAagAgagagAgGggaaAgAgaaagggaagaAggag	D@=CACC?EBFBFBBCCHEBFDCFHDCCCCFFFHHGCH?GDGDHCCDAGGHDHDGGGDDDGGDGGDCE@	A	36	G	33
8	120118021	C	36	CACACCCACAACAAACCAAAAAAAaACAACACCaCC	?HDHDDDHD9=CHHHCDHGGGGGGGGCGGCECCFCA	A	21	C	15
8	120428758	G	44	AGGAAGAAAgGAAGGAGAAAAGGGGGAGAAGGAAaAAGAAGAAA	FGEEFGFFFDGEFFFEFEEEEFDFFFEBDEFFEEFECDDBBCC@	A	26	G	18
8	120429282	G	62	ggGtTtttgTtGggGtgGTggtgttgtGgtttggtgggggttgtgttttggGttgtggtGGg	?ACBDFEDFEDHFFHEFACFFEFEEFEHFBEEFFEFGGEFFFGFGFFFFFGHF>EEGGFGGE	G	34	T	28
8	124114333	G	63	GTgTTTGTGGGtTTTTTGGTGgtGTGTGTTTTTTGtgGTTTGGGTTTTtGTGGGTTTTGgGGt	9FFGGH5GCA@EGG>GGCBFBGEBFBCBFFFFFFB?GBFFDBBBFFFFEBF=A>ECCA=>ACB	T	36	G	27
8	124553222	G	112	ccgGgcGCGcgGCcGccgGgCgggcGCCggGCCGCCCGGGGGcgccgggGGGcgcgCCCCCgGCGgGgggccGCccgggCgCcCCggCGcggcgCgcgcGgCggccggggcG	;=@=A@BBAACBDBCBBC;CDCCCBCDECCADEBDDDCCC?C9CABCCCC;CBCCDDDDDDDCDCDCDCCCBABC<DDD?DBCDDDD?BCDDCDCECD@BDCDDCCDDD=<?	G	63	C	49
8	125052018	T	80	TCCTCTCCTCCCCCCCCCTCCCtTTTcTTcCCCCTTtCTtTTTCTTCCCccccCTTTTCctcTTccCCttcTCccTcCCt	@FGEG:GFFFEEFFEGGGFGFFFFFFEEDEGFFFEEFEEAEEEEEEFFEEEEEEEEEEEEFEDEEEEDFECDCBAC@?@B	C	47	T	33
8	125155303	G	60	AGAGAGggaGAgAAGAaGAGAGaGAagGAGGggagGAGggaaaGAGgGGGgGGAagAAaG	B@AFFGCCFGFCEFGFFGFGFGFGFGDGEFFDDFDFEFDDG?GEEFCFEEDEGDC@A?A?	G	34	A	26
8	125155635	G	32	aGAaAAAAAAGGAGaGGAaAAGGAAAAAGggG	A;IFHHHHHHC@GCGBBGGGGBBGGGEC??9C	A	20	G	12
8	125155706	G	61	GAaAAGGAAAAAGggGGaAAGaagAaagaaAaaaGGAGAgagGGaaAGgggaaAggaggga	9@FHG<CHHHHFCCCCCFHGCF>DHGGDGFHFGGC=FAGDGCBBGGEBCDDGGEE@GC@??	A	34	G	27
8	125574925	G	42	gCGgGGCCCCGGCGGCGGCCCCGGGCCGCGCCCGGCCgGCGc	@FECAEF@EGEEGEDF;DFFFEDCDFFDFD<FECECC>@BA>	C	21	G	21
8	125601964	C	128	ctTCCtTcttcCccttCTCcccCtCTccctctCTCCCCctcCCcttCtttTCCcctTttTTccccTTctcttTTTcttTcccCCCtcTtCCTttcctccTcCccccctcctccctttCtcttcctctc	CC=@BEBBFGBFBAGFGCGBBBGGFEBBAGB@EFFDGFBFBFFAGGGGB;FGG@BCAGGFFBBBBFEBCCEFEFF9;BFBACDGGFCFHGFEHF?CD;CE>FCCC?CIBC?CC>DA?EHC>CC?FA>:	C	72	T	56
8	128098838	G	29	aAGGGGgAGAGggAGGaagGGggGgggGa	9DFHHHEEHBHGDEHHEEGGGGGGFEBE:	G	21	A	8
8	129021179	G	154	AaaAGaGGAGAGAagaaAAGAAGgggaaGgaAGGAAaagAgAgGAGaAAAaAAaaGGgAggggggaAAAGaAAGGAaAAGgAgAaGGaGGGgAgaaaAaagAaaAgAGGGAgaGaAGGggaagaAgaaggGagaGAgaggGgaggGAaaaagga	9?6?@EEEFEFAFFFFFDBE@FEFFFFEEFEFFDFDFFFFFGFEFEFFFEF@@FFEEFFFGEEFFEECFEEFFDAFGC@EGEGEGE@GEEEGFFFFFDGGGFGGFGEDDEFGGEGEDDGGGGGFEDGGGGBEEEDEGGGGCGGGGDEFEFEDB?	A	84	G	70
8	133048619	T	134	TCTCcTtCTCTtTtCccTTCcCcTTTCtTCCTCCTCCTtcTTTccCcccTcctCCcCcCTCCCTCTtTTTtcCTCtttCCTttcccTTTTttCcCCTctcCCtcctCctTCTTtCTtcttCCTCcTCCCcTtct	=B?EEEEGEGEEEEGFFEEFFFFABA?EEGGEGGC?GDEGEEEFGGGGFEGGFGGGGGD;GEG>GEEDEDFGDDFFEEFFBEFGGGDEACFCFGFFDGFGFFFGGDFGFDFDDFEDDEFEGFDFE=D<BA@>DC	C	70	T	64
8	133049810	A	30	gaagGagaggaAAgagagaGaagAgaAgaa	CDEGGDFDFFCDFF=FDFDGCCDDGEEGEE	A	17	G	13
8	134129000	C	41	TtTtctTcCttCCCcctcCCCCCCcccCtcCtcctcctccc	AEDECGFBDFGDDDBBGBDBDDCDCACDFCDGCCHBC@BA@	C	28	T	13
8	134260948	A	116	GaAaaaGaAGggGgGAAAaAGAgGGGAagagaGaGAAggAGaaAGaaAGAaagaaGAaaAgaaagaagggAgaaagaGaAaggagggGagaAggAGaGGAaggAAAgAGgaagaGa	D?ABCDCFDGCCG<GFEAFEGFCGGFFFCFCFGFGFFDCFGFFFGGGFGFG<DGGGFEGFDGGDDGFDDDFDGGCDGFCDEDDGDBDF=DGEEDEFEFFEGDDDEEDEDBFC?BC@	A	65	G	51
8	139809111	G	147	TGTtTGTGGGTGGGGtGTtTtGTgGGgGgTGTGTTTTGTGGGgTggGGGGGTgGGtGtTGGGTgGGgGTgGtTttTgGgGTgTGTgtgGtgGTgtgTgggtGgtGtGTggGTgtttTgtgtgGtgTGTgtGTGggGtgtTTGGTGtt	?@?DEHEDHHEGGHGDHEDECGFEHHFGFEHEHDEEEHDHHHFEGFHHGGGDGEHEGEEHHHCGHHFGEGHEDEEDGGGGDGDHDGEGGEFGDGCFDGGGDGGEGEGDGGGDGEEDDGEGEGFDCEHCFDEDECAD@A?ABDC@D@B	G	85	T	62
8	141310486	A	27	AGAAGGAAAAAGAAGGAAAAGGGAAGG	HCGHBBHHEGFBEGBAGGG@AA?D@:?	A	16	G	11
8	141460918	C	45	CTTTTTcTcTCcTtcTCTtTtCttcTCTCCcTTTCCTCTTTCTCt	AFG>GGFGFGDGGFEG>FFGEDFBGFCECCGFFE=CFCEFECEBA	T	27	C	18
8	141461266	A	212	GAGAGaagAAaaGgggAAAAGGagaAAaaaaaggAgAaAgGaaaGAaGgaggaaaGGAggaGaAGggGGagaAGAAaAgGaaaAAGGAggGaAaagGAAAaGgggAAAAgAaggGaAaaaGGaggaaaAGgggAggGAgAgAgGgGGAGgaaaGaaaagGGaAagGGGGaaGaAGGaaGGAGAaGaGgAAGAGGGAgaAGGAGAGaaAAGAA	@E@C<?=ACBCC@CDCFGAHBCEDDHGEEBEECCHEHEHFCBEECHECBEFEEEEABCFDECEHCEECCDEEHBHHEHEC?EEDHC?HGGACHFDFCHFHE7FFGHHHCEHF8GCEHCEDCCFFGEBDFBFEFHEGCHGGGGGC?BBFBG;ADBF7DFFBB@GFGBBBBF>BFGBABE@BGBGEBEBFGGBGBAAFEEDBAF?FCEDED>B?	A	114	G	98
8	142444780	G	43	CcgCcccgccgcgcgCccggcGgcGCgcgggggcgGccCcCgc	EA@AFFFFFFFFCFFEB>GFFGDAGGGGGGGH;GDGGFFCB9A	C	24	G	19
8	142451177	G	32	AGAAgaaAaGGAGAAAAAAAGAGGaaAAgGAG	@E=FFGGEGEEFCDEDDEE>DEDDGACEFD:C	A	21	G	11
8	143382143	C	25	tctcttcttcCtttttctccttttc	C?C?DGAGGBGGGGGGBHC?HHHHC	T	16	C	9
8	143399860	G	90	GgtTTGTgGTggGggGgTtgTgTTTtGgGTTGGTtTTTTGGtgTgTTGGtGgggtTGTGtgtttGggGtTtgGggTgtttGgtTGGTGGt	?>AABDEEDFFFEFBEFGEFEFFEFFEGEF;EEEFFEECDDF;FFFDEEFDGGDFEEEDFGEFFCFGDFEFGDGDEGFFFDFFEDBBAA>	G	47	T	43
8	143607870	A	53	CCCCAaCCAACACCaaCaCaCCaaCCCaaaaAAaaaaAAAaaAaAAaAAAaaa	:?DB8?8:F:9C@@DFDF>9?7FFC6?EEFBC=?FFF===FFFEB>A@C?BCC	A	37	C	16
8	143607876	A	56	CCAaCCCCaaaaaCCCaaCCaaaaCaaaaAaaaaAaAAaAAAaaAAAaAAAaaAAA	:C:ED>D:?FFFC=@DFF?>FDAF;FF>FDBE>EEDFFFFGCBDEFD<5CDAAC?@	A	44	C	12
8	143856967	C	69	CGCGCCCGCcCCGCGGGCCCcCGCGGCcCCCGCgGGCcCCGGCGCGGGCGGCCCcCcGcCGCcGGGGGC	?;<9BDDCDBDDCCCCCDADGCCD@CDGDCDCCGACCGCCBBCACBBBABBCCCGCGBG:ACEAAACB@	C	40	G	29
8	143857208	G	66	gaggaagGaGAgaggaAgaGagaagGaGAGagAaAAgAGgagAAgGaAAAAgGaGgGgAaaAGGAg	@ABCFFCC?BGCFCC;HCFCFCF=CCGCFBGDHGHGDGCDGDGGDBHFGGGDBGBDBDEGGF;:C<	A	34	G	32
8	144097362	G	52	CGGGCggccgCggGGGGCgGGCgGccGccCcGCcGGCCGccgccgcgGcggg	DFFGGFFFGFGFFGGGGGCGGFGGGHGHHGHFGGGEFF?HEEHGFHGFAGDE	G	29	C	23
8	144351610	C	106	CccCtccttcTTctctctTtCtccTTcCTTCcCCttcTtCcccCtCCctcctcCCttTtTtcTCctcCcCCTTTCTCcCTcCTtTCcccCccccctCccCtccTtt	E@BBBBDEDAE<DEDEDEDEGEDDEBDGEBGDGFEEDA<GDDDGEGGDBDEFEFFFFECEFEEGAFEGEGGCEDFDFEFDEFDDDFEEEFEEEEEE>E<EFDD@AB	C	63	T	43
8	144621084	T	114	tTtgTtggtgGtGTggGttttgGGtttgGtttTgTGTGggTtGTTTtTTtgGTGGgTTGGGGgGGGtgGGGTTTTGTttTggGgGGGttTtTGTtttttTtgTTtGTGGgtggg	?<BA?>BBBCFDGEEF<EEEEFGHDEEFHEFEEFEFEHEGEEHDEDFEEBGE;HHDEDHGHHGGHGFGBGGDDDDFDG<DGGCGGGGDFDFCGDEF@FFCFGDCFGDEEDBCDA	T	60	G	54
8	144641753	A	98	ccccccaacaacCcacaaaAaaaaacaaAccCccCaacacaccacaacAaaaacacccccaCcaccaaaccccCaccacaaacacccaccccaaaaac	AAC<:<DC?ADBBBFBFFFHFFFFFBF@HBBDBBDFFBFBFB=FAEFBHFF>FBFBBBBBFDCGBCGGFCB=CDGCCGBFFDCGCCBBCCCCGGFG@C	C	51	A	47
8	144654594	G	83	TGGGTtGTgTGTGgGTGGTTTtGGTtgGTtgTTTTGTtGgGGGGGGGggTgTTGGTGgGGTttgGGtgtggTGtTTgtTGgtT	B8AAFEDEFFDFEF;FDECFDFEEEFGBFFGBFFFAFEEGEE@DD8EGG;GEEDBFDGDDCEGGDDFDFGGE5EEEBDDB<:?	G	45	T	38
8	144654693	G	127	gcCCCgCCgcCGCgccggCcccGCCCGCggGCGggGcGGCGgGcGGCgcGCgCgGGcggcgGgGGGGGcGCGGcgCcgcCCCCggCgccccGgGGccGGcccccggCccgggGcGGcCCcCCgcccg	5A?AAACBDBEGGCABCCGBBBGGEGGGCCGFHBCGBGGGFC?BGGG@CDE?GDGGCDDCDGDGGGGGBGGGEBC=CDCGGGGDDGD>C=@FDFFC<FF=AAC@D9F;CDDDFCFFCEFCEE>>>>A	C	64	G	63
8	144658370	C	65	CcTtCTttcTccCTCCttccCTcttcCttTcccccccctcctttcctctcTttcccccttcttcc	B@=B@>BEAD@AFEGGGGBBGEBG<BGGGEBBBBBABBGBBHHHCCHBHC8HHCCCDCDHCHGB;	C	37	T	28
8	144659949	C	81	CaaccccaAAaaaAaCCACACACACaaCaCAACACAcccaCAAaACAAcCCAACAcCaacAAcAAccaCACACCcAAACaC	>EEDDDDD<AAEDHEDBHDHDGCHDBFDFCHHDHDHEEEDCGGFGCFGBBCGGCG;CF;EGGEGGEEFCGCGCCE=GGCD@	A	44	C	37
8	144660257	G	30	GgGTtgGTTGttGTTggTGGTGTgggGGGG	=FEDBCEEEDADDEEEGEDDEDEGF:DBA@	G	19	T	11
8	144681777	G	74	TGgTGgtGgttGgGGtgtGgTgTGtgtGTtGGggTGTgTGttgggGttTTggGTtgTTTgGTTGGTgggGTgGt	AAADFCGHCFGHCHE?CGECECEHHDHHEGHCDDEGEDEHHHDDDGD9ADEDGDHCDDDDGDCGGCC@C@B??B	G	42	T	32
8	144689146	C	104	CTCcCCTcCttctCCtTCTtTTCcCTttCTTTtcTTTtCCCctCcTTTtTCcTCTcCcTtTCtcCCCtttTCtctctcctTcctCTctCtCCTCTcccctTCTt	DEECFGGDGEEDDDGEGFFAHHGDGFEEGGGGE=GEGCGGGEF7EGGGFGGEFGBECEG@GG<AGGGFBFFDCEFEF@7:FEE9FFEEFBFFEFECB@A@CBC@	T	53	C	51
8	144695176	C	163	CtccTttTCCttTTcctttctTtttttCtTTTTcCtCTTCtcTctctctttTCTCTCCTcTttcTcttCcTTcccctccttCCTccctttTcccTtcTccttTctttcttcctcccctTccccCcCttttttttttctttttCctcttcccctctcttcctcc	@?@?8CC:A?EE>BB>FFGAGFGGGGGGGEEEDBGGGEC?GBDBGBG7BGG@E7DFFHDBEDGBEBGGGBEEBCBBGBCHGGE9CB5HHGCCCCEGCECBFAECAHGAEECCDCBBCGEC:C:FCEFCGHGF>HHHDDIHFHFCHBFHCCCCFBHCF<;5C6:	T	91	C	72
8	144801243	C	89	ttTTcCctctcctTTtcCCTtTcCtTTTTCTTcTttttCtttttctccCTtcttttttctCCTttttTcttTCTccCtTCtCctTtctc	A@@;=?=F@GBAGFFGBDDGGGBDGFGGGDGGBGGFFGDGGGCGB=BBDGHCHFHHGHBHCDFEEHHFCHH=CFBDC5FCHCCGFGC<@	T	57	C	32
8	144808926	C	163	CCTCTTTCCCtCTTTTcTCTCCCTCCCTTcCCCCCCctCtCTttcTcTCccCCtCtCctccCCtTtTctcctcTtttCTCCTCTTctCttCTCcCCtCtccCcttcttCcctTctCTcttCCCtctTcCTCTTctcTctctcCtTCCtCtccTctCtTctTCt	;AA8><<>>>EDGBBEDGEGDDCGDDDGEDDDDDEDDEBEDHDEDGDGDDCDDEDEDDEEEDDEEEFEFECFEGEEFDGDDGDGGEFDBEDGDECDFCED@CEF<EFEDDEFFEFCFEF=CCCFEFEECFCFFE<DFEFEFACD?CBFBFEEFDFCEFACDC?	C	88	T	75
8	144876159	G	77	AAaGggGaAGgGGAgGaGaGAgagaAAAgAGAggaGggaggAgGAaaaaAaggaagAaAaGAGAgggGaagAgGAaa	@?AAEEGCBHFHGBDHDGDDCFEFDEDEFCHBGGEHGGCGGDGHEEEEDCEGGEEFDEDEGDGDGGDGDEFBAC@=@	A	40	G	37
8	144940290	C	187	CCCCccccCcCCcCCCCccCcCCccCCCCCCCccCCcCCCCCCCCCGCCCCCCCGCGCCCCgcccccCCcCCCCCCCCgCcCCCcCccGccCCCCCccCccCcCGcccCCcccccCCGcCCcccCCcccccccccCGccccCCCCcccccccccccccCCcccCcCCGCccCCccCCCGcGcccCcc	?BA8AB>BGB;GBAEAGBBDBGEB7EGGGGGGBBGEBGEAEGGGGGFGGGEGGGHGHGGFGCBBBBBGGBGFGGGGGGCGBGG?BGCCHCBGFDGECCDCCGCGHACCCGBCCCCGG<CEG:<CGGCCCCCCBCCFGCCCCGGFF>CDDD@CCCCABCFFCBCFCFFFFCCFEBCAEGD<D>==9<>	C	175	G	12
8	144946818	C	117	TctTcccCTtcTTTCCTtTTCtCctCTTTtttttTTcCCTTcttCcTTCtctTTCCccTTtccTtctctctcCCtTttTtccTTTTTtCCcTTttTTtcTCCttTtttCttTttccc	AC@>;?@E9G<DCE=FFGE?GGGBGHBEEGGGHFECAGG;;CHHGCABGHCHEEGGCBE?HC?EGB5CBCHCGGHDGHEHCCED:DDHFFCDDHHCDHCDFFHHDHHHACBBA@;>>	T	73	C	44
8	145006790	T	96	cctCTTtTTTtTccCCCCtTTcctctCTTCCctCTCTtCcTttTcCTcCTCCTcTCTTTTtttCTCCTcTTTCCTTCtCttcTTtcccTTcCTcCC	CC@9GGGGGFGFBBDCD>GBGBBGBGDGGDDBHDGDGHDBFGHGBCFCAFCCFBFCCFFFCHHCFCCFDFFFCCFFCHCCH@FFHCBAFE8CE<@A	T	51	C	45
8	145058986	A	123	aAAGGaAaggaGGGGaAaAagAAAAaGGaAaggGaAAaagAgGaGgAGgAAGaggAaAAgGGGgAgGGgagGGGGGGAAaggAgGAGAaGgAaGGAGAGAAGGGaagGAAAGaAAgAggGGaA	AB<=;DFFBCFCCCCFHFHFCHHHFF;CFHFCCCFHHGGCHC>ECDA@DEGCGDDGGFHDCC:DHDC:CGDABBBBBGGDBDHDBGBGGBDGGBBGBGBCGBBBGGDBGFEBEDGDFBC??AC	G	62	A	61
8	145066004	C	218	GCCcgcGGCgcgGgGGCggCgGCCCgCCCgggCggGGcggGGccGCGCGgGgCcGcgCCcGCcGGCGgGGcgCGgCCGGGGcCGGgcCCCcgccGGGGcCCgcgggcCCcccGcCGcgCCCcCCCCccGgCGCCCGGGGgccggcCgCgccGgggcCGcggGgcGcCGgGGcccCcggGcCCggccCGccccgCgGGCGCCcGggCCGCcGccgCccg	B9@?BB?ADCEDCFDEGFEFFEFF;F@FFFFFGFFEE=FFCDFFEFDGDFEFFFFFF?GFEFF:EGEF@@FGGDGFFCEED:GAEFGGFGFGGGDEEDGGGGGGGGGGEFGFEGG9G?GFFG>FFFFGD@GEDFFDDDDGGGGGGFGFGGGDGCGG<DGDGDHFDHFDGDDGFEFGGGDGFFGGFEFDFGFG;FFDDDDDDFCGGGGDEEBDCAA?>E	C	111	G	107
8	145577999	T	36	ttAaaAtaaattAaatttaaaTTTttTtTatatAaa	ECEGFFGFFFGGFFFGGGFFEFFBHHFCFCHGDEGE	A	18	T	18
8	145623098	T	113	TTTTtCCTCctTctcTCcCTcCtttttctctCccttttCCtTCTcctCCCCTCtCCTTttctccTCttTCTTTTCTCcCtTcccTcCTCCTCTTTTctccttCTTCctcCCCt	<?DDG5GDGBGFBGBFFBEFB>GEGGG=GAFGBBEGGGGFHFFACBHGGGGBBHGFEFHHCABCFFHAEG@EEDGEFCFGFCCCFCACEFFEDDED<C;C>H>EAFCHCEBA@	T	58	C	55
8	145624640	C	94	TTTCCCtTCTCTTcCtCtTCTCCtTtCTtTtTcTcCCTTTtTccTCTTCttcCcCtCcTTCtTTTTCCttccTccCTTCTtcTCTcCTCTcTCc	?9DC;CEFDGGGGBGEGDGFGGGGGGG@HEHFCBCGGGGFHGCCFFE6FHHCFCFEFCFCFFEDFEFFGH@CFCCFCFBEACEFD<BC=B>C@=	T	51	C	43
8	145625283	T	53	tcTtcccccCttCTCCCcCtCTttcTTCcTCTccCccCTtTcTtcTTtctTTC	CC?C?>?BBEGGGEGEGBE?EEGGBD?GBACD6BE@AGEFECDD:EE;<BDCB	C	28	T	25
8	145639726	T	79	tTCccTTCttTtCTTtctTTCCTTTcTTTtCCcTtcccCTttCtcTTTtTccCcCcttCCctctctCCtccCcccTttt	BA???DCGFGFGFCEGBFFFGGFFFB?FBHFG9FHCCCGEHEFGCFFEDECCFCFCHHFFCHAH?HFEHCCECCADCC@	T	42	C	37
8	145640306	G	108	aGaAAaaaGaAggGGggGaGagaagGgaggggaaaGagaGggaGgGGAGAaAaAaaGGAaagGGgAGagaagaggGGagGAgaggGAAGAggGAAGGGgGagGAggaa	6=DBCEDGCEFCCEDCCEFEFCFFCECFCC@CCFFEFBFDCCEECDDFEEFFFFFFEEFGGDAEDFEGDEGDGCCEEGDDE9GDDDEDDEDDDEE@DDDDFDCEA@D?	G	60	A	48
8	145665699	C	70	CcttctTctTCCtttTCTctTtcTctCCTtCCCtTctTTTTtccTTTcCccCCTCTCTCtTTctTtTCCc	?@DDAFFBGGD@GGGGDGBGGF6FBHDCGHCCDHGCHGGGGFBCGGG6DCCDBFCD@FCGFFB=FGFCCA	T	39	C	31
8	145694949	C	205	CTtcCTCcCttccCccttCCtctTTttccTcTctCTCTCCtttttttttTttttcttttctctttcCCTtCCtcCttttccTTTtttTttcccctttcTcTTtcctctcTttctctttccttcCcCtTctctCttcTtCttTttctcTcCCctttttcCcCTctTcCctcCtcTTttTCttttCcCTCtcTCcTTTttTtttctt	C@AC?@BC>BABDDEEBCEEEHDFBCCGFFFFFDGFGEF@DCDDDDDDDFDDDDGDDDDGDGDDDGG7FDGGDGFDD8CGGEFFDDDDDDGGGGBDDGFGFFDAHDGDHFCEHEGDEEHHEDHFHG;BHEHEFDEHFCGEEFDCE>HEHGFHEEC<DAEH6EHEEHF=EEDFIEECDEDECAEFHFEFEH=CGCDDABB@@@C@B	T	122	C	83
9	304769	G	47	gggaaaAaAaGggAgaaGGGGaaGagggGagggggaagaAgaaagga	ACCDEFEFFFGFFGFFEGFGDFGGGGGGGGGEGGGGGGGEGGGGG@E	G	25	A	22
9	316998	C	48	CCcTTTcCCtCTCCcCTTCCTCCCctctctCCtCtCccCTTCctCCCt	??CEGGDDDEEGDDDDEBDDGDDDEF@FE>CCACFCEBCFEBDDB@CC	C	31	T	17
9	327957	T	25	GgGGTTTTGTTGTTTTGGTGgTGTT	HFHHE;@DGDCDDDDDGBDGF>DA?	T	14	G	11
9	989868	G	37	CGCGGCGCCCGGCGGCGCCCGGGGCCCCCGCGCCCCG	GHGHHGHGEGHGGGGFHFDFFGGGFFFFFGEGEGF9D	C	21	G	16
9	2073162	G	33	CCCCGCCGGGGGGGGCcCgcGGCgcCCCGGCGG	ECGGHGCHHHHGFGGFAFDCGGFDAFDDDGBC?	G	17	C	16
9	2123639	T	40	TtCCCCTCtCcTtCCCCTTCTTCCCCTCTCTTCCTtCCCT	?GGGFGEGHGCEHGFFCD:D:D7FFFDFDFDD>FDGBBC<	C	23	T	17
9	4285986	G	83	GcGccgcccccggggCGggggcCcGGGCcccggGCGcCCCggGgGGgggcCgCGCgCgcCCgcCcCgcGCGgGCGCCGCcGCG	BA<<>@?@ABBCCCAGECCCCBG<A@9FCBBCDAFEBGGFDDEDBC=DDBFDFDEDFECEBBCFBED=CECCDDCAAAA<AA?	G	42	C	41
9	4561596	G	45	aggagggggggAgggggggaagaaaaaaaaagaagaaaaagaggg	ACC>@>BBDGFGEDFEFFFDCFDDDADDDADFDDFEEEEEGEEGG	G	23	A	22
9	4679906	A	166	GAGAAAGAagaAgaGAGGAggAaagaGGaggAGGaAGgGGgaGgaAaaaAaGAGgGgaGAGgGGgGggGggAaggaggggggAgggaagaAgagGaaagagaaaaggaGgggaagaaaggggAAGaggaAgAaggGggaggaGggaggaggaagaaggGgaagggg	DCE><=?9?@D@BDCDEEACCFEFCEGGFBCEGGFEFCGGCFGCFEFFFEFGFGCGCFGFGCGGCGCCG;CFFDAFCCDCCC<D5CFGDEFCG9GFGGDGDGGGGDDGGDDDFGDGGGDDD?FDEGDDGEDEGDDFD7GDDHFDDGD@FDDGGDGFDDF;E=B9:?	G	96	A	70
9	5081780	G	135	GAgAGGgAAAGGGGggAGaAGGAAAGAgAagAaGGAGAgaGgGGGggGaAGAgAGgGAaaAaggGgAgGgAAAgAGGgaAgagGGAaAAagGGGGAGAgaggagaGAAgGaAAaggaaAgAGGgaAGaAGAGgaa	CB?@GHCD@CGGHFCCEHFEAGE@8@ECEFCEFHHDHEDFHCHHCDDHGDHEDEHBHEGFDGDDHDEDGDEEEDEHCDGDDGDHGDGEDGCGGGHDG;DGDDAEGGDDDGGDDDDDGGCDCGD>??>BAAC?ACD	G	72	A	63
9	5801121	A	113	GGAGGGGGAAGAGGGAAAGGAGGGGGAGAAAGGAGAGGAGggAGagGGAAAGgAGAGAGgGaAAGGGAgAgGAAGgGgGGGGGagGGaGGGGAgAggGAGGGGgagGAgggAG	>?DBCCCCHICH;CBHHH>CHCBC>BGBHHHCCHCHCCHBAGGBEGBBHFGBGG<GCGB>BFGGBBBGFG:BGGBGBGBBBBBEGBADBBBBFGG?EBGAABB<BD?CBABA?	G	75	A	38
9	5805001	A	47	GAAAGAAGGGGggGGGGAAAGAAaAAAAAGagGAGGAAGAAGGGAAA	GFFFFFFGGG>GGFFFFDEEEEEEEEEEEFEGFEFFEEEEEFDCCBC	A	25	G	22
9	5923326	C	37	Tcctcttttcctccttcccttctctctccctcccctt	A8>@BFF;GABFBBGDBBBGGBFBG9G@==H@:CCH<	C	20	T	17
9	6007500	G	148	GaaGgAGGAGGGGGgaaAgaaGAgAAGAGAAAaGaaGGaAAGAgAGGAAGAGGGgAGGgggAAAgAGGAGagGAAaggAGAgaGAAGaggAAgAaAAgGGaagGAaGAGAgAaaAAAGGGgaAGaaGAGAGGAGAGaAGGAgAagagg	@CCDEFEEFEEEEDFEDFFEEEFEFFEFDAFFEEBEEEFFFEFGF9;FDEFEEEFFEEDGFEFFFFEDDDFGDFEFGDFECFFDEECFG;DEFEFEEFDD=FGDDCBEDEFECE?EEDDDFEEDFFDEDEDCEDEDACAAB@B@>;>@	A	75	G	73
9	6255881	T	32	TTTGgGGGTTGGTGGGTGTTTTTTTGGTGGGG	GDFFCGCGFGEFFEFFFFFFFFFEDGEDDBC?	G	17	T	15
9	7013909	A	194	AgAAGAAAaGGGgGGAGGGAaGGAGaGGGaGAGGGagAAaAAAAggaGGAggAAgggAgAAgGGAAAAGAAGAGaAGGAAgAGGaGaAAgAGGagAGAAgaGAgAGaagAaGGgaaGGgaGagAAggAaggagggagGAAaGGGaaggaaGAgGaaGGAGggAgaaaAGGAAaGGGgagagggAGGGgGAaAGG	?FDFGFFFFGGGFGGFGGGFFGGFEFEGGEGFGFGFFFFFFFFFFFFG@FFGFEGGGFGE9GDGFFCFGFFGFGGFFGFEGFGGGGGFEFFGGFGFGFEGGEFEFGGGGFGGG8GDFFGGFGFEEGGEGGGGHEGGFFEEGFFFGGFFGEFEGFGGFEEFGFEGGGGEFFEEGEFEGGFGEEDDDEDACA@?CA	G	102	A	92
9	8436703	C	96	CGCCGCgcCgccCcCccggGCgcccgccggcGgcCgGCcggcccgCcgcCGGcggggCggGcgcccgccgggcgcccCcggcGccccccccccccc	B@BB?@CDBCCHFGEGGFD9FFGGGFGGFFGEFGFFEFGFFGGGFGGFHFEEHGGGEEGGEGGGHGGHHGGEHGEHHFHGGGDHHGHHHGGFB?FG	C	59	G	37
9	14813072	G	122	GaAgggAAaGGAgagAGgaGGaggAAgggaAggaGgagAGgggGggagggaaGAAaGGaagGaGggGgAaaagaaaagggggaGgGggGgagAaggAaGggagAaagaaaGaaagagAAGga	E?>?AA@=DB>ADFBEHCEGHECCEECCCFECCFHCF<EBCCCHCCFCCCFFHEEFHIEFCHF=CCHDEFGGCGGGFDDCDDGGDGDDGDECEGDDCGG<DGDBGGDGGGGGGGDGDDCGCB	G	68	A	54
9	14868653	A	40	AAATaTATTaATTTAAAATTTTAAtATATAAAATaAAtat	HHFGFGHBGGHGFGGGGGFFFFGGEFFEFGDFGEFEBA?=	A	23	T	17
9	17273878	A	69	gGAGAaaGgggggggAaaaggGAagggGagagAgaaAAGgaaAggggaAAgagGaGaaaaagaggggaa	@@@<DFFEFFFFFFFEFFFFFGFFFFFGFFECFFEEFFEFGGE@FFGGFFGFGGGFGGGGGGGGGFFB?	G	36	A	33
9	17298291	C	134	tcCTCTTCCcctCCttTtCCCCtTTtcCCtCtttTcTCctTCCcTTcCcCtCccCcctcTtCccttCcCctccctTtccccccttctCtcTTcTcccCcctctcccttTcccCtcccccctCtcccctttcttt	CECAEGADGGGDCGDCGDGGGGBFGDGGGDGDDDBGEGGDGBGGGHGGDGDGFGGHGEGGEGFGDBGHFHEGHHEFEHHHHFHEECEGDHFFHGHHHFGHEHCGHHEDFHHHFEHHFGHHEFEHHHGDCAC=9=	C	80	T	54
9	17761379	C	96	CTCCCTcctCCcTCTTTCCCcCTcTTCCTCCtTtcCTTTctCTTccTCccCcTccTTTCcTTctCCCCCCCtCttCTCTcCTCTCCTtCcCTCCcC	>DCDD<ABGDDBGCGEGEDDBDGBGFDDGDDHGHCDFGGCGDGGCCFC@CDCFCCFFCCCFFAGCCCCCCCGCGGAFCFC@FCFCCEFB;CEDA<@	C	58	T	38
9	18504916	T	44	tAAtAAtatTaaaaTtatTtTaaaaattaaaAAAtttataatat	C?<EEFFFFEFEFFEGGHFHCGGFGBHHGGGEC;HHHBHGGHGC	A	25	T	19
9	18928039	A	46	AGAGAGGGAAAGAGGGGgAAAaGAGGGAAgGAAagaGgAgGGGGag	@CEHEIHHEEEGEHHHGGDDDGCDDGGDDGGDDGGGGGCGEECDAE	G	26	A	20
9	19076673	G	36	GGGCGgCCGGgGggCCgccgGGcGgCGCcGGGgGGC	;EEG@CGF@EDEDDFFDACDEDCDDEDBCDDD@DDE	G	24	C	12
9	19409206	G	128	cGCgCggGCGGCcCgCgGgccGcggCCCCCCGcCCCGcgCCcCcGgcgcCcccCCCGcCgcCcgCCcgGGCcCCgCCCGccGcggCCcgcCgCggcccCGCGggcCgcccccGgcgccccggcgcCcc	C@@A:BBDCF;FD@FDFGFDD?@FEGGGGG@GD@GGGDEGGDGCFEDEDGDCDCGEGDFEDGDEGGDFGGGEGCFGEGGEEGEF>FGEFEEGGGGE;EFBGFFEEF7EEEEEF6EECEEEGFEFDA<B	C	82	G	46
9	20916828	A	32	ACACACACCAACACCCcCCCCCAAAACcAAAC	?CEGFGFGEFEFEFFFHFFFFFEEDDFHDA?C	C	18	A	14
9	21006934	A	83	AGAGAGAAGGAGGAAAGAGGAAGGGGGGGAAAAGAGgAAAgGAGGgaGAGAagGGGGAAgAAAAagaAGGaAGgAAGagAgGA	@A=FEGEFGH?HDEEEHEHHEEGGGGEHHEEEDG?GGDD;DGDGGGGFDGDGFGGBGDDGDDDDGGGDGGGDGGDEFFEBB@C	G	42	A	41
9	21026540	G	27	TTGGTGTTGGGGTTTGGGtGTTGtTTG	GGG?GGGGGFBGFEFFFFEFEEFAC:@	T	14	G	13
9	21695893	A	48	GgaGgGgAAagaaAaGagGggGGaaaagAGaGggGaAggaAgaaAGga	?FDEEAE:DDFFEEEEFFDF7EDFFFFFC?FCGGDFEEFFEDFFECDA	G	25	A	23
9	24545513	G	60	gaAaAagGgagGggAGGaaAAgaAaAAGAaggGaGaGAgGgGgAaGgAGAGaaGAGaaag	CCABCDA?DECCCCHCCFFHHCFHFHH5HGDCCGBGBHDBDBDGGCDGBGBGGBG<GC?<	A	31	G	29
9	27044587	G	25	GGGGAGGAGAGAAAgggAGAgAgGg	GGGEGGGFFFGEEFGDFEEE9DABD	G	16	A	9
9	32550912	G	79	GaAaaggAAagAGGAaAaGgaaggaaggaaGgaAaaaAagaaaggaggagaagagaGaGAgGaGggAAgGagGaAggAa	BC7AB>ABBABCACFFFFECFFCCFFCCFFECFFFFFCFDEGGDDGADFDGEDGD=EGDEDDGADDEEBDGD@FEBCCB	A	44	G	35
9	33062291	A	55	gAGgGAGAAAgGAGGAggaGggAgGgaggaGaagggaagaggggaaaaaagggaa	BFGFGEGFFFF=FGBFDFDFFFFFCFEDGEGEEGGGE9GD<EGGEDEFDEGGGA=	G	31	A	24
9	33461973	C	26	TTtTCTTCCTCCTTCTCTTTTCCTTC	FFFFFFEFEDFGEEEEDEEEDEDEDB	T	16	C	10
9	33465182	G	60	AGGGAAGGgAggAAAgAaGAAAgaAGAAGGGAAAAAggaAGAGGAAGAAgGGgGAGGGAA	?CCDBE<HDCCDECEDEGE9DDAG;HDEGGG@DDCDDDGDGDGGCDGDB?GFDGDHFF;@	A	31	G	29
9	33469406	C	58	cCCcCccCCCtCctTTcCCTccTTTCCCTtcCtTcTtCTcTCCTTTCTCCCCTTCCcc	CGGDGDDFGGDFDEEEDGEEEEEEEEGGEAEFBDEDFFCEDDFCDDFDFEEEECCD@@	C	36	T	22
9	34098257	G	28	cCGGcCCGGCCCCGCCGccCGccGCGGg	BGFGBGGGGFDFFFFFFCCFFCCFGFBA	C	17	G	11
9	35101870	C	88	ggggGcccGgCGGccccggGGCggCgCCCGccGGgCgggcggGgcGcCcgCCCGcgCcgGGGgCCgcCgGcccGgCGgGCCCCGGGgG	ACCCDGFGHFGHHGGGGFFGGFFFGFGE?HGGHH=GGGGHGGGGHHEFHGFFFGHEFHGGGGGFFGHFGGHEHGGFFGGFECFHED@D	G	49	C	39
9	35606884	G	62	GaAGagAGggGGAGaaaGgGGAGGagGaAgAAGGgGaAAGgggAaaagaagaAAGAAAGGGa	AC>ACCDBFFHHDGBCFHFHEEHHEFGGDGEEHH8HGECHEDGDGGFGGGGGDDGCBAEFDD	G	32	A	30
9	35665153	C	34	CCacCaaccaAaAAaAcAcCAAacACcacaaaaa	DBDCFD<GGDFDDAE?GFGGF@EHDFH=IECDE=	A	21	C	13
9	35674101	T	175	CCcCCCTCtCTtctCTTCTTtcTTCTCtTTTCCTCTccCcCctttTCtttCccCcCTctCTtCCTcTtttccTCCtTtTcccTCtCTtTttCcTTtCccttCTTTCtctccTtcTTCTtCtCtTctTccTCTCTtcttCtccTCTCttCTTCccCTtttttcttctCCccctCct	AAC>?>CCECGBEDDGGDGGEFFDDGDEGGDDC<DEFFBFDFEEE@DEAEE>EDFDGFEBGEDDGFGEEEFFGDD9EFFFGFFDFDGEGFEDGFDFD=GFFDGAGDFG:DGGF:GGCFFDFDFGGFGGFFCFCFFGGFCFHGFCFCFECFF=GDCFFFEAFGAEGDDBCBB@@;@	T	92	C	83
9	35992256	A	46	AaaAaaaaaAaaaaaAaaaagaggagaAgAggaaagaagaaaggag	ECEHEDFF@HCCFFFHFFFFCFCC@CFHDHDDFEGDF<CGGGDDG@	A	34	G	12
9	36110137	C	25	cccccaaacaaccAccaccaaaaac	CBACCECDDDEDDHDD?DDDFFFFE	C	13	A	12
9	36148722	G	72	aaggAgagaaaggaAgAaAaagAaggGaagggaggGggaAaagaaggaaaaagaAgaaagagggaggaaaag	?CD>FDDFEEEFFEF=FEF8EEFEEFEEEDE:DFEEFFEFEEEEEFDFEFAFGFFFEFEG?FGFGFGAEE?>	A	41	G	31
9	37441650	T	95	CTTcCcctCttCctTcctcttcctttTccTcCctTtctcTCccTcTttCCcTcCTCTCcCtTTtTTtttCcTTTTCcccctCCCtTCCTCTTCcc	CEECGD<EGEEDDEDDDEDDEDDEEEGDDGDGDFE?EFEAGEEGEGFFAAEDECGG@GEFFGBFFEFEFDFFFFFFCEEEEFFFFFEEACE=9=B	C	49	T	46
9	74360395	T	175	TcCtTCcCCCCCtTTCccCtTTTTTTtTTCtcTtCTCCTTttCTTTCTCTCCCCtCTtCCCtcTTCCTTTTCCCTCtTTTCcCtCctCTcccctCtctttttcCtctttcccCCTtcCTcctcctcTcCctcCctctctCctccttccCttTcTcTtctctCtcccTcctcCCct	DA<@DBBCBDDDGDGDABDGGGFFFFGGGAGBGGDGDDGGGGEGGGDGEFDDAEGDGGDDDGBGEDDGCGGDD>GCGGGG>BDHDCHDGCCBCHDHCHHHHG;DGBHHGABCDDGGBDGCBHBCHCGCCCH?CCHBHC@CDHCAHHC>CHHFCFCFH@ECGCHCCCFB?F@BC@C	C	92	T	83
9	75783937	A	81	AAGAAGGGAAAGAGAGAAgaGGaAgGGGGAGGAGAGAAGgAGGGGgAGAGAAgAAGGGGaGGaAAGAGAAGGGGAGGagaG	DEHEEEHGEEEHEHCHEEGGHFFEGHGGGCFGCFDGDDGG=GGGGGDGDFDDGDDGGGGGG8GDDGDGDCBFFHDFEC?@C	G	45	A	36
9	78907125	C	31	TCTTTttCTTTtTCTCcCTcTTTCTTCTCcC	=GGGFFFEGGFFFFFFFFFGFFFECDBBA<C	T	19	C	12
9	78936492	A	234	GGAAaaAGAgGGAGGgaAGGaAaaggaGAAAaggaGGAAAgAAAggGAAaGaaaagAAgggAAgagaaAGgAAGaaAAAAgaaaGaAGgGggggAAGgaGagaaaAaGGGAAAAaGAAaaAAGGGGgaaGagAAAGagagAAGaagGgaaggaAAgggaAAaggAAgaGgagagAaGGggAggAgAAAGAAggAgagGaAGGGGGaagGGGgaAAaggaAGAGGAaAaaAGAag	BBCACCA?>B?ABAAEEDEACFDDFFDEFFBDFFDEEEFEFF:FFFEFFDEDDDDF@FFCF8EFDGDDFDFFEEEEFFEFGDDCADEEFEGGGGE8EGEDEDEEBFEEEEEF>FAEEEEEE?D>DDFEECDGEEEDEGEFDDDE:GDGEEEGEEEEGGEDEDGGADGE=EEG8FEEDDGG<GEDGEEEDEEEFEGEGDEDDDDDDEEGDCDG@DDEEGCEDFDAB?=?@?BC>;	A	129	G	105
9	78938186	G	49	gCcccGcCgggccccccgCGgGgcggccgGcgccgCggccgggccGgcC	ABGGHEGGDFFGGGFFGDFEFEFGGFHGGEHGHHGFGGHDGDGHHDGHA	C	26	G	23
9	85627408	G	69	AAAGGGgggAaggAGAAgGAAGaAaAAgaGAAAAgGGagagAGgGGAAagagaAaAaAaggaGaaaGAa	C<D=<CFFFEFFFHCHHFCHGCGG@HGGDCHHHGGBCEGGGFBGBBFGBHFGGGGGGGGGFGACBB8BB	A	40	G	29
9	89627102	C	52	CTtcTCCCcccTccccCttcCtccttCctTttCCcccccctCTtctTTTctc	<>DDEFFFDDDFCDDDF>E=GED6BFGEFFFFGGEEB;EEEE;FEFDDB?>B	C	31	T	21
9	90313717	G	69	tTTGttTgTtGGTGGGGgtGggTggGTGTtGgttTtTTggtgtGttGGttttgtGGgtTTttttgtggG	EEFEAECEFEEEFEEDEDEAFEDFFDEBFDEGFFDEFFGFFFFED:CDFFG6GEDDEEEEFFEFFEFFD	T	37	G	32
9	91262472	G	110	aGaGaAGGGgGaGAAGGaAAGGgaAGaGGagagAGGGAAgGAAgAGgAGcGGGgaaGAGgGGgGAAGagGAGggGgagAgAGaaGGAAAgAaGaggggAaAGaaggaagg	?@FGEEH:HCHFHECHIFEEHHFFEHFHGGGGFDHHHEDGHEEAEHGEH:HHHGFFHEHGFHGGDDGGGGDGGGGGGCDGAGGGGGDDDGDFGFGCGGD=CGFFCBB>AD	G	62	A	47
9	91934555	A	101	GGGagAAagGGgAAGGAaAgAAAAGAGaAGggaAAGAAGAAAAAgggagAGaAgagAaAAAGAAGGGAGaGgAAGaGaAAagAGGgagAGaGaagAGgagG	GFHFFDDFFHHFEDHIFFDGEEEDHEHEEHFGFEEHEEGEDEEEGGGGGEGEDGGEDGDEDGDDGGGDGGGHDDGFGGCDGGDGGGGFCFFFGEFED@??C	A	55	G	46
9	91978539	A	74	AAaaAaTAAatTaatTAtATAtatTaatAaTAaTAAaaTAtAaaattaatattTtaataaAAatttTaAtataa	C:BFEEAFFEEGEEEGFEEEDCA;HDEEFAFFDGFFEFGFF?FFCFEFEFFEFGFFBEFDEDFFADFEEEFBB?	A	45	T	29
9	91978591	C	56	ctcttTtcctccCccttTcCtctccTcTTcCTCCTTTCTTTCCTtCTccTTCCCCT	?>DDCFEEFEFFDEFEEGFGEGEGGGGGGDFG<FFFEFFFFFFFFAFGFED=BA@@	C	29	T	27
9	93657761	A	88	TTATTAATTTATAATTTATTTTAATATTttATaTATtTATTAtaTTTAATAATaAAttttAtAAAATttttaATATTTatATaAAtAA	BE<EEFFGG>FF;FFGGFFGEFC?FFGGFFFGFGFGFFEFFEFGFFFEBFEEFGEEFFFFEFBEE>FEFFF@EFCEEEGEFGEDA>BC	T	50	A	38
9	96714981	G	87	GAAGGAAAAGAGGGGgGAgaGAGGGAaAGaGAGGAGAGAAaAGGgGaaAGGGGGGgGGAAAAAgAGGGgAaGaGGagAagaAGAAAG	DDEHGDEDEG?GHGHFHADDHDHHHEEEHEHEHHEGDGEDEEBGCGEEDGGGGGG:GGDCDDDGDGGGDDEGEGGCFABC?@BAC??	G	46	A	41
9	103015184	T	129	TCTCCTTCCTcCcTTCTCtCTTTTCTTTTCCTTTTCtcCTTCCCCCTTTCtTCTTCtcTTCCTtCtTTTCTCTTTTTcTtttCcCTTCtcCccTCcTtctCTtcCCTTCTTtttctCcctTccctcCTT	B;DGGEEEGDDGDEEFAGEGEEEEGDEEDGFDEEEGE?GEEGGGGGCEEFFCGEDFEDEEDFDFFFDDEDCDDDDDDEDEEFDEFDDFFEFCDDFDDFEFDDFEFFDDFD6E?FE:FEEFDDB@A;AAC	T	72	C	57
9	103108641	T	29	ctctttttCcCttccccccttccccccct	CC@AAAAEAEFEEFFEFFFEEFGGGGGGF	C	18	T	11
9	104130469	C	50	GcCGCgGCGGCCcCgGgCGcgcGccggcGggGCcgccGgCgcgggGCGgc	BC>=>ADEAEGFBGCECFE@CBCBCCCCEDDEF?DCBEDEDCDDDDDD><	G	28	C	22
9	107456763	T	76	CCTtCcCCCtTcttCCTCcTttcctTTcCCCCtTCtCCTTtcccctcTcttTCTctTcCcctCctcttTTTcttct	BBBCACGDEEEFEEGGEGFFEEFFE9EGEGEGFEGFGGEDFGGGGDGDGFEDFDGFDEFGFF=GDFFFDDDFE@BA	C	39	T	37
9	107485326	T	36	CCcTTcTCcctCtctCctCctTTCtccTTcTCCcTc	BFFEEFEFFFDGEFEEGFGFFEEEFGFDDHDFFGDE	C	21	T	15
9	107593182	A	31	tTTAaAAAATTTTAtAATTATTTTAtAtaAA	CGFFDEEEEEFFFE?EEFFEFFEEED@>=?B	T	16	A	15
9	108275968	T	33	gTggggtGgttgGgggtTTgtgttGggGTtGGg	C?AAEEDHFDDFIE<FDEEGEGEEGGGGDEGFD	G	21	T	12
9	110084328	C	67	CCTcCCtCCCTTTCCtCtcTTtctCcTTTCTTCtCTCcctctcctctTTTTcTtcctTcTccCTttC	E?EEG?EFFFEFBFFDFEF:?EFEFGEFEGAFFEG;E:@FGFGGFGFEEEEGEFGGFDFDFGFFA@A	T	34	C	33
9	110249726	G	105	gagggaaaagaGgGAaagaAGGgagAGAGggGagAaggagggaGGGAagAgaaGGAaAgGGAagaAGAgGAGgggGAGgGaagggGgggggAGaGGgggggAaAG	CA@@CFFEECF<CECFFCFFCECFCEEFECCEFCGFCCFCCCGEEE<GDFDGGDEEG9D9EFFDGFDEDD;BD?DDEDDDGGDDDDDDDADE?FDDDDDDCF5CC	G	64	A	41
9	111641825	G	81	AgAAaaaAaaaAaAgGGgggGAGaaggGagaaaaGagggAaaGgaGaaaaaGAGgaagaAaaagaagAgAGGGagGAGAGG	>@AAEFGFFFFF5@CAECCCEFEFFCCEFCGEFEEFDDDEFFEDDEFG=FFDDDDGGDGDHHGDHHDEDEDDDGDDBABAB	A	46	G	35
9	111659483	T	110	ttggGgggGggGtgTGtgttgtgGttttGTTtgGggtGGGgGTgtGgTggTgTTTTgGGTGgGGTggGTtgtTttGggggggGttggggTgtgtTttgGTttGtgggTtT	CCBA?9BBFFDEEFDGEFEEFEFGEEEEG8GEFFFFEGGGFGGFEGG9FGGFGFGGGGGGGGGGGGGFGFGFG?FFGEGGGGEEFEGGGFGFGDFFFGFFCFF=FAA?<C	G	63	T	47
9	111746607	T	30	TCcCTTTTCTCTTtttCcTCtCCCtcCCTT	FFG?FFFFFFEEEEEEFHEEEDFFEHECDB	T	16	C	14
9	111911823	C	47	GCCCCGGGGCCCGCGGGGCCGGGgCCCCGCCCCCgCggCCGGcGGCC	>;DDDCC=CDCCCCBCCCCDBB?F<CCCBCC@CCGCFGCCBBD@5?C	C	25	G	22
9	112145799	G	127	AAagggAAGaAaGagGaAggGAagGGGAgGaAGaAGAgagaGgaggaaAGagaaaagaaggagAgAagAaAagAGaaaaagAGaaGaaaggggaggAaaGagagaaaggagGagaaaaaAAgagaGa	C>CAAA@C:AGGBFC7FGCCAGFCCCCHC@FHBFHCHCFCFCCFCCFFFCFCFFFFDGEBCFC=DFGCAG;GDC9GFGGGDHCFGCGDFCDDDFDDHGG9GDGAGGF<?G=>FD<GGEEHGCFBE?A	A	73	G	54
9	112145864	G	48	aGagagaaaggagGagaaaaaAAgagaGagaagagaGaAagagaGgag	C;BBF>EEFFFFF<FFDEFFFH;DFFECFFFEGGGECGGG8GGGBGGE	A	28	G	20
9	112918581	T	31	tCcTTCTTTCTTCTTCCCttCTccTcTtttt	BFEEEGFEEGEEGCDFFFFFFDGGDFDFCCC	T	19	C	12
9	113006420	A	63	GAGAAGAGGAAGAAAAAAAAGGAGGAGGAGGGGGGGGAAGGAAGGGgAAGGGGGGAaAAaAGg	:EHEEHEHHDDGDDEDCDEEGGDGGDGFDAGGGGGGG?DGDDDGGGGDDGEGGGGDGDAC@DD	G	34	A	29
9	114454544	T	41	CcCttcCTctcTTtcTccctTtTcCCTcTtttCcTTtCttt	ABBDDDGADEDDEEDEDDEEEFEBGFEDEFFFFDDDFE@AA	T	23	C	18
9	116028559	C	44	CACACCACCAACAAAAAaACCAAACAaaCcCAaAaACcCaCccC	DHDHDDGADHHDHGHHHEFCDH=HCHEED@CG?GFGCEC?CD?=	A	24	C	20
9	116037894	C	27	CTTTCCCCcTTTTCCTCTTCTTCTCCt	AFGCDDCDBFGDFDCFCFFCFFCFCD@	T	14	C	13
9	116044998	A	47	GAGGAaGAGAAGGAAAGaGaAAAAaGGGgggGgAGGgAgaGAgaaGa	GGHGF@GFGFFGGCFFGCG:EFEEEC=CEGHFHEFFEEECFEGCBC@	G	24	A	23
9	116048874	A	27	gGGAAGGAAGGGGGGGAAGAGAGGGAA	FHHDDGGDD=GGFGGDDDGDGDGGGEC	G	17	A	10
9	116151191	A	64	AGGAGGAGAGaGgAGGGGagaGaAaAAAAAGAaAGAGGAGAAaGAgggAGGaAAGGAGGagAag	A;A?CCGCHC>CGHCBCCEGAC=GBHHGGGBGDHBFBBGBGGEBGGGGGBBFGFBBG?>@AD9D	A	33	G	31
9	116152940	G	103	aGAAGGaAgGGggGAggAaGaaaGAgGGgggAAGAgAgaGgaggagGaGgaGGagAagagggggaaaAaagaAagagAAAAgGAggAgGgaGaaGAAGAaagA	C7ADACFG@CCFDCHFDACCFFF=HFDBFGF<DCDFHFFCFFFGFGBGCGGCCGGHGGGBGGGGFGFHGGG6HGGGEGCGGGBGGAGGBGFBGGBGGBGFGGE	G	53	A	50
9	116191244	G	77	GGGAaAaaGgagAGAgaAAGAgaagAaaAgAAgaaGAGagAGGgAAaaGGAgaaaaaGgaagGGAGagaaGggaGaG	=AEEFFBFGFFFFGEFFFGGFGFFFFFFFFFFFGEEFGGGFGGGF>GGAGEGGGGGGFGFHGFFEFFGGGFFECDAB	A	43	G	34
9	116770918	G	26	GggaggggagggGggaaagaggaggg	DFFFFFCFFFFCEGGFDGGGGGGFG?	G	19	A	7
9	117037915	T	122	TTTCCTTcTCTTTTCCcCCCtcCCTCTCctCtTTTTcTcCcTTTtTCTcCccCtCCccCccTcTCCTTCCtCCCTCTTccTTCCTCTcTTCCTttCtCCtcttctCccTcTCtCTTtTCCCt	CACBDGGCGDGEGGDDDDDDEDDDGDGCDDDEGFGGDGEAEFFFEGC>DDDEDFCCEECEEF=FCDEFCCFCCCF@EFEEFFCCFCEEFFCCFFBCFCCAEEDEFCDEFEECEBFE=D@=@9	C	65	T	57
9	117044654	G	136	GGgGGGGAAgGGGGaGgGGggGAaGggAGgaaAaAAGGgGGggagagGAggAAgGgGgGGGGGgaggGAGgggGGaaGAGGgggagggggaGggggggaGaggGgggggaGaaaaaGaggAgGggagaAgGGaaaG	:<>=:ACHHE>=7CECEB6EFA@EAE6D>EDEADCC:<G><EFEEBFB7EECCFC>CGA;<:AAFFGBC=GGFCABFAF>9GG5FGGEFFFBFCFFGFFB:EEAG@GGF><FF=CBAAFFBGAFF?EDDD>@@@:C	G	96	A	40
9	117399263	C	85	CCCTTTTCcCcTTCCTCCTTCCCtTTTCTTCccCTCTTccTTctcTCttTCTTTCTTTCCtCtccctcTtttctCcttttttTCC	;@DGGHFDDDDGGDDGCDGGDDDCGGFDFGAEADFDGFEEGGEFEGCFDFDFFFCFEFCC:CEEDEFEFEFFCFCBA?9@A>AC@	T	46	C	39
9	117668142	C	87	CcCCTcCcctcTCtTccTTCcTttCCcCtTTCTcctTccTtcTcTcttctTCttcCTcCCtcccTttTTctttttctcttttccttt	?A?>CCBDDEDGDEFDDGEDDGEEE;DDEBGDGDDEGDCGEDGDGDEFEFGDFFEDFDDDFEEBFFFGECEFEGFEEEFFEEEEFE>	T	46	C	41
9	117844239	G	31	gAgagaGagagGagagagggaagaggagaga	A@BECFFFCFCGFCFCFCCCFFCGDDGDGDG	G	17	A	14
9	119382768	A	117	AAAGaAGaAGaagGagGggaggGaGaaagagGgaagAgggaaagAGGAagaggaggGaaggaaaagagggaaggagagaaggggaGaaaGagaaaaagaggggaAggaggagggaga	BC<<A<>C@AEECAFCDCCFCCEFEFFFCFCE7FFCFCCCEFFCFEEEFBFCCFCCEFFDCFGFFDGCCDGGDDGDGDGFDDD>GEGDGEGDGGFFG?GD=DDEBD?GDDFCDCGA=	G	60	A	57
9	124910582	C	74	AaaaAAccaccCccccaACccccaaAcaaacaccacccAAaaaaccccacaacaacCaaAAAccacaaaacaac	A>@A>AEFEFGGFGGFCFGGFGGBD@GDDDGDGGCGGGFFDDDDFGH@EGEDHEEHFCEDFEHFEGEEEEDFC<	A	40	C	34
9	124929211	A	40	GaaggGgGAAggaaagaGgGAagaggggagagaGaaagaa	=ACFEEEEFFEDEEDEDEAEEEEEG8FFF7AGFDFFFDDA	G	21	A	19
9	126128253	G	109	GggGcccgGCgCcGccGCGgGgCcGCGGgggCGGgGGGgggccGgGCCgGgGGCgCGGGCGCGcCCCGCGgccgCGCGgCCGcgGgccccgGGGCcCGccgCCCgGCgg	=@@>BCDGDEEFDEDCEFEFEEE?EGDDGGEEEEAEEEEEFDEEGEFFF8FDEFFGEEEGCFEAFGEEGD?EEFFCFDGFEDEFDGDDDDEDDDEDEDEEFFGCCBAB>	G	63	C	46
9	126128679	G	26	CgggcggccCgGcggccccccggcgg	=ACCFEFGGEFEGFEGG?HGGG:@DD	C	13	G	13
9	126770250	C	85	ccCCCGGCcGCCCgCCCCcCcGCGcCcGGCCGGcCcCCccCcCGgCCCGCGCCCCGGcGGCCGCCGcgGggCGGCgGGccCcGCC	BBFFGEEEBEFGGCFEFFBBBEFEBGCEE7F?EBGCGFBBFCGEDFEEDEDEFFFDDCDDFFDFFDCDDDDFCCFDCDCBD;@>A	C	55	G	30
9	126794648	G	43	AGAGGAAGGGGGAGGAAGGAGgGAaAAAAGGGGAGGGGGGGAA	=CFEFCF<DDEEDBEFDEDDDGDEEEEEEDDD?ED@DDEEEFB	G	26	A	17
9	127217284	G	66	GGGGaaAAagaGGAGAAaAGAGAAAaGaGggGAAGgGagAGAGAgGGagAaGgaaAgaAgGgaGgG	@@@>CFHHECFCCHCHFFHCHCHHGGCGCDD@HHC@@FCHCHCHDABGDGBBDFGGDEGDBDFC=C	G	34	A	32
9	127255448	G	60	AGAGggaaAAgAAGAAAaAaAaAAGaaAGaggaaagGAAAGgaAgaaAAaAgGAGaAGgG	;=@<BDEEHHCEGCHGHFHFDFGH>GGG<GDDGGGDCHHGCDGGDGGGGGGDBBACC5>?	A	39	G	21
9	128001119	C	282	tCCtTCcctCTCCCCtccTCTtcTttCcctcTTcttCCCcctccCtcCCTTcttttcTTTcTCtccTccTCcCttCTCCcctCtTCCTTcCTCTcctTCCTcCTCTTtCCTTTtctcCTctcTTTtcCTctcCtTCTTttTTCctCcTCtccCcTtCCtCCcCTcCtTCcCTCTCCccTCCcCCTCCccttCCCTtTcTctTTTcccCCCtcCctCTtcTCTCcTCTttTCTTCCccTttTcCcCCCTTCtTCttTtCcTCTCTTCTcTcTcCctctccctc	A@A<ABDE@DDCCFFDFGEGFAFGCDGGGDGGGGDDGGGGGDGGDDGGGGDG9DDBGFGEGFGDGGHGGGGGGDDGGGGGGDGDGG=GFGDGGFHGDGGGFGGGEGFEGGGGGEHEHFFHEGGGGDHFFHEHGEGGFFEEGGGHEGHGGEFGGGGDEGCGG>GGHGEFFHEFGGGGHHFFGHDFFFFGHCEFFFFEFH6HEEFEHGHCCFCFE@EFFEHEFFFHFFFEEFFFFFFHHFEDFGFHFFDFFFEFFEEEEFGFFFCEFFEHFGCDBA=C@ABC@E	C	154	T	128
9	129143435	A	105	gAaaAaAGaaaagggAagGgGgGggGaAggAaaGAAaAgGgAagagGgaGggaAAGagAggGgagaagaAgAAgGGgggGGgggaaggGggagagGggGaaaaag	A@BCBBD@CEFGEEEH?FCFCFCFFCFHFDHFFCFFFIEBFHFFF?BCGCGEFHGBGGHGFCGGDGFGFHGHH;BBGFABBGGGGGGGBGGGEFGBFGAGDB:DD	G	59	A	46
9	129265397	G	112	GAGGAAAGAaAgGGAGGGGAGaAaAaaAGgGGaGGAAAGAgaaGAGAGGGAGAGaGAGgGAgAGgGAGgAGAggggaAGGAAGGaaagaAgAGggAAgggaaAaaAggGaag	?ACACE;EFFFCBEFEDEEFEFFFFGGEEDEEGEEDFEDFCGFDEEEE9EEAEDBEFDDEEDEDDDEDDE<EDEECGEDDE=DDGGFDGEDBDDEEEDDCEE<DDB?<A@@A	G	58	A	54
9	130251615	C	59	CAACCACCACCcCCCACCAccAAACCAacAcCCcccAcaaccAaACCcACCACCACAAC	D>A=FFGGFGGAFGGFGGFEEFFEFFEFEEEFFEEEEEFFEEEDEFFEDEEDFBCBABA	C	36	A	23
9	130493513	A	131	GAGgAGagAgAGGgaaggaGAAggggaaAagaaGggggagagGAGggaAGGagaAGAgaaaaggAgggAAGGgAagGAaGGgagGAAGaGAgagGGGaAAgGAaGgggaggagAgAaagGgaAGGgAAAAA	C?@BABBBCCDGGECDFFDGFFFDCFDDFDDDDGFFAFCFDFGFGFFBFGGDFEE:FFDEAEGGFGGEECGGGDEGGFDGFG<FGFFGEFEGDGFFAEEE9FE>F>GGEGGAGEEEEEGE=DCDDBAABC@	G	71	A	60
9	130493724	C	151	CTcCtctCtTTTCTtcCTcttCctCtcccCtCtTTCtttCTtCtTTcCTtctttTtctctttTccccCTTtTctcTtCtcttctctCCcctcTctccCtctttcttctCcCtTtcttttttccttcttCtccttccCctcctcttCccctt	DD??B5B@B>A>?A@@CC@DEFCGFEBABGGGGFGFFGGGGGCGG@BEGGBGGGCGBGAGGGGBBBBGGGGGBGBDG=?BGGBHCGDGCCHCGCHCCDHCGHHCDGBHFCGHGHCGHHHHGCCHHCHAFHCCHHCCFAHCBGCEHF??>CB	T	82	C	69
9	130495633	C	131	CGCGGCcCGcGCccgcgCGGGCccgGCgcggccGgcgggcCgCgcGGCCCgCGgGcgCgcCcGccgggccgGgcggGccgGgCCcGGGcgcGggGggGGcGGgCCCCGGCGCCgcGGGcCGGgCGcGGCGg	A><;=ACCCCCDCCFDDDCBCDDDECDFDEEDDBECEDDDDDDEDCCDDCFDBGCAFCEEDEAEEFFFE<GCGEFFCEEGBGCCDBBB@FE@FGAGGBBEB>GCCCCBBCBCCGE7BBECAA8B@<>CC@?	G	73	C	58
9	130550044	C	46	cctTTCccttccctcccTCcccctctctccttcctctTtcttctcc	C??@=A>=D@?@@FBABEGBBBBGBGAG9BGG=BHCHECCFGBB@?	C	27	T	19
9	130982416	C	190	ctCttTTTCtTCCcCCcCtttTCCTCTtTcCCtTccTctCCtTCTCTcCCCtcTCTTTtCCTTtcTtTCTCTcTCCCCcTTtCTCcCCCTctTTcTccCTcttTtTttTctCCtCCCctcTCctTccTTTTTCtTCTcCccctCTtcCTTcTCccTCtTtttTTtcCtCCcTTTTtttcttctCCTcCcC	AA=C>@@@@FFDDCCCCDEEEEDDGDGEEDDDEHDDBDEDEEGD;DGEDDDEDB>EGGEDDGGBEGFGBFCGEGDDDDEFG9DFDCDDDGEDGGE<DEDFE;EGFFEEFEBC@FCCCCE@GCEEFDEFFCFFCFCCFECECEFCFE9CFFEFCECFCFFFFFFDEEC=BBEEFFEFD>?CAB@AAD===C	T	98	C	92
9	131001692	G	280	CCCGCCCGCCCGCGGGCGGCGgggCCGGGGCCGCGCGGGCGGGCCGCCCGCCCcCGggGGcCGGccCCCGGGGcccCGCCCCCCCGgggCccCGGGGGGCCCGcCCCCgCGcCGCGGcggCGcggggCCCgccGCCgcccGGgGCCGgcgCCCGgCCGgcgCgCGCGgccgcCCGGCCGcCGCCgcgGCgcCCCCGGggccGGgcCCgcCCGGcCGcGGGCcGCCggCGCGGCgcCgcCgGcCCCGGGCcgggGCCCgCCGCgcGCcGCGGCcgGGgcCc	DB@?DEDCFGGAGHGHGHHGHCFE<GHHHGGGGGHGHGHHIHHGG=GE@HGGGDGHFEHGDGH:EEGGG8HHGDEDGHDGGGGGEHGGFGEDGHHHHGDGGEGEGGGGGGHEAHGHHDGFGHE?GGFGGGGEEHGGGEDDHFFHGGFGEFFFFGGGFGFEFFGDGFGEEDFEFFGGFFGECDFFGEEGFGEFFDFGGEG:EGGGEFFGEFFGGDFGEFGGFDGFF@GFG6GGDGDFDEFFGAEEEFFFEEGFFHGFGECDFDDBEB>D<CCB@?B@9=A?	C	149	G	131
9	131196334	G	59	GAGGGAAGGGAgGgaGagAGGGAagGGAaagaAgaAGgaGggaAAagaAAgGGgggGgG	A9EFFDFEAE9FEFFEGFFDDEEGGEEDGFGGCGGEDFGDGGGEDGGGDEGCEBF7B?C	G	35	A	24
9	131196336	T	62	TATTTAATTTAtTtaTatATTTAatTTAaataAtaATtaTttaAAataAAtTTtttTtTAaa	?CCEFEFA@ECHEGF;GHEECECGHDDDGEHGBIGADHGDHHGDDGHGDDHCDGHCCB<>B?	T	35	A	27
9	131289600	G	131	tGTTGttggggTTGttgGgttTGggtggTTggTTGGTTGGtggggGgGgGgTGgGgGgGGgtgGGTtttgggtttGGgGgTtttGgtTgTtgggTTGtttGTTGTTGTGTgGGggTgGGtgGtggGgTttt	??AAFFDEEEFEECEEFHFDEEFFFEFFEEFFEFHIEEHHEFFF7HGHFHGEGGHEHFHHGFGHGDFFFGGGFEEHGGFGEFFEHDFDADFCGGEDGFFEGDDGDDGDGDGGGGFCAFFFCDAABC??CCC	G	76	T	55
9	131347169	C	39	CtccctCCctcttctTcctcttttctccctttctccccc	BBEDEAGGF@EEEFEEFFEFEEEEFEFGGFDEGFGGGHF	C	22	T	17
9	131482148	T	145	TttTtTTTTTTTTTTTTTTTTTTTTTTTTTTTTTTTTTTTTTTTTTTTTTTTTTTTTTTTTTTTTTTTTTTTTTTTTTTTTTTTTTTTTTTTTtTtTTTTgTTTTTTTtTTTtTTTtTTgTTggTTTTTTgtTgtgggggtTTTt	BC@;:BBBDEEBEFEAFFEFDFEFFGGFFFFFFFEFFFF@EF<FEEEECFEEEFEFFFEFFF;FFAEFCFFFFEFFFEEFDEE?EE9EEEEB?;D;EDEE?EEDEEEE=EEE:EEE9EB5DE@CDDDDBE??E:C?BBB?>AB>>	T	134	G	11
9	131771505	C	94	TcCCtTtCctcttTCCcCCCTcTccCCttCCCtcTCCCctCTTTtttctTTccTTccTCcCTctcTtCCcCTCCccTtcTcTCTCCCctcCtTt	AADDGGGDBGBGGC@DBEED<BGBBDAGGDDDGCADDDBHDGCGAHHCGGGCCGFCBEDCDECHCF9CCCCFCC;CFHCFCFCFCBBCFBB@C@	C	53	T	41
9	131772154	C	248	TcccccCCccCCCcCCTTttttctTCtTcTtCCCcTtccttTCTCTTccctTctttcCCtctTTTCCctTttCCTccTTctCccCttTTTCCTTTCCcCtccTTCCTccttcCCTtctcTTcCTTtttccctCctTcttCCcctCttCtttccTCTtccCTcctcttcttCtttcttCtttccCTttctcTtccttTctcctccccccttccccccctctcTTtccctttttCTCtttttcttttcct	@AAC??@B:<=B@@DADDHGFFBFFFFFBFG?FFBFGBBBGFGEGF=BBBGFBGGGBAGAB@FFFEGBGFGCGEF@BFA?GFBBGGGF<FGFFFFFFBGGBBDFFFFCBGBBGFFHBGBFF>G=FHFFB@CEFBGFBHHGFCCHGH;<HHHCCEFEHCBGFCCHBGGBFHFGHH8HHGHGHCCGFHH;HCDCCCHHFCHCCHAC?C<CHF?@CCCCCHBHCDADA<BHHHH=FEEHHHHGCHHFF?>C	T	125	C	123
9	131825922	T	38	tttttttTtttttTttttTtttTTTTTTTgttgTgggg	A?7@CBBAEEHGF>GFFGFACGCBFEFFF?9@?E:8A@	T	32	G	6
9	131885279	G	30	GGAGGGAGGaGAGgGAAGGgAAGGAAGAGa	@CHCBBHCCGBGBC<GCBBDGFAAGC>CAC	G	18	A	12
9	132374601	C	108	AACAAaaAacCACCaACCCCACCaCccaCCAAAcCAcACaACaaaCAacacCCAaaaAACCcacCAACcCAaCcAcCCCcAACccaaCcAcCacacCaaaCccAaCcC	BABEEFEEEDGB9GEDGGFFDEFCFDDEGGFFFEGEDFFFFFFFFFFFEFDFAFEFFFF=EEDEFEFDEFEDEEEE?EEEEEEEEDEFEEEFFEFEFFFFDBBCAA@C	C	57	A	51
9	132377900	C	52	CctCctcctcTctTCTctTCtCctcttccccCtctctCtcCctttctccccc	ACB=BBDFEFFFEGDGF:F>E@FEFEEFFGGDFGF;>DFFDG?FDGFGGG:D	C	31	T	21
9	133917168	G	43	GaAGgAAaGGGGGaaaagAaaaggggaggagaaggaggagagg	BCA?BBBECDEEEFFFFCFFFGDDCDG9DG;GGDDGDDGBB9>	G	23	A	20
9	133967240	T	98	TTTtccccCCctcctTCcTCCCcCccttccccctTcttttccTttctTcttccctctcTcTtcttTtccTtCtcttcccctcccttcttctttttttt	<BAAFDGFBDGCFFDGDGFCCDGDGGDDGGGGGDGGDDDDGGBDDGBGGDDGGGCHEHGHGED?CGCHHGDDEH5DGGHEDHBH<EHEDH??E596=@	T	50	C	48
9	133967295	C	29	ccacccaacaacaaaaaaaaaccacccaa	C>ACCBCECDEDEEEBDEEFEDDDEEE=A	A	17	C	12
9	134404784	G	25	CcGCcgcGCGGccCGGGGGCGGGGc	ABECBCAEFEEC@F?DADDFCC9A=	G	14	C	11
9	134433463	T	39	tTTCCTCCCCCTTTtCCCTTCTCCTCttCCTCCCcctCc	GFFGEFFGEFGEFDHFFEEEDEEEEEHHFFEDFE=>CA>	C	23	T	16
9	135172412	A	60	GGGggaaGgAGgagGgagaagAgaaggaaAgggagaaggagggaaaaagggaaaagaggg	?AABFFEEFFEFFDEFCFFFFFCFFFFFFEFFFFFGGGGGEGGF<GGFGGE>GFGGGGGA	G	33	A	27
9	135173685	T	209	CtCCcttcTCctttTCtcttCccttCCCTTTcctcTttccTTttcctCCctTTTCtcccTCCtCtcccCTTCcTtTTTtCcCttcCTttTCtCTcCtctTTtcTCCtcCcctTCcccTtTTTCcCCtttcTttctTTttttcttTccTCcccttcCctCtccctcCTCtCtTTttttCttcttttTtttCTctCCcTtctCtTcccctc	C?@BABCB@@@BCFDEEFEEFEFEEGFFFFFFFEEFEEFFFEEEFFECBFEFFF9EFFFF;EEHECCFG:F>FFEFFFEGFCFEFGFEFFGEFFGFFFEFFFGFEG@DDGFF@FFGFFF=FFFEGFFEFGEFF9FFEFFFFGFFEFGFDGGGFFGEGFFFEBGFGEAEFEFEEFFFEFFFGFFFDEFFFFEGFFEEEDFFDFFCCA@CD	T	112	C	97
9	135375023	G	72	GgggaagaGaagggggaaagaGAggagagaagaagGagaaaagggaggagGGggggagaggggggaggggAg	D;@ADFCFEEFCCCCCFFFCFGFCCFCFDDFDFFCEFCFAGGDDDGDDGDGGDC=DGDF:DDDDCGDDEEDD	G	45	A	27
9	135861998	T	58	TGTtGTGTGTGgTTtGgTGGTTGTTGTGGGGtTTGTtGGTTtgGGTTTTTGTGTTTgg	??CDEFEFEFEGC@DEFEBBBEDE;DDDADDAEEDAEDDE@>ADCDCEEECDDEDD9A	T	32	G	26
9	135929200	A	44	CACAAACCAAAACACAAAACCCCAACCCCAaACCACAccAAAca	9GDHDHCDHHGFDHDHGGHDDCCFGDCCCG@G9CGCGEDGCD@:	A	24	C	20
9	135977586	C	41	ctCctTtTttCTtcTccttttctTtttccttcttctttttc	?BBCAFEFEEGFEDFDDEEEEDEEFFEBECFBFFEFFF>FD	T	28	C	13
9	136131315	C	123	ggCgCCcccgCccgCcgCCCCGGgcCCcgCgcggcgGGgGCcGCcGcgcCcCccGCGgccgCCcGcCGGGcggcCCggCGGggcCCGccGcGCGcCGGCgccCCgggccccccgGGCcCCgGC	>><C?BEEDEDDCFCDFDDDDCCBDDEDE?FDFDAEC=FCDDCDECCFDDEDDEADCEEEF@DE@EDCC<@GFEDDFF>CCEFEDCBEEBE@CAECBBCGEE@CGGGCEDEEEEAABDDA>A?	C	71	G	52
9	136131322	G	114	ggtgtGgGGGtgGGgtGtgttgtTTtTgTGgTgtggGggGTtggtGgTgGTTTgttgGGttGTTttgGTggTgTGTgGTTGtGtTggGGtttggggggtTTGgGGtTGTGGtTG	A@BBD?>AFEECCDCGDGCGACGE@GECB8CG@GCD9DCEBFDCGFCDDDE5DDHHDG;HH=GGBGBBFDCGDF?@D?F59DCGFDDFFHHHDDDBDDHFFADFFHEEEFADDC	G	64	T	50
9	136131415	C	138	TCTCCtTCTTcCCcctcCcctCtCtTCCCCtcCTTtTTTtTTTcccCtCCcTTTCcTTCCCTTCTTtCTTcCTCCCTTTtTcttCCctTctcTCCCccCCTTCCTCCTcCTCCctcctTCTtTTctttcccCctTTCc	CA@=?DCDGEBDDB>G?DBBGDGDGDDDDDGBDGEFGGCDGFGCCCDHDCCGFG=CGG=9?FEDFFCDGFCDGCCCF9FCFAHHC@CHEDHBBCCCCCC@FFCCFCCFACFCCCH6CHFBEGEG?GGGB?<A=ACC?>	C	73	T	65
9	136150556	C	33	TCCTcccTtTcTCTCTCtTtcttCTcTCcttCt	CDDFBACFHFCDDGDGDFFHCHGCFCFCCHGB;	T	18	C	15
9	136201191	G	77	AAAGAGGGAAGGgGAGaGAAAGGaAGAaGGAGGAGGGAaAAAGAAAgAGGGaAGGAAaGAaaaGAAGAaaAAGGAGg	AEH>CC6C?FCCFB<CDCHHECC;ACG<CBGABGBCB@EGFGC=GGAGA5BEGBBFEC5GFFCBGGBGBE=E?CC?>	A	43	G	34
9	136268084	A	76	gaAGGgggAAgGgGagAGAggagagggagaAaaagaggggggggggaaggGaaaagaggagggggGaaGagAggGa	C@C>;@@BCEC?GADFHCEFFDFDFFFDFDGDDD=DFFDFFFFFFGEEGE@EEDEDEGGBDDGGGBCEBDGG?F>8	G	47	A	29
9	136269143	G	37	GgGAaAgGgaAGgagGGgaAAGgaagGagaaggaaag	;CCHFFCCCFHC7FCCBDFFGCCFGCCFDGGDDGGED	G	20	A	17
9	136287582	C	54	tCTtTttCcTCTTCTTTCTtcTTcCTCCCCTttCtttTTCCtcTttTCTCTTcC	GDGGGGGDCGDGGAGGBDGGCDGCCECCCCFHHCIIHFDCCHCFHCFCECFF<A	T	33	C	21
9	136291361	C	303	cccctCCCttTTTTCCctcctTCtctCttCTTCCttccCtccttCTCCtctcCCTcttCCtTCCcccCTccccctcttcCTCccTCtTTtttccCCCCTTTcttccccctctCCCCCCCtttTCTCCCCCCTCtcttCtcTtctTttTCCcccttTTCcttTTttctcCTcctCtctttcTCccTTCtctCctcCCCtcttcTcttTtcTCTTCtTccccCCttttttCccCctttcTtccttcTTtccttttCTTttcCCctccTCTctTCcctcCCTTTTCCCCctccCtcTcctcccctt	AC6CBBA>CC?AA@@@>D8@FEFHBHEFGG?FFGEGAB@GBBGGGFFDGBGBGGFBGGF@GEGGBBBGFB@@BBGBGG<GFGBBFFGCDGGGBBGGFFFEFBGGBB7BBGBGDGFGFEEGGGFHB>FFEGGFGGBGGFGB=GAGFGGEFFABBGGFFGBHHF7HGCHCFF@CGGFCHHH?F8CCF5EHCHGCHCGFFHCGHCFAGCFHCFGFDGHFCC@BFFHHHHBGFC?DAHHHCEHCCHHCEEHCCDHHHFEEHIBFECHBCE6ECGDECCHCEFECECFFEECH@CFFBC??@9>><;@	C	162	T	141
9	136305530	C	241	cGCcCGCcggCCGGggCGGCGGCCCCGCGGCgCcGgCGCccccGCGGCCCCGgCCGcCGcgCCCCggGGgcgGccGcggccCCGGCGcCCCCggggcgCGCCccCcccgCCGcggCCcgGGggcCgCcgccgcCGCGggGCGcCGCccccCGGCcCggccGGCgccCGCcggcgcgCCCGcGGCccgCGGCCccGCgccccgggggcGGgGccggCggGcCgGccCcgcCccCggcCcccc	C>:>=<8@DDBDBCEEDCCDCCDDDDCDCCDEDDCEDCDDDDDCDCBC>DDCFD@CDDBDFDDDDFECC>DFCEDCE?FEE>CCCDCECDCDEGGFEFDCDCEEDEEEFDDBEEFDDEFCCGFED6DEGEEFDDCCBGFADBECBCE@EDDCCDECDGEE@>BGEDDBCBFFEGEGCCCB@B<CEEFC>BCCEEBCFEECEEGGFFEBBABEEFFCGFBECFBEEBEFDDDCCB@AA@9>@	C	137	G	104
9	136308542	C	44	cTTccCcTTTcTtcTtTTtTTcCTcCttTtTttTtTTCtcTttt	<@CBCEBEFFBFGBEG<FGF<BCFCFHHE5EHHAHEEEGCC@CC	T	31	C	13
9	136319496	G	72	GGGAAGAAGGGGGGAGAGGAaGAGAGGGaAaAGAAAGgaAgGGAgGGAGAAGGagagAaaGgaGgaAGGGag	@@GEBHEEHGBHHHEHEGEEGHE@EHHGFE9EGDED<AGDDGGDDGGBGDDGGGDGDDGGGCGGCE@DCC?A	G	40	A	32
9	136339181	C	91	TTCtcTccCCTTtcCcTTCTTttcTTTCcctctTtCCtttttCttccttTtctcTctTTttctTcTCcCCctTtTcttcttctctTcctcc	@ADEDGACDDHGEDDDGGDEGEEDGGG;BCEDEGEDDE;EDEDEDCDEDG=DFEGEBGGBDEFGAGDEDCEF@FFCEEEFCEFEBFEEFD=	T	53	C	38
9	136340200	T	56	TgGtGgTGtTTgggGGTtGtTgtggTtgGgtTtGgggtTtTtTTgggtttgGttgt	?C=C@BAEGFDCCCECFGDGFCGCBF6DEDHFHEDDDHEHFHEFCC?HAHDDCBCG	T	29	G	27
9	136405042	T	65	ATtAtAtTtttaaTaaaaaaaataAAATtaAtttaTtatAttaaAaaatAAtTtataTtaatatt	@=DAE>DEEAEEFEFFDFFFFFEFECEDEF@BEEE9EFEEEEGGDGGGFB6FEFGBGDFFFAGC@	A	35	T	30
9	136559460	C	92	tcTCCcCCtCcTccTCcTcCtTcccCtTCcttcCtcccTCCtTccTTCcccccCcCtcCCtCcccCTTcCTccCCTtccCtTccCcTCtccc	C??:;?GGGGBEBBGG@GBFF:BBBGG9G9GGBGH:CBCGGGGCCFB<5CCBCECGHCDEHF;CCFF8CFB?7FFFHC=DHFCCF=DAB><5	C	63	T	29
9	136596397	G	33	AAAAAaAAAAAAAGGAAGGGGGAAAAGGAGAGA	EFEFFF?FE<EEDFF@EFFFFFEEEDFFDD:?C	A	22	G	11
9	136640226	G	32	ggaGagggaggaaggggagaaaggaaaagAga	CCDFFCCCDCCFFCCCCFDGGGDDGGGGDEDD	G	17	A	15
9	136641313	G	77	CcCgggcgCCcccgGcCGGcggggccCccccGcCGgGcGGcccgGCCGccCCCGggcgGggCcccggGcCcgcccgg	A@A@ADCCGFBB9CGBFGGBCCCCAAG@BBBGBGGCGAGGBB9CGGFFCBGDCGDAC7@DDFCCC=DCCECCC;>>=	C	43	G	34
9	137592961	T	40	TTCTTCCTTTTCCTttCTCcTtTCCCTTTCTTTTTcCTtc	EEGDEGGEEECGGEFDFDFDAFDFFDDDDFDDCCCADBC@	T	25	C	15
9	137623555	T	35	ctctctttttCcttttcctctttcttcctttcttt	AAA@@9GGFGF;GGGGBAGBGHGCBGC=<HHCBGA	T	23	C	12
9	137630568	C	78	tctCctCCCTctcccCccTCcccTTCTctCcCTCCTttCCtCCTcTCTtCCtcccTcCcTCCcctCCctccCtCcTtc	CCEDDE8GEADEDDDGDDGCDDDFFGFDEG<GCGFCBCEFFFFDCEFEFGDFEEEEEFEEFEEEEDFEBEEFFFEE6?	C	51	T	27
9	137642489	G	175	GggCGcGGcGCcGCggCCCcCGGgccGgccGGCGGCCgcgGgcCcCCCCgcCcgggcggCGcgCgcCgggGCggGgGCcCGCgGcgCgggGCcgcGCCggcgCcCGCGCCggGGgggccgGgcccGGcGccgCGGCcCCGcgcgcCCgcGGggcGCcgccGCcggGCgCCCGggC	?@@@??AB@CEBCFBBG<CBFDDCA7ECBB:EFEEGGCBCECBG:GFFGCBGBCCCBCCFEBCG5BGDDDEF8DEDDFCDEFDECDED:DEGC7CEGGDD=DFBGEGEFFDCDEDCDC<DEDCCADDCDCADDDDFCCF=BC@DCFEDCDDBDCDFCD=CDECDBBC@B@@B=<?	G	90	C	85
9	137645988	C	88	tCCcTCtCtTCTCCTCTCTTTCTCCTCTTCTTCCtTtTTcTTcttCCCcCTTttcTctCCtctTCTCTTcTTCTTCcCCTtccttCTC	B?BBBDDCGGDGDDGD?DFGGDFDDFDGGDGGDDGGGFGCF@@HGCCCCCFFHHCFCACCHCHFCFCEECFFCGFA9AAD@=>B<=CA	T	47	C	41
9	137687038	A	215	aGgaaaAGAagaAagGggagaggaGaAGAAAAagAAGGGggGaGGgaaAggGgGGGAGAAaGGAAgaggagggAGGAGGGAgAaggAGaAGAAaAAAagaaAAGagAAGAgAgGAaAAaaAggagAGaaaaAaAGggAgggGaggAAgGGgggaGgAAaaGAgaGAGGAaaaaGaagagaagaGgAAaaaAggaggggaaaaagagGaGaaggaG	A<ACEEGAFFBEHFCAB@FBFCCF>FHCHHCHFCDHCBCCCCFCCCCFECCDCA;CHAIIE@CHHCFCCFCCCHCCHCBCHCAFCCHBGCCHHFHHHF8GGFGCGDHHCGDHDCGGHHGGHDDGDHAGGGGHG@CDDGDDDBGDDHGDB<DCDDBDGGAGBGDGAGBBGGGGGBGBBGCGGDGBDGGGGGGDDGCDDDEDGGFCEDCF?AB<<A?	A	114	G	101
9	137702200	G	36	CcgggGgcGcggGggccgggccccgcgcccCcgcgc	>?CBCECBE=CBED=CBCCCBBCCDCDCCBFBDCDB	C	18	G	18
9	137709795	C	40	CccCCttctcCtcttctcttcCcttccccctcccTctctc	AC??<<@DAFCCGDDG<GD6GCHEEGHHHFEEHHFHEHEC	C	25	T	15
9	137775212	G	98	AaaggaggGaAAagaAaaggagGGgGagggaAGgaAGaGgAGAggggggggaagAGaGAgGaagagGgagggGgAgaagAGggGgaGGgagagggaga	CC<FGDAEEDFFDFDFDCFFDFEEFEDDFFDDEFCFEDEFFEFGFDFFFFGECGCE;DEGEEEGEGEGEFGGEGFGEEGEDGGD>EDDEEFEGGFAAA	G	59	A	39
9	137809685	C	62	ACCACcaCcaaCCcCcaAaaCAAaaCAaccaAcaacaCaAcccAaAaAcAaaAaCAaCaAac	=?6FFDEFDEEGGDFDEFDD7CEFFFEEEDDFE6FEEGFEEEEEEEAEEDF7EEEDDDBAB@	A	37	C	25
9	138642912	C	28	CcAacaaaCAaacccaAaaaacccaccc	?C?E?FEFGFFFBBBFFGEFGC;CGCC8	A	15	C	13
9	138656783	T	38	TCcCTCTCTtTTCCTTTTTTTCTCTCCTTCTcTCTTTT	CDGEGDFCGEGFCDFFCCFFFC@CFCCFFCFHEBFFCB	T	24	C	14
9	138656838	A	105	aAAGGAAAAAAAGAGAGGAAGAgAGAAAAAGAAGGaAAAGgAgAGgagAaAAgGGGAGAGGAGAAAagAAAAGGGAAaGGgagGAAAaAAagGAAAaAagaGGAA	CBFBCHFHHFHHAHCHC@GHCGCHCHHGHHBHHCCGGEHAD6?GBDGDGGGGDBBBEBGBBGBGGGEDCGGGBBBGGEBBDGDAFGGGGGEDA@EEDEA??CAC?	A	65	G	40
9	138657053	T	93	TtgtgTttttggggttGttGTTgttttggttGgGatGgtgGTttggtGtgtTtGggtgttttttgggggggttgTggggtggGGgtgtgggtg	BAC??:?:A@CCCFDDHCDHEEFDDDDFFDDHFB9@HFDFHEBDDFEHDFDEDCDFDGDEEDEEDGEGGGBEEFEGGFFEEGGHEFCEGEGAD	G	48	T	44
9	138657635	A	38	AgggAAgAAagaagAGAaGaaAAaAAgGaaaaaagaaG	=>BCDFGHHFFFEF@:GFCGF;HFAG?CFGGD9EBGAC	A	26	G	12
9	138675801	A	47	CaAAACCAAACCAAAACAAACAACCCACACAACACCCCACAACAACC	EFEFEG<FFCGEFFAFFEFF=EF@EGEEEEEEEEFFFFDFFCCBBA?	A	26	C	21
9	138703476	G	29	CCgGgccgcGCcgGgCggccccccggcgg	@E=CDBCCBGGBCGCDCCBBCCBBDD>DD	C	15	G	14
9	138757088	A	134	GGGGAGaaaGaGGAgGaaGAGgGAGgaGAaaAAggAAgAAGGAAgaGAAaGagaGAGAGGggGgAAgAAGAgaAGAggAaagaaAggAgGAaaAGGaaaAAAGGgAAGaGGaAAGggAAGAAGaAgAAaGGAAG	@9<9GCFFFCFCCHCBFF?HBC>HCDGCHGGHHDDHHDGHBCHHDGCAGFAFDFCHCHBBDDBDHFDGGCGDGGBGDDGGGDGGGDDGCB;GFGBBGFGGGGBBDGGBGBBG=FBDDDFAFGAEGCFEC>>CC<	A	72	G	62
9	139091460	G	89	AAGgAGGAGgAGGGAGGAgAggAGAgGaagGGGAaGAAAaGAaGAGGagGAAGggaGGGaaGGAGagGGGGGaAGAGGGaAAGgAGGGA	FFECGEEFDCFEEEEEEFDFDD9EEDEFFDEEEEGEEEFGDEGDECDGDAEE@DCFDDD?GD>CDGCDDDCCBDDECDC8FECAB@@A5	G	52	A	37
9	139405261	C	101	tcTtttttccTtCccCTTCttcccccttttTTCttCTTTTctCctCtttctctcTTtTTCtTTTtCtCCCctctTcccctttcctccttttcccttctTtt	CC?DCDFFBBEGGBBGFFFFGB@BBBGGGGFFGGGGFBFFBGGBGFGGGBGBGBFEGFFGG=DFHGHGFFAHCHBC=CCHHHCDIBCHHHHBCCAHCEBCB	T	60	C	41
9	139411714	T	75	CTcCTTCTCCCCCCCTTTTCCCCTCCtccCTCTCCcctttCCTCCCTTCTTCcCccTCCTCCCTtTCCCTCCCCC	@FBFGFGFDGGFGEFFFFEGGFFFDDHCC?EF?GECCHFHEFEFF8EEEEE:CFCBEEFEEDDECEDFCDB9A<C	C	49	T	26
9	139411880	G	114	gaaAAgAaAGGaaaGGAGggGgaGAAagggaagggaAaaGgagGGAAgaGAgggaagGgaagaggggagggaagGaaaaaaagaaAaaGAagGggagagGaaAgagGgagAgaG	C?>>?>>DCCDDGEFFFFEEGFFFFFFFFFEFFFFEG<FGFFFGGFEBBGFDGFFFFGGFGGGGGGGGGGGGFFGFFFGGGGG;GEGGFEGGFAGGGGGFGGEHFGFGGFEGBA	A	57	G	57
9	139565150	A	114	AGGGGaaggaggAGaaggaaaGaAAAAAgAAgAAGGaaAGgGaAgGGaAGGaGgAAgAgGGAAAaAAGgaggGaAAGAaggAGaagaggAaaaGagaGaaAaaAAaggggagga	C@=???A>BCCDEBDDEDEEEGEFFFFF=FFEEFFGEDBGFGEGEGFEEGGE>EEFFFFGFEFFEEEGFEFFDFDFGFEFDFGB;FBFFEE>FFFGBFFFDFFEEEAGFFDGFA	A	63	G	51
9	139748483	G	171	GAaaaAgGAGGGAgaAagGgagGGaAAAGaAGGGgaGggggGGGaaaGGaGgAgAAAgGGgGGGGaaAGggaAgAGgaAAggaAGgAaaGAAgggGGAAGAGAgAGGAaagagAAagAAagaGgAagggGaggagagaGGGGAggAgaaAgAGgaaGGAAggGGGaGAaaa	;@CCB<CBD?A8HEEFEEBFEDCCEEHC@EFACCEEC=FEFDCCEEE=CEAFGFGCHECCDBBCCFFGCGFEGFBCGFDHFGDHBFHFFAHHEFFACHEBHBFFH;CFFEEFGGGEG?GF=F@GGE5GGBEFEFGFAFBBBBGGFGFEFGGFBG>FBAFGADAA>@>C@@B	G	92	A	79
9	139750902	C	294	GCGCCGCGCcCGCCGCGgGggGCCCGgCCGCCGCCGGGCGGCCCCcGCCCGCGGGgGGGGCGgCGGCGGCCCCCCCCcCGGCCGccccGCCgCCGcGCGCggCCcGGCCccCCCCCgCCGcgGGGgGCCGCCgGGGCcccGGgcCCCCcccgCGGcGGGCCccCcgcCCCccGGGGCccgcCCGgCCggGGCCccCCCCGcgCCgcGgcCgcggggGGCCCccccGcgCCGGCCCGCCcggcggcggCccccgcGGcGGCggCggcccccCGGCggccgCgggcGGcCGCggcg	>?@BBBCBDCDCDDCDCECEE>DDDCFDDCDDCDDABCC6BDDDDDBDCDCDCCCECBCCDCGDCCDCCD7DD>DDDDDA5CDCB@EDBD?FDD;DCDCDFFDDECCDDEECDC?C8DDCEFCCCFCDDCDCECCC@BED;BGEDDDDECEFCCCECCBACBEDEFE7DDEEBBBBCEEGECCBCCCGFBB=CEECCCCBEGCCGEBGDC<DFF>EBBCCCEEEBBEGCCB@CCC@CCEFFEGFEGGCEEEEGEB>DBBBFFC<FEAEEDDBBCFFD?BABB@;=>=C?CCCB?	C	165	G	129
9	139835622	C	129	cttTtcccCtccCTcctctccttctcctttTctcttctttcttTtcttctcCcTTctcctCTttCCtcttttCCtCcctcTTccCcccCtctCtTcTcCCctttcTccTCcCcctTCTTCCCTTcTCTc	CC??C?>?@E@@BECCGAFBBGGBGBBGGGGBG@GGBGGGBGGGGBCFBGBABEDBFBBGDGGGDDGBGGGGDBGDBBGBEGBCCCCCDHCFDHGCGBDCCHHHBFCCFCCCCC7FCFFCCCFE?C@A8	C	67	T	62
9	139866247	T	78	TTtgttGtTTgtTGtGgTttgggtgGgTtGtGTttttgGtgttttGggGtgtGttgtttGgggtgtggtgggggtttt	<=CA>D;ECD:F>HGHCEGGCCCGCHCCGHGHEGEGGCGGBFFHGHCCGHDF:HHDHA=HDDDHCHE;HDDDDDHA;?	T	42	G	36
9	139887042	G	78	cCGGGGGcCGGCCCCcgCGcCcGCGCGcgCGccCcGccGCcGgcGggcCgcGcCcggCCccCcgGGcgccggccgggC	C@DCEEDBBEEGFEGBCGEBE=AGEFEB?FEB@ECECCDGCADCEACCFDBECFCDDEFCCGCDDCCDCCDDBCDD<C	C	44	G	34
9	139903972	A	86	AaAAaAAAaAAAAAaAAAAAAAAAAAAAAAAAAAAAAgAAAAAAgAAAAAAAgAAggAAAAaAAggAAAAAAAAAAgAAAAAagAA	>D=@FECEEEF?BFAFBFFFFEEFFCBFFFFFFEFEE7@EED9E5EEE6EDE>EEACDEEEGECD@DEDDDDDEDE?DCBB><:CC	A	77	G	9
9	139912178	G	96	AGagagaaGaaaaaaAGgagaAGAagGggaAagAagAagGggaggaaGGaaGgggagAgAgaGgaAgGGaGGAgAAGGagGAAagaaaGAagGAAA	C@GDE@EF;EFFFFFHCCFCFFCHCCCCCFHEBCFCHFCCCCFCCFFCCGFCDDDGDHDHDFCDGGD=BGABHDGG7BGDBG9EDGGGBFF@>;@>	A	51	G	45
9	139929080	C	73	TTCTCCTCCTCTCttTTCTCCCTtTCtTcTctTtTctTTTTCTCTTTCCCcTCCcttTCttTCCtttTTctcT	BACGADGDDGDGDDFGFDGDDDFEGCFGEGE@FFFDEFGEFCFCFEFCCCEFCCEFFFCDEFCCEFEFECFDA	T	44	C	29
9	140051238	A	109	AGggAggAGaAAGggAGgAGaGGaGaGaGgaAGaGAgAAgAGAgaGgGagAgGAaAAAgaAGAAAGAAGAggGAAgaGaGGAgaAAAAagAaAAAAGGAAGgggGAGAG	@=BA;BCFCFHHC=CGC@HDFCCFCFCF<8F=CG:CCA:CHAHDGBDCGD:CCHFGHHDGGCGGHBGGCGADBGGDHBGBBGDGGGGGGDACFGDC=>D@>;:>ACCC@	A	57	G	52
9	140100224	A	107	AAAGgGgAaAGGGAAaGaAAGAaAGAGGGAaGGggagAaAgGgagGGGaAaagAAagagaAaaaAAAGGAgaGgAAggaagAGAaaAaaaGGaAAagggaAgggAgG	EBB>CAFHEHCCCHHECEGHCI=HCHCCCGEC5AFFGHFHDCGDFCCCFHEB8HGFFFFEFEFFGHGBB;G=BFH;@FBFGGBGFFGFFCBA=CGFGFDC=FFEDBC	A	60	G	47
9	140108969	C	42	ccCtttcctTcCTtttttTtCTTCTTttTTTTTTCctTCtCT	A>>=BBCDEDDDGFEEFFGFCGGDGFFFGFFFCFCEEFDA?A	T	29	C	13
9	140120396	C	47	CcCCtCcccttcTcTTcccTCcctCTCcccCttccctTTTCttctCC	>:BBFGBAAGGBE@=FBBAFFB=HGCGBCCFHH;CCHEE?FGHCGG?	C	29	T	18
9	140323906	G	52	GccgcgccCGCGGGcgcggggGccggCCGcGGcggcggggccgcggcgccgg	?=@D:CBBGEFCEEBCBCCCDEBBCBGFECBDCDDBDDDD<;D7DCCBC>?;	G	30	C	22
9	140328077	C	57	tTcCcttTCtTCCTtcTCCccTtCTTTTTccTccTtTTTTtCTCtcCCTtCCCTTCC	CD?CA@CGDGGCDGGBGCDACGHDGGGGGC<FCC?HFFFFH@FCHCB<E;@AAACCC	T	31	C	26
9	140357848	G	52	CCGCCCCGCGgCCcgGGGCCcccGgcGGGGGCcGCCGccGGCGGCcgCgGCC	B?HEEGGHEG=FGCDGEHCACCCGDCGGGHHFCGFDABCGGFGGF>DFDGB?	C	28	G	24
9	140638607	A	42	ttttatttaaatataAatttAaatAttaTttttataaaaata	A@D7DDDCDDDDDDDFDDCDFDDBBBDDFDEEEEEEEFAEEB	T	22	A	20
10	3145906	A	65	AACCACACACCAACCCCCCAACCCACCCACCACAAAACAacCcAAACCAACacaCccACccAACC	AEBEEF;G6GGEEGDEGF=ECDGGEGGEEGGEF>BDCFDGCFCDDDFFDDFFCEFCCDFBB<AC?	C	37	A	28
10	3178815	G	56	CGgcggcCggGcGCggGGcGcgcGgcccGgCggccgccgcggggcgcCGgggCcgg	BEACB?GGFFHFHGFFHHFHFFFHFFFGHFGFGFFGGGGGGGGGGGGGGGDGFGGG	G	33	C	23
10	7319078	C	32	cgcgGgggggggggcgCcgcggggcccgggCc	>FDEFFEEEFCCFFDEFEG;GFGFEEECFGD@	G	21	C	11
10	7798150	C	29	TccCCtccTTttTTCccCctCCtttCccC	BFFDEDFGGGEFGGDGGCGFCCFFECEF?	C	17	T	12
10	7838222	C	40	gGGgCGgCGcCCgcGggGGcGGccGgGcGCCCcCgggcCg	FHIFEHFG;GGGEHHGGGGHHHHHGGGHHFFFHFGGGHF?	G	23	C	17
10	11330525	G	109	GGGgaGGgAGAGgGgaggaggAGaagaagGagagGAaggaggggggaagAaaagagaagaaggggggaggaaaggagaaaaaaaaggaagaggagggaggaAaagggag	BBBCA@9@ABBECEBFCCFCCEEFFCFFCFFCFCEDFB@CCCCCCCFFCFFFFDGDFFCGGDDDDDDFDDDGGDDGDGGGFGGGGDDGGDFD6GEDDDDDGBFGDD???	G	60	A	49
10	12292454	A	37	aAgaagaaAAgaaagagaAggaaAagaaAGagGaAAg	ADEEEFEEF<BDEDEEEEHEGEEHFEFFHB7FBCGGF	A	25	G	12
10	13214427	A	159	agaggAGAAgGGaGAAAGGgGGggAggAGGagAGAaGaagAagGAaGAAgGGAGGAGAAAGAgaAGGGGGGAgaAAgGGgaAaagAGgGAAAGAGAaaAaGAaGGGgaGGaGgAGaGaaggggGgaagGaGGggAAgAGGggAAAGaGgGGGggAAggG	AA>ABAFDFFGGDGDFFGGFGGFFCFFFGGDFFGFDGDDF:EFGFEGFFGGGEGGEGFFFFFG;FG=GGGGEFDF=GGGAEEEEGFGGGEEEFFFE9EEDFEEFFFBEFFEFGEFEFEEGGGGFGAEGFEFFGFEDGDEFEEEDDDADAC>C<AAA9@A	G	90	A	69
10	13239651	A	62	AGGAGAGAAAaAAAAAAagAGAAggaaGGGAGGAGGgAaAGAAgaAGGGaaaGaGggGaGAA	?@BFGFGFFFDDFFEFFEGFGFEGGEDFFFEFGEFFHEDEFEEGDEFFFEEEFEFGGEEEDB	A	35	G	27
10	13275676	T	81	tccTTtcttTcctCCTtTCcttcccctccTCctCttccttCtcttctTCTTtTcCcCttctCtcccTtctcTtttTcCtTC	C>=>BB>DC=@CGDDGGGCBGGBBBBGBBGDBGDGGBC:GDGCFHBHGDDG:GCCB8HH;HCHCCCFHCHCEHHHF@BCFC	T	43	C	38
10	13693883	C	201	CCtCCCTCCCtcCTTTTCTCTTTtTCCCcCttTCCtCCCtccttTCtCCcCCtcccccttCCCCcTTccCtttTtTtttcttTccTCtctttcTTcccTTcCCCctTTCtTCTTTtcTcTcccccctCtTctcttCtcctCCcctcCcTtttttTctctcCtcTcCtcCCccctctttcttTttcttCCttCcccccctCt	BEAB@AAACDBEEEGEEEGGGG>DGCGGFGDDGGGDGG8DGGDDGGDGGGGCDGFGFGDDGGGGGGFGGFDDCHDGDDDGDDGGGGGEGEEDGGFHHHGFHGGGHDEGGCFGGF5EHFHGHHHHHHEGEGHDGEEGEHGEGGHHEG;HGDE?DEFHEHEHGEHFHFEHFFHHGDHDEEHEEFEEHEE8EEEFH?GFDA@A@	C	106	T	95
10	15256194	G	108	ggaaAGAGggGgGgaaGaAAAGGAgaGaagAgGgaaGGAggAgAgGGGGGgaggGaGGGGGaaaGgGGGGGAAggAAAaGGaAggAggaggAaagaaagGAgGGGGGg	?>ADFEFEFF;FEFCDEDEFFFEFDDEDDFFFEFDDEEFFFFGEGEEEEAGEGGEEEEEEEDEECGADEEEFFGGEEEEDDDEGGEEGCGGEEEGEEEGDCBB@@BAD	G	66	A	42
10	17156151	A	64	AAaaagggAAgaagggGaaGGgGAgggGgaaggagaaagaagAgagAGgGgGaggGaGGAaggG	CC=D@FFFFCFADFFFFDCGGGGFFGGGGEEFGEGDEEGEEGEGDGEFGEGFEG?FEFFDAB@?	G	37	A	27
10	17194026	A	65	agAGggaagGgaagagggAgggGaGGAaAggGgagggggAaAgAAAGaaggaaaggGgggaGgag	BCB@GGDBFEFDDD:>FDFFFFFDFEDDFFFEGEGEGGGFEFFF@FDEDGGFFFHEDFGGEDGE?	G	39	A	26
10	17210881	A	74	AGagAAGAAaaaGaAGAGAGGAgAAGaaAGAAagagAGAGAaaagAGaAGGAgGgGggAgGaagGaggGaGaGa	HBDDHHCHHDDCCDH?HCHCBHGHHBECHC@HEGEGHBHCFEDDGHBEABBBEAGAGGGGBEAGBEGEA@>?CB	A	40	G	34
10	17365169	A	25	gaagaagagagAGaaggagaggaga	CCC@CDDDFDFFHDDFFDGEGGEGD	A	13	G	12
10	18789724	T	41	TGGGTTGGGGGTGGGTTGGggTGttgGGGgTTGTTGTGGTT	EGGHEEH9HHHEHGHEDGDGGDGFFFGGGGDDGADGCCDAC	G	25	T	16
10	18828670	T	31	tcctcttctttttcCTTTCTttttttttttt	?@CBBBCCBDCCEFDDFFCFEFE7EDDDE8F	T	24	C	7
10	19229638	G	41	AAAAAAgGaAGGaAaagGAAaaGAAAaGaaGgAGgAGGgaa	CBGHGHFCEHCCFHFGGCHCGFBHFHFCGGCGGBGGBBGEB	A	26	G	15
10	19229645	C	40	GGGcCgGCCgGggcCGGggCGGGgCggCcGCcGCCcggcg	BCFFGFHHEFHFFGGHHFEFHHHGGGFGHHFHHFFHGB@B	G	24	C	16
10	19571940	C	56	CCCTTCCTTTTTTTCTTttTcCcTCcCTTtttCtttTTTcCTcCccTCTtTTCCCC	B9DBDDBEFGGFGGDEGHGFHAHGDHDGGHHHCHHHFFFHCEHCHHFCFHFF:A=A	T	32	C	24
10	19571941	A	57	AAGGAAGGGGAGGGAGGggGaAaGAaAGGgggAgggGGGaAGaAaaGAGgGGAAAAA	EGFGHHHHGHFHHHHGHGFHEGGHHCHHHGGGGGGGGFGGG?GG@EGGFGGGFDBBC	G	32	A	25
10	19613068	C	63	GgcgGGGcggCcggcCGgcGGccccgcGCgCGgccgcgGcggcccgccgcCggcgcccggggg	CCBACCCDDGEFEFFGHFEGHFFFFFFHFFGHFFFFFFHGGEG?FGG?GGEGCGGGCDFEGGC	G	34	C	29
10	19676561	G	139	gAAGGaggGGAgagaGGAgAGAgAAggGGgGggggAGagAGGAAgAAagGAAggAGGgAGGGGGAaAGAgAaAAGagagAGAAAaAAgGGAAGAAggggGAAagaggGgAAAAagGaaaaaGGaagAGaaAAgaGgggg	C>@BBCCGHHEFCECGHEDEHDFEEFFHGFH=FFDEHEGEHDEEGEEEGH7DGFBHHGEHHHHHEDEHEGBEDEHDEEGEGDDDEDDDFHDDGDDFEEAGDBEGEFGGEDDDDDEGEEEEEGFCE>CFCDCACAED?BD	G	73	A	66
10	19884264	G	95	aAGGGggAaAAAGaaAgGaaGgaaGAaaAGgAaGGAGGAgAggGAgAaGGAAAAAGggGaGaGAGgAGGgaggaAGAggaagAaagagAgGgGga	?AGGGFEFCFFFFEEFEGEEGFDEGCE=FG?FFGG@FFFGEGFGFGFFGGFFF@FFFGE;FFFEFEEFFGGGGGE@EFFFFG@F@GEEC@:>BB=	G	48	A	47
10	19904879	T	28	tTTtGTTtGTgtgtGgttttgttggggt	EEEEFEEEH;GEGEHFEF<FGEFGGGG?	T	17	G	11
10	20500743	T	37	gGTTggtGgggtGgggttgGgGtggtgggttgggggg	AC>=FFEHFFFEHFFFEEFHFHEFFEGDGEFGGGGGA	G	27	T	10
10	23482635	T	30	TCCCTCTTCTTCCTCTTctcCCCCCTCTTt	FGGF:FFEGFEGGBFEFE:EFF7FEEEFDA	C	16	T	14
10	26310410	T	137	TTCCCCTTTTTCCTTCCCcCCTTCCTTtCTTCCCCCCTcTCCccTcctTTcCTccCCTTcCtTCtttcTtTCCccTCCCtTCTTttCcTCtTTCcTTCCtcTTTTCCTcCttCCctcttCCCTccTCCCTctCCTct	=>AEGGEEEEDGGEEFHEBGEEEFGEEGGEEGGGGGGBCEGGCCECBHEECEECCEGEE?FHEFGGHCDH;FFCCDFFFHDDDDHHFA@FHDDFCDDDFHCDDDDFFCCDHHFECDBHHGFCD@?CA>@@<CCC?=E	C	74	T	63
10	26355992	A	90	AgagAggGAgAAAAGgAGGagAgAagAggGAGagAAAagggagGGgaGGGaAaaAaggAggGgagAaaaaaaggaagaaagagaAaaaaa	CCCA>ABCEGFEEFGFFGGFFFFFFFFFFGFGFFFFFF9FFDFCGFFFGGEEEEEFEGF?FGGEAFFEGGGGFGGFG;FGFGGGEFGGEC	A	50	G	40
10	26463043	A	132	tATtAtaTTAtTaTAaAATAtaAaATAAaaaaTtATaTAAtttATaTAAAaAAtAttAttaaaaATaTTttttaAaAATaAAATAATaaAAAtaTTTTttaatatATATtataattAAtataAAattaataa	C?8A?B>ACBFFDGFCFCGAE>FBFFFAEEEDGEFHEGFFDEEFFDFEFFFFFFFEFFFEFFFEFGEGEEF<CFFFDDGFEEEEEE>FEEEEFDFFFFEDEFFF<EFEFFFEEEFFEEEFFFEE@;=?>>@C	A	76	T	56
10	27350056	G	40	GGTGTTGTGtGgtGgtgtgGGGGgTgggtTgGtTggtTgg	=>CCGFCGCECFFCGF7FGCCCBCFGGGEFFBCFF:DE@?	G	25	T	15
10	27405096	A	48	GGGgAGGgGGagGggGGAAGAgGgGgAGAgGggGAGaaagGgAgaggA	@;BFHCCFCCFFCGGACHHCHEBD5GGBGGAGGBGBFGGGBGGGGEF?	G	34	A	14
10	27434483	G	62	aaGgGAgggaGaaAgAAaGGgAAaAGgGagGaaGaaagaagGGggAaaaaAgggaaagaAGG	AA>BBDFFFFGFFFFFFFGFFEFFEFGGGGGGGGGGGFGGCGFGGEGAFFEFGFGGGGEEFF	A	33	G	29
10	27437994	C	30	cCtctTCTccttctttccttctccccccct	AEFGEGGGFFEEEEEEFEDEFEAFBGG>G@	C	17	T	13
10	28032136	C	37	TTTCTCCCCTtTcTCTTtCCTCCTcCTcTTtCTTCTC	?FEFEEEGGFEFEE;FF>EFDFFEEFDEDEFEDEED@	T	20	C	17
10	28378758	T	53	ctccCctcctcccccttcttcccccctcctcccttttctcttttccctctctt	?B=FGFDFFEFFFFFEEEEEFFFFEFEFFEFFFEEEEGEFFFFFEGGFFE=FF	C	31	T	22
10	29754535	G	50	gAggaaAAgAGAaGaAGgaggGaAAaGaaGaGgagAaAagaAAaAgAaAa	BBDFBEHHEHCHECEHDFDGECEHFFAFFCFCE;FHFHFGF=GEGFGEDC	A	32	G	18
10	29821523	T	123	TCCCCTtTcCCTTCTCTTTCCTTttcCtctTcttTTCCttTCCtTTtCTCcCtccCcctTTttTTtccccTcCtcCttCttTCcTtcCctTTCttcttCCTTCCCCtTCCTTTCCCctcTCCT	FDDDCFEFEDDGGDGDGGGDDFCEEGDEFEGFFFGGDDFFG@DFGGFCGDGC@GFDGGFFFFFFFFGGGGFFCFGCFF@FFBCHFDGCEFFFCFEGFECCFFCCCCFCBBEE?CBD>;BDAA?	T	64	C	59
10	30317872	C	116	CtcctTTTTccTtTcTTccTCCctccTtcCTTCtcTcCTTttcccCTtttttttCctcCtcTTttTTtcCtccTcCctttTctctTCTCtTtTtCCCTttTTCCcCCTtTttcCtt	BC?@BA:???AFF?BFFB@F:GBGB;EG7GFFFG;FBGFBGDBBBGEDGGGGGGGCHCGHCFF@HEFHCGHCCFCFBHBCDCDCGEEDDHBHBHDE6EHHDEDECDFDE>?B;B=;	T	67	C	49
10	31001494	A	257	CCACCCAAcacCCACAcAAACACaACAaAaCAAAACCCACcAACACCAcAaACcaCCCACCCAAcaCAacCcCAcAccAAccAcAaAACCAAAAaAAcCAAaaAAcccCaaACCcacccAcaCacaaCCccacAaCAacccCAaacaACCCACAcCcAAacCAacAaaacaaAAaACccacaAAcccccccaCacacaACcccaAaacaacaaCAcCcCaccaCcaaAACaaAcaaaaCaaaaccccaaacacCcaa	A>C@@BA@D?DCDBEDFEDFGFGFFGFFFEGFFEFGGGFGFFEGDEGFFFEFG?EGGGFGGGFFFFGFGFGGFFFFGFFFGFFFFEEFGGFFFFDFFGGFCGGEEFGGGGFFGEGGGEGFGGG8GGFGGGGGGFGGF=GGGGEGGGGFEEGEFEEFGF>EGFEFGFGGFGGFEEGEBGAGGGFEG?GFGFG>FGGGGGEEGEFAEGGGGGGBGFEGFGFFGGGFFGGEE?GGEGFGFFFEGFGGFFEDBBB<<?CBB	A	134	C	123
10	32120678	C	44	TCTCCTTCtCTTCTCCTCtTTTTTcTTcCccTTCttcTCcCttt	EGF8EEDGE@EEGDFGEDFEEEEEEEEEGEEDDFFEEDFEFDE<	T	25	C	19
10	33491552	G	39	GGGGGGgGGGGGAAAAAGGAAGGAGGGAAAGAAGAAAGG	EEE?EDDECDDDEFA:EA@EEDDEDDDDEEDEEDDDC@A	G	23	A	16
10	33510768	G	165	AAggAAgggAAGAaGGAAaAGGGAaGGgAGGGggaGagGagaggggaagaaaGGaGagAAGaGggggAAAaaaAgGAagaGgGggAAaaAAaagGgAaAggaagaAagAgaaAagGgagaAaGgggaaaAaaaagagaAAGaAAgagGaaaAgagagAgaaAaag	>CC?>:;@CBCGDEFGEEECHHHCFHHCEGHHACFHFCFFCFCCB@FFCFFFEGFHFCEEHFHC?C@ECEGGFECHEGDGCDDDDEEFGECEG?HDEGED>GGDG6G>DDGE6EDGDADDDGGDDDGGGD9G?GDGDGDDGGDDDDCGGGGDDGCGDDBCD7BBA	A	92	G	73
10	34661555	G	42	cgcCcCgGCcgccGGGgcCgccgcccgCCcCccggcgccccg	CACAFGFH:FFFFHH<FFFFEFFFGFFGGFGGGGF@EFGGGG	C	27	G	15
10	35320383	C	67	tctccCtccttCTCTcTTTCTTCCCTTCCTTCTTCCCTCCTTTCTCtCCTCCTCcTcCCCTcTTtcc	BGDGGDDGFDDDGDGHBGEDGGDDDGGDDGGCGEDCCFCCFFE6FCECCFCCFCHFHCCCEGDE@C@	C	36	T	31
10	43622217	T	151	CtTCcCccCTCTTtTtcctCTcCTTCttTcTCtcttcctccTCtCcTTtCCcTCCTTcCTccTCCCcTtTCCCcTCCCtcccCcctTttctTCtccctcCctCctcCtCcctTTccCCTTtttttCctCtcCcttctCctccttctcttct	AA=AB?DCECCEEEEDEFEGEF?ECGEEEFEGEFEEFFDFFEEEEFEEEGGFEGEDAFGEFFEGGGFEEEGGGFDG>GFAGGGGFFBFFGEEGFFGCFGGGFEGFGGEFGGFDD:GFFDDFEFCFFG?FEHFGFFGFFGFGFFEGFFDEBC	C	83	T	68
10	45496120	A	141	TTaatTTAATTTTATATattATATTaatttaaTAAtATTaAtatatTaatTTtAaAtAAtAAAtTaTAaTAAttataTTATtTTaatTAAAAAAttTAaATATATtaAttTatTtaaTTaaTatTaAAaAtAttttttaaA	D?ABCCCBEFGGEFGFGFEEEGFG<FFEEEFEGGFEFGGFFEFEEEGFEEFFFFFFEFFFB@EEFGGFGFFFFFEFFGEFGFGDGGFGEEEEEEAFFEFEEEFDFFG:FFFGFEFFGFFGAEGFFGEEEDFEFFEEDDEEB	T	73	A	68
10	45869895	A	156	aggGaaaAaggAGagaGagGaAagggagaGaAgagaagAAGGagagggaGGaaGGAGaagggAgagagaAaagagaggaagGGagGaGggaaaaaGAagagaGGgGaGagAaaagggAgaggagaAaaaaaggggggggaggggggaaggagggga	AC@;CB:CCBBBAEDFBEDCDHED@FEEECEHEEEEEBFFABEEEDFDECCEECDHCEEFEFIDEDECEHEEEEFEF9EEFCCEDCBCEFDEEEE@BFGEEEBCF:FBFFHFEFAFGHGEGFEFFGFFEFFGGC>F>FFBFGDBFFCEFFFFB@<@	G	83	A	73
10	59972453	G	26	tggtGgGtggTttGgTttggGggTtG	BCDFCDCDEEGDECFFFFFGBEFEAC	G	15	T	11
10	60147934	T	35	TCCTCTCCCttTCTTTCTCCCCTTCCCTCTcCcCC	>GFEGED9GFCDFEDDFDFFAFDDFFBD<BBAA>>	C	21	T	14
10	60273155	C	103	ccacacCccaaaaCaaaaacaCaaaAAccAacCccACCccccccccAcccacaaacccccaAcccacacCaaaaaaCacAcaccaccccccCccccccccccc	A?CCAB?BCCDDDC=FDDECDBDE>FG@DGDDEDDHDDDDDDDDDDFDDDEDEEEDDDDCDHDDDED?DDFEEEEEDFEHED9EFEEEEAEDEECEEEDEEEE	C	64	A	39
10	61414011	G	272	TGTGTgtGggTGtGGGgTGTtTTGGgTGTGGGGgGtTTGGGTTtTGtGgTTGGGTGGTgTTGGttTTGgGgTTTTTTgTGgTTgttTTtGGTTtGGTGGggTTGtTtTGtgTGTttGTTgGGTtgGtGGgtttTTGtTTGTTgTtGtTGGGTGTttttttggtgggtggtGGtTTGGGTgtTGtgtttGGttggTTGGGtgTGGttTGGGTGgggTggGGtgTTtGttGgggGggTggGggtgtTgtgGgGggGgtGGttTGtgtTtGgtgg	=B?ABCDHFEEGEGHGFEHDECEHHFEH7HCGHFHEBEHHGCEEEHEHFFEGIIEHHEBEEHHFEEEHFHFEEEEEEFEHFEEFEEEEFHHEDEHHEHGEFEEDFEFEAFGEHEFBGEBGCGEFCHE:GGFFFEEHFECH;EGAEHEEHHHEHDFBFFFFGGFGGGFGGFGGFDCGGGDGEDFFGFFFGGFF8GDA?F9G6DGGFFE?<FDGGGGCGGGFFGDDFGFEGGGDGGGDGGDGGFGFDGEGGFFFF<FDEFBBBAAB>@?ADCAA	G	141	T	131
10	62551889	A	50	GaGaGGAGaGaAAAGGGAAAGGAGgGgAGaGGaAAGGaAaAGAAAAAgAA	EC9DHGEHDHCEDEHHHECEHHEHGFGDGEGFFDDGGEDECGCCCD:FDA	A	28	G	22
10	62551890	A	49	aTaTTATaTaAAATTAAATTATtTtATaTTaAATTaAaATAAAAAtAAA	B@FFFGFFFEFFEEFFEFFFFFFEFEEGEEGEEDBGEGEEDDDEEFDC?	A	29	T	20
10	68040325	C	50	cctcCTTCcctTcccTcctcttCTcttcTtcctccCCttttcctctctCt	?CBCCBAEFEDEEFF<FFEGEEEFGFEFFFGGEGGFFEFBFGGFGFGFDC	C	27	T	23
10	69299446	T	61	tttTAttttaaTaAtaaTatTatataTtAttaaaaTtttattttttAaaaaattaAtataa	C?CAABEDDDDGCFDDDGDDGDD;DDEDFADDDDDFDDDEEDDE?EF>DEEEEEEFEDEEB	T	33	A	28
10	69773841	G	109	AAaAGGGGGgAgGGgGGGGGagAAAgAAaaAAAAAAAAGAGAGAGGGGGgAAAaGggaaGgggGAAGagGaGGGAaAaaaaggGagAAGaGagAAggaGGgAGagAaaa	B;CEEEDEEFEEEEEEAE@EEEFFEEFFEEEEFFEFFFDF?FDEEA<EDFFFABEGFFFDFFGDEDCFFEFDDDEFFFFFBGECDFEEDDDCGDEGEDBCDBB@@C>CC	A	55	G	54
10	69955140	T	61	TTTATTTTTATAAATTAATAATTTAATtAtTAAaTTTATtTTTTAAAAATTATaTAATaAt	?CGFFGGEGFGFFED<FFGEFGFFEEEFEFFEEEFFFEFFFFFFEDDEDEGEEFCBCB@@@	T	34	A	27
10	70968199	G	35	GTGTGTTGTTTTTGGTGGTTTTTTTTGGGTGGTGT	FFHEHDEHEEECEHCEHG>DCDDCDDDFCBEDAD?	T	21	G	14
10	71244832	C	62	AAACAACCCAAACCAACAcAaAAAaCCCAaCAacAACCccCCcCCcAACAaCACaCCACAcc	AAH@HHADDHHF>DHGDHG=GHHHG@BDHGCHGEGGCCFGBDGCCGGGCGGCGCGCBD@C@?	A	31	C	31
10	71264325	G	53	aAGgagAgGgaaAaAGaaggaggagagggaaggagaaaaggagaaagagaaga	CA>ACACCCBFFFFFAFFCCFCCFCFCCCGFBDGDGGGGDCGDGG7DG>HGDG	A	29	G	24
10	71332301	C	56	ttCCtttCTCTTttTTttCCttTcCtCTCTTTTCTCTCCcCTCCCTcTTCCtCTTC	?HDDCFCDGDGGAGGGGGADHHFCDCDGDGGGF8F@FCC=CF@CCFCFFCBB<ACC	T	32	C	24
10	71392557	C	76	cCtcTTTCCTcTTcCctCctcCCtCCtcTCCcCCCcCcCtCccCTtCCCtTtTccCCCcccTttcCCcCTTccCct	DGBGGGGGGFGGGGGGD8GEHGGEGG>HDGDHGGGHGHGEGGHGEEFGF7GEFGIFFFHHHFEAHFFHEGDCB9C9	C	51	T	25
10	72292258	G	26	gGCCCCCCGCCCCGCCGCGCCGCCGC	BDGGGGCAEFCEFDEEDEDFFDFBA@	C	18	G	8
10	72306978	C	34	CCACACCCCCACCCAaCCcAcACCAaCAAaACcc	=DHDFD=CDDHDDCGGCCHG8GCCFFCHCBA?BD	C	21	A	13
10	72432521	A	43	CAAaACCACCAcACCCCAcaCAAAcAcAAAaaaAacccacCcc	FEE=FGEFGFEGF6FFEDGGFEDEGBGEEEGG<EEFFEBBB<=	A	22	C	21
10	72434194	G	44	GAgAAAAGAAAAGAAGAAGGGGAaGGGaGGaGAaGAaAaGagAA	DECEFFEED9EFEFEDDDDDDDEGDDDDDDFDDGCEDDCAB>?C	A	26	G	18
10	72468584	C	55	cCcCGcgcCCcggccCcgccccccgcggcccgggcgccgcggcCcgggcgggccg	>:CCADECDCCDFDDADFDDDDDDFD=FDDDEEFCED9EE>FDCEGE;EFFF8FF	C	33	G	22
10	72505208	A	30	AggAAggGgagAAgAgagAGgaGgagagaa	<BBDEFFHFFFEFFEFEFEHGEHGGGFGGG	G	16	A	14
10	72518075	C	56	cCCCCtCtttCctCcCCccCCCCCTtTtcTCctttcccCcCCCctcccccCcCtcc	C>DDDDDDDDDGDCGDDGGDDDDDE>GEHFDCDEAHGHCHCDCHDHHHH@?HCDC@	C	41	T	15
10	73270906	T	215	tTtcTTCTCctcTTTccCTTCTTTtttTtCtCcCCcccCTTTctCTtTtTCCcTttCcCTCctTTtTcCtCTccCCcttTCTcCCTCTcCCTCcTtCTTcCCttTTttTctTttTCCTCTTcTTTTctcCtCTctcTCcTTCttcTCCCCCtctTCttCTcCctTCtCttcctTCCttCTtctcttctTtTccCCccTCCTttctcTccCTTccc	?;E?D:E?GAGADEEABGEEGCEDGGGEGGGGBGFBBBGE5ABGGEGDGFGGBEGGGBCEEB<EBGE?EH=EAC99CHHEG<BGFBE;CGEEGCDGGEECGEHHECFHECEEGHEGGEGEECEEEEAHCGG=EBHCDGCEEFHHCEG=FFFHCHDFHBFDCF=IDFHFHHCCHDFFHHDDHCHCGH8HDHDCAFGBB@DD5CC>C=@>;CCC9=>	T	113	C	102
10	73270982	G	156	GAgAggaagGAAggGgaagaggaggGgGaaAAaaGAAGggagaGaaAGGaaaAAAgggaaGgaggGaggggggaGAGaaaGAggGGGaGGaaGaagagGGggaggagGAaAaaagGaaaaagaGggaAGagggagggggaagggagaggagggggg	A@@?ABDEBFDCCDHBEEBFCCFCCHCEDFEDFFHEEHCCFCFHFFCGHFFFDCFCCCFFHCFCCHFCCCC?CFGEGFFFGDDAHCGEHGGDGGGDFDGGDD<DDGDHDGEFFFDHDFGGGDGDDDGDGGDDDGDCDDBGEDDDGDEDDGDC??<8	G	88	A	68
10	73439066	A	84	TATTTAATTATTATTAAATAATATTTTTTTATATTTATTTTTTATATAATTTATATTAATATTAATATAAAaATATTATTATAA	==C=FCGGGHGGHGFBFGGEHBCGGG<G>GGF:=FEGFF@FAFEFGF?FFFFBFEFF<@FEFFGDFAFEGGEGG=FEECDB9DC	T	48	A	36
10	73472868	C	155	GgGGcCGCGCGGcCgGgGcCcCGCcCCgCCcCCGCGCGggcCCGccCCCCCCcGcgCGCGGCCggCcgGCccCgccccGggggGCGCCcCgGCCgGCcCCCGcgCCCgCGCgcGgcGGcCCcCcGCGgGcGccCCggccGccccccGGCGGgCgg	BA9@?@EGEFEE@GCDCEBFBFEGBFGCGGBADCEEEECCBGFEACAFCADFC<CDDECEEGFDDBCDEF@CFD>CCCEDDDDDFBDDCFDDCED@ECDFEDCDFFEEFDFD<DDCDDCDFCDBDFDBDCD;BFEDDCCDBAB:<=BA>@A??AA	C	90	G	65
10	73512824	C	102	cGCGCgcCCCgCgGGGgGGgCCGgccccgCCcggGCgccGcgggccCgccGCGggGCcGcgcgccgccCcggggccgccgggccgGgcggccccccggcgcg	A>?<=CB@@CFBBBCAFCCEDDCFDDDDDDDDEECDEDDCDF??DDDGEECDCFDCDECEFEFEEFDECEGAGGECFEDG?GEEGBGDGGEEEAEEFFEF?>	C	52	G	50
10	73569749	C	239	CctttCcctctCCTTCCTtctCTTtcCTtttttttTtcttttTtTTtctTTcTTtcccTCcccttcttttcTTCCcttCCtctttctcCcCccCCCtTTctttCCcCccttcCCtCcCCTCTccTCTcttCtctTCcTCtctcctctttttcCccctcTTctCtCCTtccccccccttccCtcCttCtccctttcttcCccTTTtcCTCtttcttCTCTtctctcctccTCCttccTtc	=:CCCA??FAHCDFFD@FGAFDGGFADGEGGGGGGFGBFGGGGGGGGBGGGAEGGBBBGD@BBGGBEGGGB7GEDBGBDEGBGGGBGBDBDBBDDDG<CBFHFDDBCCBGGBDDH8CDDGDGCCGDG?HHCHCHGDCGDGCGCCHCBHHHGCCBBBHBDGCHBGDCFHCCCCCC;CHHCCCHC@IHCH<CCHEHCHGCCCBFFFHCCF<HHAAHHAFCFHCHCGC=CCCEBC>C?=:A<	T	120	C	119
10	73570215	C	148	CCCACACACaAACAacAaCCCaACACACCACCAAcCCCAacCcCAAAAaCAACCACCccccACAAcCCacCAACCAaAAaCAaccAAccaAAaaCcaaACCAcCCcACAcaaaAAcccccAAAacacCCCcccCcCACAcaaaCCaca	?>>?B<BF@EHFDHEDHEDDDDHEHD=D>HDCHHDADD;CCDDDHGHHFCHEDDFDDEEEEHDHHEDDFEDHEDDGFFGDCHDEDGGEECGGFECEFBGCCGECCEGCGEEEEGGCECEDGGG@DFECCBEEEC7BGBEA>?>A@A=C	C	78	A	70
10	79579251	G	36	agggggaagGgAAgAaAaAAgaGagAaaagaaggaa	CAABBFAEFCFHHFHEHDHHEDCBEGFFFFFFHFF?	A	21	G	15
10	81065201	G	53	AgAAGGgGaGgaAAGAGAGAAaGAGAGaAagAGGAGAAAGGGaGAAGagGAGa	5DBEGHBHFHCFECHEHEH;CGGDGDGFDGDDGG5CDDDGFFGCBCFB@B?AD	A	28	G	25
10	81192577	A	45	aGgggGGaAaaagGgaggaaAgGggaggggaAggaaaAggagaaa	??DEFCCEHEEEECEEEEDEHF>EFDFEGGFHGFFFFH>FFGFDE	G	24	A	21
10	82098146	C	47	CCcTTCcTCCCTTCCtCTtCTCTTTCTtCTCTTtCCcTCcTTCCCcT	=DDFGDDGDDDFFDDFDGFDGDGGGDGECFDFFFCCEFCEFFCBC=B	C	25	T	22
10	84625107	C	186	TTCtCCCCTTCCCcTCTccTtCCCCCTTCCtcTCCCCCCtTCcTTTCTCCTcCtTTTTTTcTtCTCTttCcCTtcCTcCCtCCTCTttTccCTtTCtCCTTCCCTttCCTCtcCCtCCTCCTCCCcCCCTCcCccCCcTCtctCCTctTCtctTtcTCctCCCCCCccCCCCTtcCCtCccTCCcc	C<@AB=CAB@FFGEEGFFFBEGCGEE5?DFEFFGGGFFFEFGFFFEGE@GDFFFEDDBFFGFDFFGEFFFGDCFGGBGGFFAFFGBFFFDGFFEEFEGEEFGFF;FFEFDAFGDFFFEEEEBFDEGFEEDFGFGFEFGEEFGFEEDGFEEFGFDEGDEGFEEEEDDGGECEEDEGDFEFD>=AABD	C	113	T	73
10	85944313	A	34	ATATATTAAATTTATtTTaAAaAAATaTATTAAA	FDFGFFGEEEFFEEEEFFGEEFEEEEGFDED5C@	A	19	T	15
10	85944322	T	40	TATATAATTTAAATaAAtTTtTTTAtATAATTATAATCAA	?DEEEEEEECDEDDE>DE6DEDDDDEDDDDDCCCDAC9<?	T	20	A	19
10	85957456	G	45	GAGGAAAGGGAGGgGaaGGgAggGGGGggagGAGAGAgGaAGAGG	@GCCFHHDACH?CGBGGCBGBEEBBBB7GGDBGBFBGECDC?CC?	G	30	A	15
10	85981801	T	127	gtgttGtttgTttTtggtgTgTttTTTTgtTTgggtggTTgtGgttgTTtTtgtgtgtggTtgtGTggttTttTtgtGtGggGttttttgttttttgttTTTggtGtGgtGGgttgtTtTtgTGtGg	AB?BB@CD>ACEHDGBCGCFCFG?FFFFAGFFCCCGCCFFCGECGGCDFA;GCD@HCGCCFHCGEECCFH=GFFHDHEHE=DEHHHHHGDHHHHHHDHHEEBDDH9EDEHDDDHDCHEHEHDDC=A>	T	79	G	48
10	85984423	C	170	CTTtCtTtttCccTtTCTCCTTTCCtcTcTTtCCtcCTCTtTTCTCttTTTTTcTCTTTCtCTTtTCTCCCTCCCttTTtCCttTTtTtTcCCTtcccccCccCttccccTTccTtTcCttctCTtccCCTTCCCtTTtCCCTTtttctCCTTcttCTCTtctCTccCtC	ACCC=5FDEDCDCFEGDGDDGFGDDDDGDHBEE>EBDFDGEGGDDDEEGGGG@EGCGGDCFDFEFGDGDCDGDADFFGG<DCFEGFFGFFEDD@BEEEEECEECEEDEEEF=EEFEFECEFEFCF@D<CCFFC<CFFFDCCCFF9FEBFBBEFCFFCFCFECD?<@>A;?	T	94	C	76
10	86131671	A	221	AAGAAgGAaagGAaagGGGAAaaaaGAGAGgaaAGGgaGGGgGaaAagAAAAGaaaaAggaGaaAaagAAGGgaAAaGaGAaAAggGaaaAGggGAAGgGGAGAAAAgaaAAgagAAAggAGggaGaaaAAaggAAGaggAgaGagaaAAGgaaaggggGAAGGagaggGagAggaaAAaaaGgAgAaGGGgAaGaaGGaaagGAgGgGGgAAaAAAgAGg	B@@8:AC9BBC=?EFFBGHE@EFFFHEHEHFEF@CHFFHDFFG:F5FF=EE;HFFFF=F=EBFEDFGFEEFHFGDDGGFHEEEEGGGGGGB:GFGDCHG@HEHCDEEGGFEEGBGEEE:GEEGGGHGGGEEGGGDCFFGGEGFHGGGGDCGGGGGGGGGGDEGGGGGGG?GGAHGHHDDGGGGGDGD6GGGGDGFGGGGFGGFGCGFGFFFCDD@@A<ACD	A	123	G	98
10	90069116	A	39	CAACCACCAAACCAAAACCACAcCCccCACCaACaCaCC	DHEDDHDDHGGDDHHGGCCGCFHCCHGCGCBCFCECC@C	C	22	A	17
10	90530660	C	27	ACACAAcACCaaAACCcaCcAAACccC	?>FG=F:FGGFFEEFCEEFEEEEFE??	C	14	A	13
10	90534135	G	36	GAGAAGGAAAGGaGAGGAAGAaAAGGGGGGAAGAaG	FFGFFCDFE:FGEFEFFEEFEGDEEEFEDDCBBAB?	A	18	G	18
10	90568182	A	60	gaaaAaaaagaaggaGGGaagaaggAAgagagggagggaggagagaaggaagggaaagga	AACCBCEDEEEEFFECCAEEDEEEEHHFFFFFEGF8GGFFEFFEFFFGFFEFG?FFFGEA	A	31	G	29
10	93000211	G	55	GAAGAgGAGGAAGAGGAagGGGaAGGAGGGaggAAaGGgAGagAAaGgAAggaGG	=HHAHFC=CCHHCHCCHGGCCCGGBCGBCBGGHGGEBBGGBFGGGGBGFGDBAA?	G	31	A	24
10	93572984	C	38	ccccttctttttttttctcctcccttttttctctctct	?<<>DAADGGHFFGFGBGBBGB8BGGGGGGCHCF?HCH	T	23	C	15
10	94816817	T	51	tttttcttctCccctccccttttccttcTCcTtttttccttttttttttct	CCBBDCHGBGGABBGBBBBGGGGBBGGBEGBEGGGEGCCHHHHHHHHHHBC	T	33	C	18
10	94820860	A	111	GgGAAGAaAAgAGAAGGAGaaggaaAAGgAAagGaAGAAGAAaAAAgAAGGAaGaGGaAAAAagaAAGGAGaAAGGaGGAGAAGgaGAagAgaaGagagggagggagAaAG	CCHBEHBFCECDIDFHHEHFFCCFFEEHDEEGCGGECEEHE:GEBDDEDGHEGHFHHGEEEDGDGEEGGEGGDCGGGGCDGDDFDFGDGDCDHGFGDFBDCECC@C@A?CC	A	64	G	47
10	95070037	A	53	agAAAgaaggggGaaaaggaagaaaGgaGggagaaggagaggggggagagggG	>A@FDFDDEEFFFDDDDFFDDFDDDGFDGFFDFEEGGEGEDEGEGGEGEEDGE	G	30	A	23
10	95241721	C	30	TCTTCCCTCCCCTCCCCCTCTCCctcCCCC	?GAEG<GEGAGEEFFFFFDFDFFGFG6EC>	C	22	T	8
10	95443688	C	47	GCCGGGGGCGGGCcGGcGGgGCggcGcCGgCgCGGCcGCggCGCCCg	EDFGGEEGFGHFAGFFGGGGGFGEHEHFGGFGFFFFGEEGGFDCC@B	G	28	C	19
10	96039597	G	85	GccGGGcGgCCCCgGCGcccggCccgcggCCggggcCgccGggGCGCggCgggGccggGGGggCcgcggGCGcccgGGcgggCcc	5DC==>E?DBBB>FCDAGGGFFDGCFFFFCDFFFFGDFGGCDFCD<BGGDGGGCHHGGCBCG:DHGHEBBCBHHHE6BHGG=AGG	G	48	C	37
10	96201615	A	35	AGAAAAGAAGGGAAGAGAGAAAAAAGGAAGAAAAA	BGECEEHEEGGGD?GDGDGDCDCDDDG?DGCCCBA	A	24	G	11
10	96305729	T	56	CctcttctTctTTctTTctccttTCcctTcCttttCcCcccctTTTtcTTcctctt	@@D?EE@FEBFEDAFEEBGBBGEEG@BGEBEDCHGGCF;CCC<CECHCDA;CHA:C	T	31	C	25
10	96341336	A	26	cacaaaacaaacCacccaaAaacacc	DDEF@EFFFFFFEGGGGCCFGGGGGG	A	15	C	11
10	96745984	A	57	taaattAtAtaatTttaTtaaattataataaaaaaaaaataaTtatttaaattttta	A?C=BBDEEEDFE=EEEFEFFEEEFEFFEFFGFFFEFFFFEGFFGFFF@GGFFGF<F	A	31	T	26
10	97181855	T	48	TTTctTTTTCCTTttCtTcCcCTtcTcCttTCCCCtttCCCTTcTTTt	DDG<EFGGEDDGGEEEEAD@ECFEAFECCEFCCCCFFACCCFFAECC>	T	29	C	19
10	97373966	A	26	acaacaCCacacacacccaaaacacc	AGDDGDGGCGDGDGEGGHEDEE=EHG	A	13	C	13
10	97385014	T	35	TCCTTTCTTTCTCCCTCCCCCTCTCCCTCCcCTCT	DFG<FDGGGGFGGFFFFFFFFFFFFFFFFFGFEAA	C	21	T	14
10	97385242	A	54	GGGaGggggagagggGagGggaaagaggaaAaggAaaggggaGagaggaaggga	@;>E;BCCCEBFCCCBFCCCCFFFCFCC7FHFDDBGGDDDCGCGDGDDGG@@AB	G	33	A	21
10	98762051	T	82	GGGGgGtGGTTGGGTTGttGTGtttgtggttTggGGggTGGgtgTgtgTTgTgTTGGTgggGTGgttGGGGTgggtTTtgTg	@8EECEEEEFFEDEFFDHDEFEHFHDHDDHHEDDEEDDFEEDH@CDGD@FDDDDEADEDDDDEDDHGDDDDB?CDEEF?>>>	G	48	T	34
10	98819317	A	93	AGgAAGaaaaGAGAgaAAAAaaAaGaGAgAgAaGaAAGgAggaAAAgaGGGgaGaGAaaaggaGaGggAAgAGagagaAgaAAgagagagGGa	C6AHHCFEFFCHC>@DHHGC>EHECE9HFHFEFBFHHCDEGGGHHH@ACCCGGCGBGGGG8GGBGBGDFGGGBFEGGAGGFGFEFGDD??AC<	A	54	G	39
10	98995076	A	55	gggaAgaaagGAaaGaAGaAgAaaagaggaaGggaaGAggagaggggagaAaaag	<DCDDFDDDFGFDCGDFGDFFFDDDFDGFDDGFFEEGFGGDFDGGGGEGEEEEDG	A	30	G	25
10	100157368	C	25	tttctctcttcccccttccctcccc	ACD?EAGBGGBBABAGGCCCHCCCB	C	15	T	10
10	100183570	G	83	cCGCGGCGCGGgCcGCGGGCCGgGCcGgCggGCGcccCCggcGCCCggCCCCCCCgcGGGCCCCCGcgcgGCcGcGCcccGGc	C<ABEEFEFEECGBEFEEDFGECEGBEDGDDEFDCCCFGDDCEFDFDDGFFBEFEDCEDDEDEFFDCDBCDECDCDDBB5DA:	C	46	G	37
10	100189242	G	87	GaGGGGAaGAggAAGgAGagAGaaaAAAGAGAgaggAGAGGAGaAaAAgGAaAaAaGAAgagagaGggGGAGaaGaGaGGGgaAgaa	=FEDEAFFEFCCFFECFEFCEEFFFFFFEFEFDGDDFEFCEEDGFGFFDEFGE=EGDDEDGDG>GDDDDDEDGGDGDFC@A=BCADD	A	46	G	41
10	102027407	C	38	tTTCCTTCCCccCtcTTTcTTtttCctTctttcCctct	CDEFFFFDGFCFAECFEFG:F:FEEGFFGEGFCFFD@C	T	21	C	17
10	102241998	G	103	gggGGGCGgcCCCCGcgGCcCGCGCCGGGCCGGGGccggGgcCCGgcCgGggGcgGcCCGGCcgccgGGcGCcCgCGGgCGCCCGgggggGGGCggCccGGCg	@BCBCCD@CB?EDDCBCCDBDCDCCDCCCDDCCCCCBDDCDCDDCCBD?CDDCBDBCCDBBCBDCCDABABCCCDCBBDCBCCCBDDDDDBBBBECBC>=>5A	G	59	C	44
10	102295658	T	26	TgTTTGTtTTTgTttgtGtggTGGGT	=BEDCHEGEEECE=G<9HGC<DGFFC	T	16	G	10
10	102296461	C	34	CTtcctttcttcttctcttccttcttctctctct	@>>CD?DDGDDGDDGDGDDGGEDG?EHE<EGEG@	T	20	C	14
10	103344589	T	119	GGgTgtggGGggggGggggGTTTtTTGtTTTggGttGggTGGtgtGggtGTTtgGttgggggggGtgtTttgttGTTgTttgGGGtGTGttGTgggtggggtgGGtTtgtGgGtGgggt	BBC?=B@AAACDCCECBBBECDEG=EEGEE>CCEGGECCBEEGCGECCGEFFGCEFGCC@CBDDEHDBFGH=HGEFFCEHHDADDHDDDIHDDCDDHDDCDHDDDFD@DGEBCBB<>?@	G	71	T	48
10	104184213	G	181	ggAaaGGAGGGAGgagaAgGaAaGAAaAgGAAagAgGGAgGAAgAGAgaGGgAGGAGggGAGgaaGAAAagAggAGAGGagaagGaaGgAAgAAgGAGgAAAGaGaGaagaaaGAGgaGgAGAaAAAAgGAGAagaGaGAAGgGaGGaaAagGGGaGAAgagAAGGaGgagAaGggaAAgg	AAADB8FFBG;FGFEFEFEGEDEGEEBEEGEFEEFFGGFFGFFFFG:FCFGFEGGEGGFFEFFEFGFDFFFFGFEFEFFBFFFFGFEEGFDFFFGBFGFFFEDFGFFFFGE5DFEFGFFGEEEF<EEEGFEFEEGEFFFEEFEFFFFCFE?GFFFFFCDGFFEEFBFFDFFFDC@?>ACCC	A	91	G	90
10	104591393	G	113	TGtGGTgTgtGggGtTtgttGTttgtGggGGTtgTtGGtTttGgGgggtgGgttttGtgtgggGGGtggTTGGGtGggttTGgggggggtgggggttgttttgggggGgtggt	D?BBADFFEEFFFGDFEFEEFGEEFEFFFGEFEFGEGGEGEEEFGFFFFGFFDEEFGEFFFGGGGGFFGGGFGGFGGGFFGFG<G;GEGFGGGGGFFGFF<FGGGGGFGEGGF	G	68	T	45
10	104629465	T	64	ggTtgTGTGtGGGGtGGTGGTgTgTGTGGGTgGGGGTGTTgtTggTtGGTgGTGTTGGTgGGGG	EEEEFGCGCD;C=<EBC5AC<DFAACF>BBFEBCBBFBFFD@FFGF;BBEFBFBFE@>E@CAC?	G	40	T	24
10	104636655	G	88	GGGCGCGCCGCGGCGGGGGCCGCCCCCCGCGCCcGCCCCGGGCGCGGGgGCCGCCCcGGGGCGgcCCGgCgCGGCCCCcGGgcCGgCC	CDGEFGGEGHFEHG;GHHHGGH=CEGGFGFGFFGFFFFCGGGFGFGGGGFFDDFFFEGEGGFGGGFFFGEGEGFFFFFEEDBAAD@BA	C	45	G	43
10	105178380	G	162	GAGAgGAGaagAgAgagggggggaGGgggGaaaaAGGAgggaaaagAGGAaGGAAGGaGaAaaaggAAGgAaggggggaGgagAggaAAaaaagggggggaggagggggagagagagaaaaggaggggggaaaaaaaaggagaagagagagagagagaagag	AC>AB>?=BBB=DEEEGAFFFEEDCAFFECCDDDHCCHFF;ACDDFHCCHDCCHHCCCCDHDDDFFHHCFH>FFFFEFDCFDFHFFDHDDDDDFCFGGGEDGGEAEG;GEGEGEGDGEEEDGGEGGEGGGEEEEDEEEG<EGF:FFGEDEGEGEGCC:D@A@	G	87	A	75
10	108447836	C	42	CtTCTCCCtCCTTCTCCcCCTCtCCcctCTTTCtCTCTTCTC	?EGGGGGGFGFGGGGGGGFFFFGFFGEDFDFFFDBBACB@AC	C	24	T	18
10	111701279	C	83	TCCCTCTCTCCCTCCCTTCCCtCCTCTccTCtCCtCCCCCTcTTcCTCCTttTCcCCccCTTCCTCCcTttCtccCcCcCCTc	@EEGDGEDEFGH=GGGBEGGGEAGDGBDE;GEGE<GFF:GEBDDEDDFFDEFDFEFFECFDDFFDFFEDEFFFEEECDAB??B	C	54	T	29
10	112337693	T	29	tATTATTtAtttAAAaAAtaattaaatta	<;:@??CECDDDEDEDEEEEEDEFEEEED	A	15	T	14
10	114905722	A	120	AaACAaaaaAaAaaaAaaCCaAaaCAACCAaCaAAaaCaaaaaCaAaaaaaaaaaAaaaaAaaAaaaaaCaaCCaaaaaaaaaaaaaaaaaaCaaaaaaaaaAaaaaaaaaaaaAaAAaA	?BBC>DECDHDE<5EHDE>DEE;EB9;DBD;:E57EE9FE>AF=@@=8FEF5CF;;@D;F:D=?EFFDFCA6:CAFFCFDEEEEFCFFFFFF>DBBCEDEEE:=CF=@>FFBDA@<BB>C	A	107	C	13
10	115312811	T	41	TTCCTTTCTTCCCCCTCTCCcTTCCTTTCCCTTCcCtttTc	EDGGEEEGEEGGGGEEGEGFEDCFFCDDFFFDDFDFBACB<	C	21	T	20
10	115392919	T	103	AATAaTAaTtTaTAAtAAATtaTaatTaTAtaTTTTAAtATAatAaaaaTatataTATtTttaattatAtatTTTtTtTTTaaataATtTATtatTATtTaTT	@?CDEGEEGEGFFFFEFFFGEEGFFEGFGFEE=GGGFFFDGFGFFGGGFGGEGFFFFFFGFFGFFFGFECGFFFFFFGEFFEECEGEFFEEFFFDEEFBBAAA	T	57	A	46
10	115401081	T	51	TcTCtTTTCctCCTcCcTTtTCCTCTTCCcTTCCCtTcCttcTCtTTCTTT	@AGDGGGGDCHD>FCDCFGHFDCFCFFCCCCFCC;HFC=GGBFCHFFCFEF	T	28	C	23
10	115423094	G	237	GGCGGcCGCGGGCCGcCCCGGCGggCGGGGGGCCGCCGggggGcGcGGGgGGcgCGGGCGGCCcGGggcGCgcGGGCGGgGCGCCGGCgcGCGCcgCGccGGgccGcCCgcGgGCcGGCcgcCGgGCGgcccgcCgCgcGcgGGgcGCGggGGggcggCgggCCgcGCCgcCCGgccGCCcgcggGGCcCCggGcgGGcgcCCcggGGcgGCGGcGCGggGggCgccGCgCgccGcG	B@>=?@CA?CC@@EDAFFFEEGECCGEEEEEEGGEGFECACCE=EBBEFCEEBCFFDFFEEGGBEECC<EF?B>EEFEECEGAEFEEGD6<GEGCDFE;BEDDCCECGFDCED>FCAEFBC<GEDEFEDCCCDCDDFDCDACDDDCDEDDDDDDD?DDDDDDEDEDDEEDCFE=DCCDFEADCDBDDECDEDDDCDDDCDCFFCDEDDCCCEDCCCECDDDCCGCBBDD>A=<9B;?	G	137	C	100
10	115804036	A	57	AaGGAGAAAGGGGAAaAGgGAgAGgaGGAAAGGGGgAGGAGGAgAGGAGGAGGGgaG	CBHGEGFEEFG=GFDGEGCCEDEFDGFFEEEFFFFDEFFEFFEDEFEEFEC>CC>@@	G	34	A	23
10	121199365	T	47	cTCttcTtCTtTcCttCcctTccctcCtttctcttctccttctcccc	C?>DDAFGBGGGBEGGCBBGGBBBGBDGGG@GCEGCHC>H=CBC?CC	C	24	T	23
10	121435955	A	67	AACCCACAACACCCCcCAaCAAACAcAaCCCCAcCCcACACaAaaACCaAcaCcacAcacAcACCaC	@=>GECGEEGEGGGEFGEFGEEEGEGCGFFFDDGFFGDDDFGDGFBFFGDGGFEGFDEFFAC<CC??	C	36	A	31
10	123719928	C	35	TTtCTTcTtCCCTttctCTtcttCtcCccCCcTCc	BEGG5GGGGGGFGHHHHGGGF5HFHHFIHFFGFFD	C	18	T	17
10	123719929	G	34	GgAGGaGgAAAGggagAGgaggAgaAaaAAaGAa	FFHGHCHFHHHHGGEGHHGE:GGGEGEEGGDGGC	A	18	G	16
10	124340436	A	105	ccaCaAcAAAaaaccCacaaaccAaaaCacacacacaaccaaAaAaaaacAAcaaacaaaacaaAaAaAcaaaaaACAcaAcacCaaaAacaacAaACcccCaaa	CCC9A=D?CDEDCFGECGDACFG;9DDGDGDGD>DGDEG?DDFEBCDDEGF>GECEHCEEEHAEFEEEFCDEEEEE;EHEEHEGF?E<E9GEDGEEDEBFBDA@B	A	71	C	34
10	124351954	G	70	gGGAGgaAAGAGGAagGgagGaaaAaGAGaGAAAAGaggAgaAAagGAggaagaggAAGAAgGGaAGGAG	C;;A:CGHHCFCCHECCCF>CFFEHFBHCFCHHHGCGDDHDCHHGDCEDDGGDGDDGGBFGDBBGGA=A?	A	36	G	34
10	124396586	G	27	GAAAAAAAAGGAAGGGAAGGAAAGGGA	AHFHHHHHHCCFHBB@GGBBGGDAB>C	A	16	G	11
10	124457452	C	134	tcCTTttctctcTtCTTccTCtttTTTctCCctTCCCCcCTTcttCttCcCCttCctcccTCTTtccTtTCCTctCcTtttCtccccCTCTCCTCctcttTTtttCctCcccctCctccttcctCCccccTctT	C@>>>CA@G>GAFGGFFBBEGBFGEBFAGFGBGDEGEGBFFFBGGGGGEBGEGHFCGCBBFGFFGBBFADDDDAHFCFHHHCHCCBC?DEDFFFFC7CHHEEEHHFCFECCCDHFCEACHHC;HF95B??>9C<	C	70	T	64
10	125521590	G	183	AgAGGaAGAgAGaaaaGGaGgaaGAgGAAggGaGGgggAaaaGGagGGAAgGGaaGAGagaGGGGGGgaaAGgAGagggGggagGGaAgggAaAAAGAGaaAGgAGAAAgAGagaGgGagGgaaaaggGaGAAAaGgaAGAAAaagagaGgagaaggaAaAGgaagaAagaGgAGAgaaAgaa	A?=@@C?BABDCEFFFEEFEFFFCFFEEEFFEEEEF=FFFFFBEFFE7FFFEEFEEFEFFFEEEEDDFFDFEBFEFGFGEGGEGDEGFGGGEEEFFEEDGG:DGFEFEFGFE<GGEGEGEEGGGEGGGDGEFDBFDGBEDEEDBGGFGEDEGGGFGGGEGDDGGGGEEGGGDGDCECBBAB?@	A	92	G	91
10	125780759	G	26	gGCCCCCCCCCCgcgcCcCCCcGCGG	?EGFGFECECFEDBC>E:CBC7BA>A	C	19	G	7
10	126714966	A	53	aaggaagggagAagaAAaaGAAaAGgGgagagAAGGAAaGAaAaaaagaGAaa	EEFDEEEFEEFEE8FEEEEHDEFDHFHF<GE?EBHGDDFG<FDFFFCGEGC<@	A	34	G	19
10	126721261	T	47	TcCTTCCTTCCTCCTTCTCCTtTcTCtCTTTCCTCCCcCtCCCTCtT	CBGDEGGDDGGEGDEEGAGGEHCCDFEFCDDFFDF=FCFHFECCDBA	C	25	T	22
10	127426588	C	92	cAAACaacAAaccAccacCcAccaaaacccaAccAaccaacCacccaCcCcaCcaAcCaacccaacccaaccaAcacaaaaaaaacaaccca	C=?;@CC>=@C@?CC?EAGBEBBFFFFBBBFEB<EFBBFFBGFBB@FE@GBFGAFEBGFFCC:GG;C@GFBBGECGCFGGGGGGHCGGBCCB	A	46	C	46
10	127436411	T	150	TCCCTCCCTCCTCCCTCTCCTCTCTCTTCcTcTTTTtTTCTCccTcttCtcCTCCTTtCCcCcccTTcctCCTtCTcctCCTTCtTCCCCtcTTCCttTTtTTTCtTTTcCCTCTttTTTCtttTCTtcttCCCccCCtCTccTTCCcTc	EGGFEGGGEGGEGGGDEEFGEHEGEGDEGEEEEEDEFBEGEGEEDEEFFFAGEGGEEFGGEEEEEDCEEFFGDAFDEEFDFDDFADFFFDFEDDFFFFDDGDDD>CDDDC9FDFDEEDDDFFFEDFDFEEEFFFEDF<EFCDDDCBB@A=	C	76	T	74
10	127462390	G	96	CGGCGGCCGGGCCCCGCCCggCCGCGGCggCcccGGcgcCCgGgGGCCGcGCGGCGcCgGGggCcGCGGcGCcGgCCcGCgcGCCGGCGCGgCCgg	E?A@CEBEEEEGF:;EFBGFGBFE;ADFGGEFGGEEGEGFDFEGDEFFDGDEDDCCHFGDDEEEGDEDDGDF9DDFEFCEGFDEDDCFBC9@A?D>	G	49	C	47
10	127500718	C	29	CCCCCCGCCCCGGGCCCCGGCGGGGCGCG	GFEFFDF>FFFFFFFFFFFFEFFFGCECC	C	17	G	12
10	127668487	G	80	gaAggggaggGAgaGGAggaAgaaGAaagaaaggAgaagGAggGGgagggaaaagagagggAGaaaAAgAaaagAggaag	A?=AA=BECCG9BFHHECCFECFEGEFFCDFFCCECFFDHECCHHDGCCDGGGGDGDGD6D>GGGGECCCGGGDDDDGGD	A	40	G	40
10	127734716	A	85	GAgAaGgggaagAaaGAaAAAgagAggaagaAaGaAGGaaaGGaagGaaaagaggaggAagAAAAAgGAaaaAgaAggagaagAa	@ABB=GEFFDDFDDDCFDFFFFDFFFFDDGDFEGDFGGDAEGGDEGGEEE>GEGGEFGEC?EFEECGFEEEAEEEEG=EGEEGCA	A	52	G	33
10	127737930	G	155	GgAGgaGGGggagGaAAAGgGGAgggAGgaGGGAAGAAaAAgaGaAgaAAAAggGAgaGAaaaGGgaaAAAagaaAGaagAGaagGAAGagaaaAAgGgggGggAggGAGaAGGAaaaGggaGGaAGAAAGGgGGaAgaaaggAGgaGAgGGAga	>?@?ADAADCBF?EFFEFECEECCCCFECFEEEFGEFAFEECFEFBCF?DDFDCCFCDDFGGGEEDGG9FDG7GGFEGGDFEGGDDFEDGDGGGDEDDD9DDDDFADDEDGEDDDFGGDDDGBDEEDBDEDCDDDGEDGDGDDDCDDCD?AAAAB	G	78	A	77
10	127829043	G	26	GGGGGGGGAGgAAGGGaGAGgAAggG	@ADEEEEEFDAFEDDDCDCDGEEGDD	G	19	A	7
10	129046407	T	64	cTtctTcctctcctcctTtTccCttttcTtctcccctCtctttTttttccttctccctctttct	CBC=GFBBFBEABGBBGGGGABGGGEGBGGBGBBBBGGGBGGGGGGGGBBGHCHAC@HCFHHCH	T	36	C	28
10	129207429	C	155	CcCTCcTcCTCCcTTTtTCtcCTTTtCTcTcCCcCTtCTcTctTTTTCtCCTctCCcCCCtCCCtTTTttcTCTCtcCCtCcCTTcTcCTCCcTTCTtTCTtTtcTCTTTCtCtCcCtTcCTttCcTTTCCtTccTCttCCctTCcCctTCttct	?C;?AGEEGEDGFGGCDGG>FGGB>EDHF<FA:FGGEGGFGGEGGGGGFGAGGEGFGGGG@GFGFGEFEEGGGGFCEGFFCGFGEGFG;FFDGFEFFFFFFGFFGDFFFFFFFFFCFFFGFFFFFEFFFFCFFGGEEFDFGFBCCAAA>@A;BD@	C	78	T	77
10	129245684	G	149	GGGGGAAaAaGgAAGAAAAaaaaAaaGGGAGGggAggaAGgGGGGaGagGGAGAGgaGgAGaAgGgGGAgGGAGaGAgAgaAGggGggAGagAAGgGGAgGGAAggggGAAgGGGaAgGaaagggggGggaagGGAGAagaagGagAGa	BC>??<EDEEEEEFEFEFFEEDE?EEEEFFDFDFEFEEFBEEEEE>EBFEEFDFEEFDGBDFDGEGEEFGEEFDAEFFFGEBEGFCGGFDFFFDEFD?EFDDEDFGGGDEEF@DDEEFDEFFGGDGFDGGFFGCDD@D;EEEFB==AAC	G	88	A	61
10	129913960	A	91	tATaAtattAaTattAatATTttTttatatAtaaAtATtttTaAaaaTAaAtaAatatAtaAATTTaaattttaaAaAAtataTATtAAAA	C@A=EBDDDGDGDDDHDDHGGCDFDDDDDDGDDDHAHGDDDGE=D9DGHCHEECEEEBHEDHHGGBECEE6<EDBGBGGCDEEFGFDGEBC	A	49	T	42
10	133976706	G	47	TGTTGTTtTtTTtGGGGgtGTGGGTTttttGTggTtTttTTGggtGT	5>AABEGEGEGGECCCCGECFBBBFFEEFFBFGFFFFFEECBEFA>C	T	29	G	18
10	134018483	G	31	gaaggggggaaaaGaggggggggggaagaga	CACCCCCCCFFFFCFCCD@DDDADDF@DGDG	G	20	A	11
10	134144016	C	133	CtttCttttTtttCtCttTtcttCctccTccctcctcTcttTcccctCctCtCccctttcttctTccCccCccTCtttCctcttccTtCCctcctctCtcCtTtctccccttctccccccccctttcttcctt	ACCC?;CCEEHHHFGEFGEGBFFFBGBBGBBBGB@GBGBGGGBBBBGGBGGGGBBAGGGAGGBA<BBG<CEABGGGGGG@HA@GBCGHGGCHC6HBHFHAGHGDBDBCCCHB>HCC<CCC@C8GFGCGA@9@>	C	70	T	63
10	134736026	G	36	AGGAGGaaAAGGAGAAGgGAgAAGagagGAAGGaAA	BEEF<EGGFEBEF9F=DCDFDEEDCDFDDEDDA?CC	A	19	G	17
10	134740618	G	103	GcgcgcgccgcgcCGcCGccgcgggcgccGccccgcggGgggggcggcGcgcgCgccgccgcgccgggggccccggcgcgcgccgggcggGggccggcccCgg	A?CC@CDCEGDFCBGDDGDDFCEEEDED;GDDDDEDDEGFFEGFDDEDGEFEB7GEEGEEGEGEAG?GGFEDEEGFE7DGEFEEGEFEFCFFEEEFGCE@B@@	G	54	C	49
10	134884595	G	77	gGgaaGGagAGAAGaaaGgaggaggaggGgGagggaGagaaaaggAGGGAGAgAAGGgagAgGAAAAAgAAGGAgaa	?==CB@AEC?EFBDFFFECFCCFCDFCCEDEGDDDGEDDGGGDCD8DEDED6DFEDDDFAEDCEE;EDDDDD=A=?@	G	41	A	36
10	134898594	A	26	aAgaaggAAgaaaaGaagaaagaagg	ACEDDFFHEFDDDDCECFEEEGDEG@	A	17	G	9
10	134910629	G	96	AAGAgAgAaaaGggaggaagaGGagGagAGgagaggGGaAaAAaaaaaaAgGAgGgGAgAgAgAaGggaAaGAgaggaagagagAaaGgaGaAaaa	>A7A>BADEBCCEDEEFEEFE7CEDBEEHBFEFEEE@CEHCHHEEEFEFGFCEF6ECHFHGHGGFBFFEGFBGGFFFFGBFE@GGEFBFEBFG>>@	A	53	G	43
10	135103301	C	26	CCCCccCCCCCCCCCCCGGGCgCGGg	DDDCDE@CBCCCCCCCCAB?BFC=8A	C	19	G	7
10	135351174	T	25	TAAAAATTAAATAAATTTTTTaATT	GHHGGHGGHFGFGGGFFFFFFDDEC	A	13	T	12
10	135352509	T	28	aaaaaatattattttaattatattatat	ABDCFFEEEEFEEFFFGFFFEGCCGFFF	A	14	T	14
11	193194	T	48	ccCCCCccTTCCttttttccTctccCTcTCTCTTTTCCCCTTTgtttC	C?A?BB@AC9EDGGFFCFBBABGBBGCBF9EGACDFGGFGE?D@<8HA	C	24	T	23
11	294523	C	71	ttttTTtttTtttTttttttttTTttTtTTTTTCCCCCCCCCCCCCCCcccccccccCCCCCCCCcCCCCC	DFDE;7EEDAEEECB=EBEEFE9FEF?DEEBEE??FFGFGEB6EEECFEEEEEEEEDFDEEFCDDACA@CC	C	38	T	33
11	299411	C	66	CcGCgGCCggGCCcGCgGCggGgGgGGcccCggcGcggcccgcGggccgggggcCgcgGgcgggcg	ADBCECCDDFCDDDBDFC@FECFBECCDDDDFFEBEFGEEEGECE>EEFFFGFECGEEBGEGGFEG	G	39	C	27
11	372700	G	51	gcgGCcCCCgCccgcgCCCCCGgccGggcGgGgGccCggcgcggcgcgGcc	A:BEFAGGGC@B?@BAGAFGGBDCCC?DCE?EDECCEDDCDCCDC:CDDC8	C	27	G	24
11	373427	C	29	cccCcCcCccTCCCCCCCTTTTTTTtTTc	DDDCD@EDEECFFFFFFEEFEFFFF?FB@	C	18	T	11
11	376065	A	91	CACCCaCaCACCaCaaCCCaCCCaaCaCaAaaCaaaaaCaaaaaaaaACCaAaCCCaaCaaaCaAaCaaaaaaaaaaaaaAAaaaaAaaAa	<B;D8EDE:EDCCDD?7>8CD6BBEDFBF<CEDFEDFE?FEAFDFD:???BG?=;CFFCEEFAFGC=DFEECFFFFC??7FFDDD?D6BD?	A	64	C	27
11	403545	C	30	CTTTCTCTCTTTCCTCTTTCTCTTCCCCCC	DGDDDGD>CGGFCABCFF?CDCE=BCA8AC	C	15	T	15
11	403880	G	73	cgCCgcgcccggcgcccggcgccCcggggcgGcCgggcgccgcccGcCggCgcCggcCCCCCCcGcCGGGgcc	C?9?A>A@BBCCBCBBBCCBC>BFBCCC@BCDBCCDCBCBCDCCCGCGDDGBCGCDCCFFFFFCF7FEEF<:;	C	42	G	31
11	409815	G	141	AAAGAAaGGgagAGgGAgggGAGGaAaGAAGAgaAAGGaAAGAAGagAGaaAGaaAgAGgAGGAgAgggggAaaAaGaaaagaaGgGAaaggaaGggaaAagagggGAaaagggggaaaaaaagaaagaggagagggaAAg	B>A@@AECCBFBDECEECCCEFEEFFFEFFEFCFE@EEFFFEDDEE>EEDFFEFFFDFECF@EFDEDCCDDEGGFGEGGGGDDGEDEFGGCDFGEDD=EFGDGDCDEEDGGDDDDDGGFGGGGDGEEDGCD=CGDDDGCCB	A	77	G	64
11	498442	G	59	AGAAgGGAAAAAAGAAGAAGaAAAAGGgagGGgGAaGAaAaaggaAaGagGGAgaAGGG	FAHHFC5HAGHHHCEDBHFCEFGGFBB9EG@BC>GEBGEGEDGBEFEBDGAAGF=E>C?	A	33	G	26
11	498976	T	72	cTtttCcttcTctcCcTTTcTtccTTtcCTTtttctctctttcTcTtCtTTtttttTcTttTTTcCTcTctT	?BAB>?FCDGFGDGDGBG?G<DGGEHDGDAGDDCGDGBGEDDHD@GEDEGFEEEEDDHF=DFFFHC@GFH>C	T	48	C	24
11	534242	A	213	AaAGGgaGaggGagAAGaAAAaaAggGgGAaAAGGaaAGgaAagAgggGaAagaaAGAGaGAAgagGGGaaGAAAGagaAaagGaGGgAagaggagggaAaaaAaAGGGaggAGGaGgAGaggaGAAgggGaGGGAAaAgagaaAAGggagAGAaagaGgaAGgaaaAgAgggGgaGGagaaagaaGagagaaGgaagagggGgaagaaagaa	A6>?>9CAFFFFDFFEGFFFCEFFFF?FGDEFFG;FFAGFFFFF@=FDHEEFFFCFGCG>GFFFFFFFGGGGFFDGFFEEGFFGFGDFFGGEGGGGG9GEGEEFGFGDGGGEFGGGGGFG=FGFGEFGGGGGGGFEE?EFFAGFFEFDGFG:FCGGGBFGGEFGGGFEDEEGGFFGFEGGGCCGGDFGGGGGGFGGGGGG9CDBAAB?BBB:B	A	112	G	101
11	551235	G	83	GGgAAAGgAAAGGAAAagaAgaGGGGAAAAAGaaGgaAaaaGGagGaGaaggaAgaagAGaaggGGGAgaaaaAggaAAGggA	>:@@@>>F9HH=BHHHDF;HFACAACGHHHECEBCFEHFEF=CFF=FC=;F7AHGFEFGB>;EFB@BGFCFFF?GGCFGB7>C	A	46	G	37
11	551753	G	177	aGAGggagAGGAaGaagagAaGAAgGggaAAAagGagaAAaAAaaAAAAGAAAGaGgggggaAAAAgaGGaGaaaGGGaAAGGaAGGGaaAGaAAGAGAAaAGaGAaGGAgAAgAAGAGGAGAGAaAGGgaGAgGgGaaGGAGGGgGGGGggaagGaaGGGaGGGAGaAgGGAAAgg	A<?<>@DGDCC>CCFFFFFEFCEHFAFDA@HHFF;FFEC>FHHFFHHGHCFHHBGBFB<GGEHDGDGGCCECGGGCCCEHHC6G;C?BGDG9GHHAABHBAGBGBGGBBCGGG=GDAGBBG;GBGGGBBA<BGE;CBGC@BBBBBGA@BAGGEGGAEGAABF@@?E@CCBCC5C?D;	A	91	G	86
11	620289	C	81	ctCtcctTCtTtTTtTccTcTTcTtTTcttctccTCcTCtttCTcCTTCtcCctTCcTCCCcCtTtcTCctTTttctTttt	?>=@CDBEBDFDEHDGGGGGGGFGDGGGDDGEHGGBHGDEEDDGGDGGCEGCHEGCHFCCCHCEFEHFCHEFFEDHEG?==	T	47	C	34
11	828784	A	137	gGAaAGAGGAAGGGaAAaAAAaaGAAagagGGAAgAAAAGAGGGAgAgaGGAaaaAGAaGgaggAGGaGgaAAaGAAAggGAaaaaaGAaAAgAAaGAgGaaGaaAGggGgggAAAGaGgaaAgaaAAgAAgGGgAa	A<C?C=C<>?DBACDHGBHCHEE=HHEEDECCEHFFIHFCHCCCHFHFFC5HFEDHCHFCGFGFGCC@CEBHHFCHHHGFCHFFFFEBGFGDFGGFBHGBFFB:FEBFGAGEGGGGBFBFFFBGFFGG?EFDB@DB<	A	80	G	57
11	836043	C	63	TTTTCCCCCTTTCTCCcCcTTTTCCcTtctTTtcttccCtTCTCTTCCCTTCCccTCttctTT	GFGEHGGGGDGFGEGGEGEGGBGGFEGFEEFFFEE:EEFFFFFFFFFFFFDFFEEFFEEEDFB	T	33	C	30
11	840319	C	62	CCCTTCCCCCCCcTTTCTCCCTTTCCCTTTCTTCCCTCCTCCtTCtCccTCTCTTCCCCTCC	EFFFCEGGGFFGH@FEEDGEFF5FG9GFFFFFFGEF?EEEDFCEFEFGHAEEFE;DDBB?AC	C	38	T	24
11	1020778	C	35	tctcttCtttccTcTTCcTTtcCtcTtttTcttcc	?BAABDCEDEDDFDGGDAFFEDDEEGFEFF@FE@:	T	21	C	14
11	1027221	C	170	TcCTTCCcTtTTtCTCCtcTCCTtccTCTccCcTtTCtTCcCtCcTCCtTTtCTTCTCTCttCTCCCCTtTCCCCCtTTCtCTTtTcCCTCtcTcCTTCtTCTCccTCTTcCttCtTTcTCtCCtCCTCtTcTTttTccCttCCTTTTCCTtTctCTccCtCCCCtCCTT	D>??A@CBGF<FGDGDCG@GDDGGBBGDGBB6BFGFDGGD@DGDBGDDHFGGDCGDDDGDHHDFDDDDFHGDDDDDHGFDFCFGHGCCDF7HCFC7FFCHECFCCB<CFFCCHGCIFFBFCHCCBCCFCEFCFFHHFCCCHHCCFFFFCCFGFCBCFACCHBDCBDBBC?	T	86	C	84
11	1029320	C	71	ccCTCCctTccCtTtcTTcTttcttTTcCctccccttTTCtTtctcTCctcTctctTTTCCtttCTctttT	?>ADBACGFBBDGGGBGGBGGG@HGDG@DCHACCCCHGGD@GHCACGDBGCFCHCEFFFC@HHHBEAGB;?	T	40	C	31
11	1078393	T	185	CccCttttTtcCCCccTtttctcTtttttCttCtttCTCccCcctccccCTctctCcCTccCCtTTccCCCCttcCctcttccCtcTccctttCttcTTCtctctccctcttcTtcCtccttccTctctCccCCCttTtCttcTcCtcTCtTCCTTcccTtTtccccCcccctctTTtttCtCcc	A??=CCD>BC>@@AAACGGGCGBDFFGGGDGGCGGGDFDBBDBBGBBBBCGBGBGCB9EBBDEGDH@B:ADDGGBDBG>GGBBDGCGBBBGGHDGHCGFDHCFCHCCCHCBHCGHCCGACHHCCGCCCHD7C=CCHHFHDHHCFBCGCECGFCCFFCCCFHFHC7BBACCC;FCHFFHBFBDB@?	C	101	T	84
11	1079809	C	38	cCcTCcccctTctTcTcCtCttcttTtctCccTccctc	?;?CBCBAB8EBGFBGBD6CHHCH<GGC:CCCFCCBGC	C	22	T	16
11	1103477	C	41	TttCctcctTTCCTcTCTCCtTTcCCTTCTTTCTcCTTcTT	D?EDBGBBGFGDDGCGCGDDHFGCCCFDCFEFCFBCEEAFA	T	23	C	18
11	1252708	G	198	GCCcCgCgCGCCCcGGCGGGGGCggcGCGGgCCGcgCGCcgCCCcgCCGGGcCGgggCcCgggCgcCGGCgcCCGCgGGGggcCcCCGCCccgCgggGgcggcGGggcGcgCcCGgcggcGgCcCgGGgcccgcggGcgGcgGcgCcGCGCggcGGgcggCgCgcggggCcgcCcCgCgggccgggcggggCcgcccc	ADD<8@A<DD;EFCGHGGHHGHGCCBGFHHCGGHBCGGF@CGGGBCGDHHHBDHCCCDBGCCCGCBGEGGCBGGEGCHHH@CCGBAGHGGCCDEDDDHDCDDBHHDD@HCDEC<HDCDCCHDGCGCHHDCCCD5DDGCDGCDHCDFCGFHFDDCGG7CDDFDFBCDEDDFBDCFCF?FCDECCDDDAA>>>A=<;7=@	G	105	C	93
11	1253401	C	74	CgcGCccGCgGccgGCcCgCcccgCgGggggGgGcGGcCccgccGcgGggcCcccGggccggcccCgcgggccg	D<>@:BAABDCDDFEFDDFGDDDFGDE@GEFEFEDEDDEEEGEED?GD>FDF@9ECGGEEGGEEEFF=FFGAEF	C	38	G	36
11	1279486	A	69	gGGGAAAAAGaAAGAAAAGGAAAAAAGAGAGAAAGAAGAGGAAAGAAGGgAAaGGAaGGAAgGGGAGaA	;?DEFEF8FEG9FEFA;;D8ED?:FEDEDEEEEDAE;DDDDEEEDEEDCADEDDDEGDCDE?DDDCA@C	A	41	G	28
11	1281134	T	186	TTcccCtTCttCCcTCCCCcCTTcttCcccCTCTcTTTtCcTTtcCTCTCtTTtCtCcCCccCCCcTTCCtTCTctCCcTCcTtTTCtttctCctccCTCTTtTCCCctTCttTCtCCTtcTttCCCcTTTtTCCTTTCCTTctTCCctTCttCTCTTCTCcTcctCcccTtTCtttCTccCTCCT	<?>@@FFEGFGFDBGGGGGBGGGBGGEBBBGGGGBGGHG>BEGFBGFGGGGEGGFCGCGGCCFFGCGGGGHFGFCGGGCGGCFHGGGHGBCHGBHC@GGGGEHGGGG?HFGHHGFHFGEHCF;DFFFCF8FHFFFFFFFFFF9HFFFAHF;HHFFFFFCFFCFCCHFCCCEHEEFHGGC;?B?B??	C	96	T	90
11	1585277	C	90	cctTCCTCTCtTcCCcccTCctcCttcCTctttttTCccctctCttttCttcctccttctccttctctcTTCtTtccCCCccCTctcccC	C?BB?<DBGDGGBDDBB=EDBG@DAGBDGAGGGCHGDACB>AHD;GGGCGDCCGCCCACHCC;GCHBHCGFCHFHBCCCCCCCFBHCCCA	C	50	T	40
11	1857270	C	191	TcTTCtTttCCctTTCTtTCCTTCCTccTCtttTtcCTtTcttttcTCTtttTTCcCTTCtcTtTTtcCctcCCccTCTCTttcctTTttTtCCTttttTtCCTcctTtcTCTTTCCTtCcTTTTCTccTTTtcCcCtCCtTttTtTttccccCCctCTtcttCtCCtCCtccccttttcTtTccttcCCt	BA@<BB?CECB?EFEE=GFGGEDDGEBBEGGGGFGBGBGFBGGGGAGGFGDGGGGB<EGG?BGGFGGBGAHBGDACFGGGFHHCBHDFFGFEGGFGHGH6EGGGCBHDGCGGEGFAGGHEBGDFGGDCCBEBHCG>FHFFHFHHFGFHH5CCCCFCDFE9BHFFH@FHCFGCCCCHHHHCECE??G@=ABA	T	111	C	80
11	1857930	G	27	gGGGAGaAGGGAGGGAggAGGGgaAAG	AFGGF<EFGGFDFFFEGFEAED@>BA?	G	18	A	9
11	1874292	G	26	AAAAAAgGAGAAGAaAAgGaGAGGAG	HFHGHCGAHBGG9GEGGFBA>GB?BC	A	16	G	10
11	1947789	G	119	AGAgaggggagaAGaAggAGAagAaagAaaAagGagagagaGaggggagaggGagagaaggagaGgaAaAAGAaagaaAgaaagaaGAAaaaGgGaagaAggaaaAGaGAaGgaaAAga	?=@>CBBAABB?A?CBCCDDFEDFDCFFEEFDFEEEEFEEEEEEFFFDEEGEEEEEEEEFEEEBEAEFCFEEFFFGFFEDFFFFDDEF?FFFC@EDFFFEFFCFAE@EDEFDEF@AA>B	A	69	G	50
11	2017439	C	103	GcgGgCCGCCGcgcccgGgcGGggCgccccggcCcgcGCccGccCGCcccGCCGCCggccgcCCcccGccCcccCcCgcgcCGgCCggCGgGCGGGCgCcccG	EC@DBFBGEDGACB;@CGCBGGCCGCBBBBCCB?ACB9GBBHBBGHGCBBHGGHGFDCCCCCEGCB@?BCGACCGCGCCDCFGDFFDDFFDGFGGGFDF?<;?	C	62	G	41
11	2018449	A	99	ggGGaGgAgAaggGAaGAagAAAGaGAGaGAAggAgAaaAGAAGAgggGggGGaAggGagggaaaaaaAgAgaaAaAaaAGGGgGGgagAGAaAGGAgg	BBAFDF9:EEBEFF>CGBEF>FGGDFEGDG9E@E:EEDE?GBEGFGGF>GFFFBEFFGFAFGB=BBEFECECBFEFDACEF>FFEFFEDDCB?BAAC?C	G	50	A	49
11	2330077	C	48	GggGCCccGCCcGgCgCgcgGcggcccCCggcgGgcCGccgccggGcc	BCBEBECDHGGDHFFFFFDDHAGFEEEGGGFEEHBEFGEE?EEG>GE>	C	25	G	23
11	2330400	G	51	GGGgAaGGAGGAAGAAAGaGgAAGAaGAAaGggAaAAAgAaaGAagAAAGg	?BBCFFFGF=GFFGFF?9GCDFBGEGFEEGGD8EGEEEDDGGFDGDDED?>	A	29	G	22
11	2416154	G	43	GAaGGgAGAAaaaAAAAAGGaggAGAagAaaaaGgAaaAaAAa	@HDCCFHCHHFDFGHHGECAEGGGBGFFEEEFFBFGFFGEFFA	A	30	G	13
11	2427291	A	283	AcACACccACccACCCaaAACCACcCACACCAACCAaACACCAcaCCCCAcCcAACaACCccCAAACCaaAAACCacaCAaaaCCCaAccACAAAACaccAaaaACaaccaCcAaAAcCCCcCAacaacCCCCAcCACCcaACcAAAaAaaccAAaaaaccACcccaCcCCCAcccaCCCacccCACaccaacAcCaCCAcaaAAAaAACccaAccAAaaccaaccacAACcccCAAcAacaacCacCAaaacAAaCaAaAAAaaaCacaccccAACacccAc	B?@ABEDCEFCCEEF@EEEDGGEF<GFGFFFF;GFADEAEFGFDDCGFFDDFDFFFCE<BDCEFDFFADEFFEGD=DAGEEDEEF9EFEDEGEFFF@EEDEFFDEEFEEE;GEAF@FEFCGEF<EBFFDGFFGFEG<GFD?FFBFEEDEEFDDEEEFD;EECFEEEFEE?DEEEEEBFEFFDEDFEEBEED;DEEE6FEEEE>EEEGEEEDEEEEEEDEEEBF<EEEDDEECDDFEAEEBE<CEEAEDBEEEEEEFEEE=DEDFE?FBA>?<?@AB>?==9?A	C	143	A	140
11	2432820	A	113	gAaGgGGgaGAAaAgggGaggagggAAgAgaagaGAaaaaGgagAAaAGgagAgGaGGAAGggAAAGaAGGaGAgAgaGAAgaAGAGGGgGgGgGgGGaaGGaGGAAgAgGgg	A:DABDDDEEFDFFFFFAEFFFCFFEFFGFFFFGE@FFFFEFFEFEFBEFF=FGEGEEFAEGEFDADGEDEGDFGEGGDEEGFDDDADDDBEDGDG>CFEDCGCDEDGCAC>=	G	63	A	50
11	2439621	A	26	aataTaAaaatAttaAaTAAATTTAA	FDEFFFGFEFGHHHGHGFGGGFFEFF	A	17	T	9
11	2909513	C	64	CcccCCCCCCCCCCCCCCCCCCCCCCCCCCCCCCgCggCCCCCCCCCggggggCCCgCCCCCCg	>CC?=EFDFFFEFEGEGFFGFEFGGFE<EFEEAEBE>AE=FFEEFEE>D?ADDFFD<FBBAA@A	C	53	G	11
11	2975987	A	102	GGgaaAaAAgagAgaAgGgaGgggagAaagagGgGgGAgaAgGGggggaaAgGggGAaagaaaAgaaAagagagGaaaAAAagagaaaGggagaGAgAagag	:<C:ACCGFEDFHFDHECFECEEEEFHEEEDB>FCEDICEHECCGEEFEEEFCGDBHFEFEFDG5FFHFFEEFECFFF>HGFFFEFFFAGFBGEBGFGFFD?	A	52	G	50
11	3026712	C	37	TcCctCTttcCCTccTccccttttcccTcttccctCc	@AA?FDFBDDDDGDDHDDCEEFFFAEEGEFGEDDFCD	C	22	T	15
11	3036933	G	45	TGTTGGtTGTGTGGTGGtGTGGTTGGTGTTTTTGGtTGGTTTggT	@@FFE@HECFEFEEFDEHDFDD9EEDEDEEEE5CDGDDDFCC@?C	T	24	G	21
11	3078536	C	32	CGGCGCCGGGGGgGCGCCCGcGCGGGGgCCCC	DCCDB7CC;CCCF=CCCCCBEBCABAAD???=	G	18	C	14
11	3398760	G	38	TGTTGTTTGTGTTGtGtTTTGgGGTGTGGTGtTTTtGT	EEFCDEFFEEDEDDGDGEE@DDDDEDEDCCCFEDCBB?	T	23	G	15
11	4104087	T	51	CCCTCTTTCCTCtCCTTTCCCCCTCTTTtTTtTtTcCCCTtCTCttTtTTT	@@EEGEEEAEEGHGGEEEFGF=FEFDDAHDDEDHDCADFDHFDFHHDGDCB	T	30	C	21
11	4104745	C	87	cgggGgccgCcCcggGCCGcgcgcgGggCgggCCgcGCcgCGGgGCGcCccgcccccccccGggcgccggccccccccccgCcgcGc	A??A@B?ABFBGBCCEFGEBCBCBCECCFCCCEFCBEFBCGEECEGBCEBBDBB=CCCCC;EDDCDCCDDCCCCCCCC?CBFCDA8=	C	50	G	37
11	4411003	G	64	ggGccgcgcCggcgCCcggcGcgccGgggCggcgggcgggcccgcggGccgcggcgcgCcgccC	BA?FFFFEFDFFFF?DFC@FCFFBFBFFFDFFFFF9FFFFGFBEGFCCGFGGG7GDGGCCGGGC	G	34	C	30
11	5221645	C	215	aAAagaAaGAAgggAAgaaaGgAaAAaGggaGaaGGAGGGgggagaAGGGGGaaaAGGAAAAaaAGgaAaGaaGgaAagAAGaaagGagAGAaGGAAaaAaaaggGGAAGaagAAAgAgaagaGGagGAggGggAGAgaAAaagGGaggaAGAggAaagaggGgaaGggaagGAaaagGaGaaGGAaagaAaagagggAAagggagggaAgAAag	C@>BABDDBFGDEDHHAEDE;EHDHHECFEECEBCCFCC@EDFEEDHDCCBCEEEHCCHGEHEEHCEEHFC;D?FFHEFGHBDDFG@FFECHFCCHHFEHEFEGGCCHHCEFAH?HFFGFDGECBFGBHGFBFFACFFFGGBEFBBFGFFG?GGFGFFF:FFBGFFBGGGGGBGEEFGBEBFEBBGFFFDGEEFEGFFFG?GFEBB?@ABBC?>B	A	118	G	97
11	5364276	G	71	gggggaaagaagggGAgaAaaaGGAgGGGgaaaAaaaaGGGaaagGgaAggGaaAAaGGGAAgAGgGgggG	CC??@CCC@FFCCCEFCFF5FF;EFCEEECFEF?FFE?EEEGG?DDDGDDDAGGDEGDD>EEDEDDCDC8B	G	38	A	33
11	5474838	G	164	TtGGTtGGgGgGGTTGGGgTGGtGGTtgGgGGTTgGgtgGGTggtTTtGtGGggTgGTtgTGTgGgggTTtgGgGgGtgGGGGGTGGGGTTGGTGggGTgtTGGTGGGtggTTGTGTTGTTtgGggTtgtTTTgTttGGgTgggGtTGTTGGGtGGttTTTGTG	ADDC9FEECECEEEFDEECEEEEEC@GCECEEEACDCGDEEEDDHFFHDHDEDCFDEFGDFEFDDDCDEFFDDDEDDHDDCDDDEDDDDEEDDEDDDDEDHEDDEDDDIDDDEDEDDE@EEHDDDDEGCHEEEDEHHCDDDDDDCHDDEEDDCCCBCC:9A>C?	G	98	T	66
11	5632212	G	103	AaGAggGaAgaAAgGgGaGgAaggaGGGGAagGaaaGGgGAAaaAGAGAgGAAgAAgAGaAaAGagAAaGAAAGgGAAGGAGAGgGaaGggGAAgAAAaaGAg	B?@?AADFECFEDCHAFFHC=FCCFBHHHEFC@GGGHHDHECFGEHEHEDGEDDEBDEGGDGDHFDBDGGDDAGCGDDGG9GDGDGGEGDDGDDDCDCGCD<<	A	54	G	49
11	5717762	T	128	TttTCCCTTTtCCCTtCCcTTTCtTCtCCcCccTTcCtctCTTCcTCTtCCTttTCCcCCtttCTTtTTTTcTtTCCccCtCTTCctTtcTCCTcTCcttTttTTtCcCTctccTcCtTTcTtcCcTt	@BBBBAEGG=GGFGGGGGBGGGGGGFGGGBGBBGGBGGCGGGGEBGGF@GGGGGFGG?GFHHD7GGGGG>GCGHGGGCBCHGFGGCHFHBFFFFDFFCHHFHHFFHDCFE@ACCF@EGFDBEE?B;?E	T	69	C	59
11	5719750	G	52	CcggGCCGGcgggGgCGgGGgcgGgCGCgcGGgccgGgCCcGCggggggcgg	ABCCFGGGFB?CCDCEGCG<CCDGDGFGDC>GCCCDGDGFCFFDDDDDDC;<	G	35	C	17
11	5729580	T	62	ccttctttttccccctctctccTTtcCtcCTTtCtCCTTCCTTTctTCCCTTCTCTTTTTTT	CEEEFCDDDDGGFGG9GDGDGHDEEHFEHFDDECBDFBDFFDDDHDDFFFCCFC@CCDCEB9	T	35	C	27
11	5862845	A	151	AgGGgGGAGggGgGaaAAAAaGaGGGGAAaGgAAGaAGAaaggAGggGAgAGaaAgaAAgAAAagaAGAAgaggAggaggaAggGggaAaaaAGGAggaaAgggGAgAAAaAagggaagAAAAAGAggGaaGagGaagaAagGggaAGaag	B@?CFDCFDEEEFEDEFFEFFEF<CCEFFFEDFFEDEEFBDFFFDFFEFF<DFFF9FEFFFFFFFEFEFFGGGGEGGGGGGFGGDGGFAGGGDDDFBGGFFEGGDECEEEGEGGGGEGHEEEEEDEGGDCEDGFDFFF8FBAAB@AAB<D?	A	79	G	72
11	5906203	T	357	TtgGggTGGTGGTGTTtGTGgGtGtGGGGTTGTGGtgTGGGtTgGTGGGTTtttgGTGtTTGTTGTTtGGggGGGtgGTTGggtGGTTTTGGggGTtttGtgTTGGgGGTGTTtGTGGtgGTggTttTgggGTGGGGTGgGttGTTGTTtGggtGTGTTTTgggTTTTggTGgtgGGTTTttttGGGtGGTgGGgtTgTTgtGGTgGGGttgTGggGtgtggGGgtgtTTGgtGGggTGTGTTgTGtttgtTGtTgGggGGTttGGgTTgtggGGTgTgtggTGTgttTTgGgggttgtTgGttTTTGgGTTGTttgGggttTgGTggtGGGttTttttTtgggtttGTgggtgtgg	B?C=>A?<<?CB?BAADFEGFHEHEHEHHEEGEHGE6EHGGEEFHEHHHEEEEEEFFH?EEFE@IFDEEHFEHGHEEHEEGEEFHHEECEHHGEHE;EEHFDEE?HEHHEDEEFHEHH>F;DFFEFFEGGF6EGHGHEHFHFFGEBGEEFHGFFHEHEEEEGGGEEEEFEEHAFGHHEEEFFFFHH:FGHEFGGEFDFD<AFHHCGGF;FFGDGGFFFFFFGGGGFGEDDFGFGGEGDG:GDD;DGFFEFFDGGDFGGFGFDDFGGEDDGFGFGGDEDEFFFDGCGFEDCEGGGGEFFFDFGFFDDDGFGDDGDFFFGGGFFDGGBFEEHHGBEDBCBBB=BBB???@AB>>;ACBB	G	191	T	166
11	5906205	G	358	AGGAGGAGAAaGAGgGaGGaGGGGAAGAGGagAGGGGagGAGGGAAaaagGAGaAAGAAGAAaGGAggGGGagGAAGggaGGAAAAGGggGAaaaGagAAGGgGGAGAAaGAGGagAggAaaAgggGAGGGAGAGgGaGAAGAAaGggaGAGAAAAgggAAAAggAGgagGGAAAaaaaGGGaGGAggGGgaAgAAgaGGAgGGGaagAGggGagaggGGgagaAAGgaGGggAGAGAAgAGaaagaAGAgGggGGAaaGGgAAgaggGGAgAgaggAGAgaaAAgGgggaagaAgGaaAAAGgGAAGAaagGggaaAgGAggaGGGaaAaaaaAagggaaaAgggagagggAgggGg	C;?;<;:;>CCADAEAECAECCCBGHBHCCEFHC>CCEFCHCCCHHEEEECHCDHHCHHCIHECCFFECDCDDCHH6EEECCCHECCCFECHEEECEEHG=CGCCGCGGEBHCCEFHFFH;FGGGFCHCCBEBGCFCECHEBHHFCGFEAHCHHHHGGGAHHHF@HCGFGACHHHFEFFCCBECCHBFBBGFGFFGA<CBGGBB>FFGFBGFAFEEFDBBGFGFGGBGFBBGGGBGAGG9GBFFBFEGBGGBGGBAGEFBBBGGGFGFBBGFGEFFFGBGEEEGGGBG?GEFFFGFBFFGGG?FBGGBCFCGBGGFFGGBGFFFBBAFFGDEDBG?EBDABBC>@@@B=?@@@B@>CD	G	194	A	164
11	5906291	T	317	CttTTTCcCTTCTttcCccttTcCTcctCCCttTttttTtccctttCTccctctcccTcccCcTccTTCctccccctCctTTtcttttttTTCTtTtccTtTTCTttTTCCttTtCTctTCTctCcctCccCTTTCTtttCCtTTTCTtcTTccttTtcctTtcccctttcctTcCCctTTCcttctTtttccctcctCcttTctCtcttttCCctctttTCcctTTcCTctcTtccTttcttTCttCCcTtCcctTccCcttCcttttTTTTccTCtCttctttcCTtcCTccttTtctCCCtTctCtttTTTCCc	DC????@CABB@;AABBDDCBCEEEGFEGGGCDGDEEEGEFFFEEEGEFFFEFBFFFGFFFGF=FFGGGFEFFFFFEGFEGFEFD@EEEEGGGFEGCFFGEHHCHEDGGGGEEGEGFFEGFFFEGFFEGFF:FGBGFEECGGFFFFGEFFEGGFEFBFGGFFFGGGGFEFGFFGGGGGFGFGGFFGFGFFFGGGFFFFGFFFGGEDFGFFFFGGFFFFFFEFGG?GEGFFFFGFFGFFFFGFEFFFDFFGFFFGFFFGGFCFFFFFDFFFFFFGGFBFFFFGFEEGFFFGFFGGFFEDEFAFFA>B@BA9?ACBACD	T	177	C	140
11	6079001	G	216	gaAAggGAAgAGGAGGAGAGaaGgAaGGAgAagGGGaaaaAGGaaAAGagaaGAAaaaagGaGAGAgagAAAGAgAGGgaaAAGGGGaaAGgAGGGGaGaagAAAAaagagaGAgagAAaggGaggAGGgagAgAGAgggaGGaagggGAAAgGgAaaAgGAAaaggGGggAgaAggggaGagaaAGGaggaGgggGagagGaaggAgaaaAaagG	BCCBCCBHHFHCCHCCHCHCDECEHECCHEHEECCCEAEEHCCEBHHADEEECIIEEEEFCECHCHFEFHHHCHFHC>CBEDHCCCAF@HCFHCCB;FCDFFHHHHFFGEFFCGFFFHHFGGCF@FHC56FFHFHCHGGFFCCFFGFF=GHHFAGGFFGGAGCFFFFBBB9FGGG?FGGFBFGFFGBBFEGDBFFFBFFEFBFF@D>FE?EE>=A?	A	108	G	108
11	6579539	A	25	aagggagAgGGaagggagagggaaa	CBCCFDFFFEEDEGGGDGEGFGEEA	G	14	A	11
11	6739822	T	147	ttCCccccTTtCCTCCtcCtTCTcttcTCCCtTcCcTCtTcctTCTCttTTctTtcTttcCTCTtttcttctCTcTctttTCTtTTtccCCcccctccCtTTtTCTCCCTCTTCCccCTTTtcTTTcTcTCTccttTCCtCTCTCtc	AC<AAAABGGGGGGGGABEGGEGBGFBGG?;GGBABGGG:B>HGGGGG;GGBGGHBFHHCGGGFHHHBHH=HGE@GCHBG<GFHFGE?CEF>CCCHCBFHFFIFFFCFFFF@EFFCCFBFFGCFEF;FBFGG;9FFCDDDBCABAB@	T	77	C	70
11	6913127	A	111	GaaaagGaGAaaAggagaaaggaGaggGAAGGgaAGgggAAGAAAaaGgGGggGAAGGGaggGaAgAAAgGGaAagGGAgAaGGAGGGgGGGGGGAaaaGaggGaaggaaG	@ACC?BBDBFEFHFFFFFFFFFF>F=FBH;CCFEHCDFGCGCHHFGGBGBCEFAHHBCCGGG=EHGHGGGCBGGDGBBGFGGBBGBBBGBB@BBBGGGEBGGDAD=B@@?C	G	61	A	50
11	7070866	G	27	gGGGAGGGAAAGAAGGGGAAAAAGGGG	FEEBFEEEEFFDEEDDDDEEEEEDCCC	G	16	A	11
11	7619518	T	33	tCctTCTCCccTCcccTcctTCCccttccttcc	CGFDGCGGFGGGHGGGGFHEGGGFHEEHHEEG?	C	21	T	12
11	7670249	A	54	gggagaaaggaggagaggaagggaagaagggaagaaggaaaggggaagagaaGg	CC?CBEGG@BFCCFCFCC@FCCCFFCFFCCCFFCEGCDGGG?DDDGDDHDGBB>	G	29	A	25
11	7949707	A	52	AGGAAagGagGaAaagAAagAaGgGgAggaagGggagaaGagggagGAGAAg	<CFFFDFGDFGDFDDFFFDFFCGGFGEGEEEGGGGDFEEFEGGFDGEEFEBD	G	27	A	25
11	7949791	A	72	ACAAcACCACAaACcaAaACaACACCAACCaccccACcAAAcAcCAACcACACAaACAaCCAaACACACAAc	?BFFDFGGFGFDFG@>9FFGFFGFGGFF7AFEEDEEFEEEEEEEFEEFDEDEFEFDFECFBCAB@BABCAA<	A	39	C	33
11	8284860	G	50	TTGTGTTTTGTgTttGGTtTtgggTTgGGGttGgTTGGtTttTTtGtTGt	<CAGBFGDGCGFDFFCCGFGEGGGFF6BBBAFBGFFBBFFFEFEC@@C?B	T	31	G	19
11	8494640	T	50	TCTTTTTCCTTTTCTTtTTTCTcCTCTCtCTTCCTTtTcTCCCCcTTctC	GFGFGGEFGGGGF<FFFFFEFFGFFFFFFFFFFFFEEFGFFFFGFCCDA?	T	30	C	20
11	8735662	G	77	GAGagggAaAGAaGaGagGgAGggaGagAAgGAGaggaaaGAgGaGAGAAGagAAgAgggAaAagaGgaggggagga	?B<=CDFEDFGE=GEG>EAFFGFFD?EGFFFGFGEFFEFCGEG:FGFGEFGFFFFDFF6GEDECGFEGEBFFFFECB	G	41	A	36
11	9051406	T	113	TCCCCCCCTTctTtCtTCTTCCCTTCCTTcccTcTTtTtTCCTtCCTTcTcTCTTTcCTtCCtTCtTtctTCtTctcccccTtCtccTcCctCTCcTCtcCCCCTTCcctTtC	BFBGGEGGGGBGFGGGGDGGGAGGEGEGF@BCFCDGHFHGGEGHGGGGBGCGGEEECGFEFFHFFHFECHCFHFCHCCCCCFHFHCCFCFCHFFFAFFG=FFCCEBA=>@?BC	C	58	T	55
11	9171775	A	44	aGgaGgAgGAAgAAaaGaaGaaaaGgAaGgAgaagGGagAGgga	CDGDFFFFEFEF=GADGDCGDEEEFGDEEGEGECGEFBABBB?B	A	23	G	21
11	9981165	A	32	GgAGAGGggGGGAggaaAgAAAAAGgGAgGAG	>FHCHC6FGCCCHEFEDHGGGGGGBGBGGBF@	G	19	A	13
11	10522983	G	30	TGGTTGGGTTGTTGTTTTTTTGGTGTGGTT	?EE=FEEEEEEFEDEEBEEEDCCAB@BACC	T	18	G	12
11	10601931	G	73	AGGGAAGGAAAGGAAAaGGAgGgGgAAAGAGagGGGaggGggaAaaGAgAAAaAGgAaAaAgaGAAagaGAgG	8DHHEEHFEEEHHEEEEHHEGGFHGEEEFCGGGHHGGGGGGGGAGGGDGDDD6DGGDGDED?GGDDGGEHAAA	A	38	G	35
11	10603648	A	32	gggagagaggagggAggggggaaaagaggggg	A@DFBECECCFCCCDCCCCCCFGGFDFDBD?<	G	22	A	10
11	11913585	G	114	TGTTtTgTGgTgGtGTGgTGTtTTgTTtGttTtGgTGttgTGggtGggGtgGGTgtttgttggggGgtgggGGGttGtttttttGgttttgTtgttgGgggTtGggGgggtGtg	BB:>B@@@DDDCECCDDCFEFGFFCFFGEGGFGDCFAGGCFECAGDCCEG>EC@DGHHCHHDCDDEDHDDDE>EFHEBHHHHHHEDHHHHCFADHFDDD@CEGDBCDDDBDA@A	G	59	T	55
11	12183846	C	132	CTtCTtCctCTTTCCTCCCTcCCCcCCcCtCCtTTCCTccTtTtcTtttccTccccCtTtccctccTtCCcctCTTctcctTccTTcCTtCtTCTTtCtcCCcTCCTtctCTccTcCTTTttCCCcCTtCcc	D=>FGDDEEG?EGGGGGEFGFGGGFF?FHEGAFGDDGFAFGEFEEEEDFGFGGFGFDFGFGGGFGGGFGGGFFGGGGFGGFEGFFCGGGFFFF?FF<FFGFFGFFFFFGEDFGGFGFFFFEFEDBBBBACDE	C	73	T	59
11	12231179	G	29	gggggTgggtgtgttgtgtGTtttttggt	@ABCCFCB;CCGCGGBFCGEEHFGHEDBH	G	15	T	14
11	12242030	A	27	gggaaAgggagagaagaaagaaaagag	BBBFFBEEFFDFCGFG;GFGFGGGGGB	A	15	G	12
11	12495607	T	34	ttttcttctTccCtctccTctctttCttcttctc	@@@EGCCECEGFFDFDGFEGBHDDEFDCHCDHEB	T	20	C	14
11	14810762	A	76	gGaGaGGgGAGAaGAGGAaaaggGgaGgaGgagGAAggAgaAaagaAAagaGaaGAgggagggGggaGaagAgaga	@=C9DDEEEAEF=EFEEFEEEFFEEEEEEFEEEDFDEG<FEFDFGFFEEFFEFFEFFGGFFGFEFEEDFGGEGFG=	G	41	A	35
11	16766106	T	30	TttTCTTCCTttCCTtTCccTtcTCCcCCC	FEEGEGGBGGFFGGGFGFFHFFGEFEEFB@	C	15	T	15
11	17124388	A	38	cccaAAacccccccacaAaaaccaAcccacaacaccaa	ABACBDDDDDDDDDEDDFDEADDEFDDEFDFFEFEEFE	C	20	A	18
11	17631751	C	182	CtTCCttTTTTtcTCCCttTcTCTCTCcTCTCCTctctCTCTcTcCCTctTTCTCTTTTCcTcccTtcccCCTTtCtcTtctCtTtCtttcTtctcTtTcTctCttcTCtcCCtcTTCTTcCTcctctCcCCtctcTCcCTCTCctttcctCccttttCTTCCTCCcccTTtCcctttTTtC	@C@<CCDGGGGDGFDEDDDGGGDGDDDGG?GDDGGDGDDHEG<GGDDGGCGGDGDGGGGDG?CFGGCGGGDDGGEDEHFEHEDEGBDEEEHGEGEHGEG;GHED?EHFCEHCCEHGEDGFHCFGHDGECBCCAH=HFCHCFCFBFEEEHFECHEEEBEAFFCCECCHBGFFDDGEAB?AD@A	T	94	C	88
11	17632082	C	66	CcCAcccaaacCcAcaAcCaaaaacAcccaACCcAacaacCCACAcCAAcCCAAaCAcCaACACcC	DB:;BDDEDEDAD5DCDD>EEEEEDEEEEFCGGE;EEE;EFFDADEFDDEFFDDFADEE@DGAC@B	C	36	A	30
11	18764026	G	48	cccGgggccgggggcGgggcccggccgcccgcgGcCgcggcccgcgcg	AC?>BBB?BCCCCBBECCCABBCCBBCCCCDCDBCGD?DD;C>DCDCD	G	25	C	23
11	19735987	A	143	GggaagagaggggagGgaagGaagGAgagaGAgAaagaaGAgaaAaAgAgggAAGaaaAagGAggagaggaAgggagGGaAaaaAgGgaaaaaaAgggaagaGaagAaaGagGAGaGAAAGagAGAgagaaagggaggaggaa	BCACABBAAAABABBABEECCFFFDDEEEFEFFF7:FFFEFFFFFFFF@FFCFFEGFCFFFEFFGFFGF;GEDFDGG@CGFGGGEGEGGFFFGFFGFGFGFGEGGGFGGDGDD=DFDEEEDGGEDEDFGGGFGGGGGFABB=B	A	76	G	67
11	20070225	C	28	GGGGCGGCGGGGGGCCGcCCGgCgCCCg	EDCEFEEGEEEDDDFFDDEECG>CCDB>	G	17	C	11
11	20119373	C	36	TTtttttcCctttttttcctcctcCtttttcccctt	D@C?@BCFCGBDCDDDDGGDGGEHD=EDEEHHHHED	T	23	C	13
11	20628479	T	58	CTCTTCCCTCCCCTTTTCTTTCTTTcCCTCTTCCTCTCTCCCCTCCTTCTTTtCCCTC	DEDGGDDDGDDDDGGBGDGFECFFFHC9FCFFCCFCFCFCCCCFCCEEBFEFCDBA?C	C	30	T	28
11	20639479	G	25	gaaaaaggGAGaaaggagAaaggaa	BEFFFECCAGCFEFBDDDHGGDDFB	A	15	G	10
11	20648179	C	37	TCTTCTTCtCTTTCCTTCCTCCCcTCCTTTTtCCccT	GDGCDHGDH@GFGDDGFCCFCCCAFCCF=EF:BCA8C	T	19	C	18
11	25100229	G	39	AAaagGaaaaagaGaagaggggagggagagaagaagggg	A:ABFBEFFEBFFAFFFEFFFFFGGGGGEGFEFFFGGDA	A	20	G	19
11	28232869	T	32	TtctcTcctcCcCCTcttttccccctcctctc	=?CCEDGBDEGEGGCFEEEEFGGGFEGGFGB:	C	19	T	13
11	30253318	A	35	TATATATTTATATATTATAATTTATAAATATAAAT	GFEFGFGGGAFEFEFFEFEEFFEEEDEDEDECB>@	T	18	A	17
11	34460704	C	30	ttttcccccccccccctttttctttctccc	?CCBCADDDDDDDDDDEDFEFEDADBFEEE	C	17	T	13
11	36293048	G	51	AGGgGAGAGGGGaAgaAggAGAgGGGaGGAGAGgAAgGaAaagGGGAGAGa	=DGFGFGFGEEGDFE>FGGFFFGGGGDGGF9FFGEEGFEEEAEFFFEDBBB	G	30	A	21
11	44151480	G	103	TGGGTGGTGTTGTGGGGGTTTTgTttTtGTTGGGtGTGGTTTtGTTGTTggTGtGGTTTGGGTTGGGTGGGTTGTTTGgGtTGGGtGgtTTTTTTggTTGgTt	BCEECEEEDFFEFEEEEE;BE6BFAHFHEFFEEEHEE9EEEEGAEDDEEDDDDHADEEED=DEEADDADDDEEDEE5DDDCEDDDEDDHEDDDFCAA@AA=C=	T	54	G	49
11	44151577	T	265	AATtAaTTATaAATTAttTtAAtaTATtTTTtaAATtatttAATAATTTTTATAATAAttaattttAAAAaaatAAAaatTaaTATaTtaaaTAAaTTaAATatatATTataTTaaTAtTAAtTTTaTTttatTaATatAAAAtTAttatATtaTtTtaaTaatTTATAtaaTAAatTTaaTTaTTATAatAaataatTTtttaATaatatttAATTattTaAattttTTaaTtaaTAATAaaaaAtattaaaTTATattttTAt	C:?B:AABBBGBFEFFEEFEFFEFFFFEFFFEFFFFEFEEEFEFFFFFFFFF@FGFFFEEFCEEEEFFFFGFFE?FEFFEFFEFF;GFEFDFFFFGEFEEFF>DFFFFFFFGFFFFDEEFCFEEEEGFFFEGEFGFFGFFFF@EFEFEGEFDFGFEFFGAFGGFFFFFEEFFFEEGFDECGEEGDEEFDGFEGGGEHGAEFFFGEDGGFGFFFEEDEGFFEGEGFFFEDDFGEEGFDEEEEGF=GDDGFFGEFEEADBAA>?CAA	T	137	A	128
11	44296828	C	38	TTTcCTTTCTTTCTCTTCTCCttTCCCCCTtCTTTCTT	GGGDDFGFCDAGDFCFFCFCC>GFC=CCCFEACCAADC	T	23	C	15
11	44331509	C	160	cCGCGcCGGCgggCGCCGcgggccGGCcgccgcgCcccgCGGgGGcCcgCCGccGGGGGGGgccgccggGcgGcCcCcGCCCCGgggGCGGgGGccCCggGgCcccggccCgcgGCCgggcgccCGgcCgCcCCgGGgggCGGCcgcGGggGcggccgcg	A<=?=CCB<BFFFDC@:CAFFCFFCCDFDFCCFFEFFFFECCFCCFDFFDDCFFCCCC><CFFFFGGGGCGGCGCGCGCDDDDCGDFCDCCFCCGGCDGGBG8;GGGGGGCDGFBCCGGGGGGGCBFGCDCGCCGBBGGGCBBCGGFBBGDAAEBAAB?D	G	84	C	76
11	44639921	C	28	cccttcttcctctttcctttcccctttt	A@>HFBGFB>GBGGGBBGHG9BB;FGHA	T	15	C	13
11	44959083	C	36	CGGCcGcGCccCcgggcCcGgCCGGggcCcggCggC	@BCDGCGCDFGDGFFF@DHBGDDCBDG;C@HECGGB	C	19	G	17
11	44959924	G	65	gAaaggaaaaGGaGaaaGaaagAaAaAGGggggaAAAgaAaagggAaAaaAgGAgGaGAaggGAg	AAEGBCFEFFEDFDFFFEF<FCEFFFFEDD>DDFEFEDGDGGDCDEGEGGEDDEDDGDEGDDCD<	A	38	G	27
11	47857253	T	178	TTcCCCcTTCTTTCTTCCtTTCCcTCcCtCccCTCCCtCTcCCtcCtcCccCCCctcTTCTcCTcTTTccTTCcCtCcCcttCtTCTTCTccTCTtccCtcTCTTtCctTTtTttttTCCtcctcCTTcttCcTCctcTCTCcCTccTtTCTttTCTCcTcTCTTtCCTcCCCCTCCc	B>?:BB?DEEE>FFFDFFGF;BFBAFBGGEBBGFGFEGHEAGGGBGGBEBBEFFCHB@FGEBGECF7ECCEDFAGHECFBHHFHFFEDGFCCBGFHCCGHCEFBFG7;H:EHFHHHCEFFHCCHCFEECHGECEFCF>EDEFBEECCCHDFEHGDEEFCDCDEEEGFFE?CCBC:>B@	C	97	T	81
11	48186104	C	43	cAaccCccccaaacaccaaacCcccccacCcaacacaaccccc	AC?AB@DDDCCBCEDCCDDECCCCDDDEDDDEADDDBCBA;DA	C	28	A	15
11	48238455	G	80	aGGgaGgaGAgAggAAGGGAgGGAaGGGGAAaGAagAgGAGGAGgAGGagAgaggGaGaaGAAagagaaGGgggAGgaAG	C?;EFCFECHFHFFHEDCCHFCCHFCBCCHGGCHGGHFCHC6GCGGBBGGGDFFGBGBG<BGGGGGGGG@?DBA;=:?AC	G	46	A	34
11	48285856	C	251	CCtcTTttCTcCTTtcCCcTTCTCCCTTcctccCttctTTttCctctCTTTCTCTCctCTtctccCCTtTCtCCTCttcTcCCctccCTccCTTtcTCCTttttctTCTtcCctTttcctttCTCccccCCTttttTcccCtTcttTTCtctTTtcttcctTccCcCTCCcTctCttTCTCTCCtCccctCttccTtTTCttcTTTCtCCTCctCctTCtccTtcCtCtccctTTTTTTtcccCTctctCC	@7CC>=@CB?:CBC5@FECEEGFGEGFEBBG>AEGGBGEFGGGBGBGFFFEEFGFFBGGEGB<BBGF5G:GFGGEFGB9?BCFBGB9GE@BEBFHC7BGFHGGFCDFFEHCGBGFHH:CBHGF;FCCC=AGFHHHHECCCFHFBHHEBGHCHF;FCGHC=HFCCEC=EEF=FCHEHGEFED?EEHECCCHFHCCCDGEEF;GCE9EFHFFEECFFCHEEECCEHCFHFHCCBHBEFCDDE?<?AA=>=CA?	T	127	C	124
11	48286231	T	111	tTTtTAAtaTTaATtatTTtaaaAAaatAtataTttAATaaAAttAAAaAatTTtAaaAATTtAtttTaAAtatTatAAAtTaaaaAtTTaAatTTtAatAtttatatAAt	?@=7DBACDGGDFGDDDGGBDDDFDDDDFDCCEGDDFEGD8FFDDFFFEFEBGGEFEBFFGEEFEEEGEFFEDEFEEEEEEFEE<EEAFFFEEEFFEEEEEEEEE>??A@@	A	57	T	54
11	48367073	A	180	cACCAccAcAaCacAaAcaCCACACaAaaccACAcACAAaaAcACcaAACcCccaCaCCaaAcaaCAcAAacCACcCAACCcAaAcACcaccaAcaCccaaAaCAcaaACacccaCcacCCaACAcaCcAACACAcAcaCCCCcaAAaCCCacCAcACACacAACCACCAAAccAACCCc	C>B<>EFFGFDG6FFAF5DGFFGFEDFDDGGFGBGFFFFD<FGBGCDFFGDGHGDFDGGEDFH8CDFHEEEHFFFHGFFGGGFEFHFGHEHBEFHDAHHEE>EFDHEE>BDBGHEFHEHFFEDGEHEFHDEFDFEHEHFFFFFHEEEEFFDEGFEGEBEEEHDEFEDFEFEEGCBBAC?=	C	92	A	88
11	55111584	A	37	TATaatttAAattAtaaaaaatAtttaTTatTaTata	B=AFFGGGEFFDGFGFFFFGFHEHGHFFGGHFGFGFF	A	19	T	18
11	55541284	G	367	AGgAaaaAGGGGGgGaaaGGAGaggaagGaagagaAAGgAaagaggaAgagGAGAagGagagaGagAAagAAgggGAGgaGaAGGAAgGGggAGaagaAAGgaaagGGAgGAGGaaaaAGAggggAgggAAAaAAggAGaaagGaggAGGaggagggaggGGAAGggaGGaggagAAGagAGGAAaaaAAGGgaagagAAGGggAggGagGGgggAGAGAggGGGaGGaaGAAggGGgGAAgaAaGgaGgagagGGGAAgaAaAagGaAaaagGAgAGAgGAaaAggAGaaAgGgaaaGAAAgagAggggGAgaaaggGGaaggGAGGGaAgaagggaAaaaaggGGggAgaaAagaaaagaggGaa	E9CACBAB>;<>9C@CCEB?FBFCEEFECEFFFFEFHADHFFEFFFFHFFFCH:EFFCDFDFFBDFHHF>FGFFF>HBFFCDHB@BHF69FFHCFFFFII6FECFFCCGF@HCCFGFEHCCF>FFHFFFBHHFCHFFHCGFFFCGEEH;BGFFGFFEGFGCCHBCGGG@BGGGGGGGCGEHCCHHGGGHH8CGGGGGEHHCBGGHGGCGGACGGFHBHCHGGC>CGCC<GCHHGFCCGCHBGGHGAGGBGGGFGCB@<FGGGGGGGBGGGGDGBGGHCGEBGGEGEGGAGHFDBGGGFBGGDGGGGGGGABGGGGEEFABGGGGBGBBBGGGGFAGGGEGGEGGFAAEFHECBC=A@@@BB??9?DB	G	191	A	176
11	55606208	G	34	AAAGAAGaAGGGAAAAAAGAGGAAGGAAAAAGgG	HHHCHHBGHBCCGHGHGGBGBBGGB>GGGGF?>>	A	21	G	13
11	56185159	A	174	GGAagGAAAAAAgGAgAAGaAAAAgaggaaggAGaGGaaaGGGAgGGgaaaGgaGAAgGAggaAGGGgGgAaAaGAgaaGaGaGAAAaGaaggGaGggaAaaaGAGaAAgGAGaggGagAgAGGAGaaaGAGGAAggAGGGggAaaGgAggagAAAaGgaAGAgGAaagGGaGg	D?:?@BBDEFFEBGFCFFFFFFFBCFCCFBCCFGFGGFFFHGFFCGFCFF;GCFGFDCGFDAFFFGGDADEFFGFFDGGFGFGFFFFGGGFCDGEGCCGFDGGEDFEEEDFEFGDDFGDEDEFFBFGFGFEFFEEDCEFEFDDEGGCCEDDGCEDDFEACCCC>C7AB;?CB?A	A	88	G	86
11	56216601	C	40	aaAacAaaaaccacaCCccaCCCAaAaaCACCcCaCccCC	CDDFEEFF;FFFFF@GGGFGG8GDGDFGFDFDGFGGEFDB	C	21	A	19
11	56344260	A	143	AAAGAAaaGGAaaaAAAAGAAAAAGaaAAaAGAaaAAAAAAAagAAAaGAAGAgAAaAGGgaGGGGgGgaAGGagaGGggAagGGGGAGaaaAAAAAaagAgaaggaaGaaGgagagAAGagAagaaaagAgaaaaagagagg	BBDF>EFFGGFFFFFEEFGFFFFFGEFGFFF=EFFFF:FFFFFFFFEFGFFGFGFFGEGGGGGGGGGFGFEGGFGGGFGGEFGFFGFEGGGGEEEEEGGDEGGGGGGCFGGFGGGAGEEEGGDGGFGGEDDEFFEFEEEDB?D	A	92	G	51
11	56468044	T	38	TttgggtttTTgTggTTtTtttTGtGTTGtttttGttt	?DDCFFDEEEEFFFFEEEDFFFEHFHCDGGGFCEGF?C	T	28	G	10
11	56468047	A	39	AaaAgggaaaAAgAggAAaAaaaAGaGGAAGaaaaGaaa	CEFEFFFFFFFHFHFFFHFHGGFDAFC=6GBFB?GBGEB	A	28	G	11
11	57157405	A	102	AgaGGaaGAAAaaAAGAGAaggAAAAGGgagGaaGAGAaAGGAgAagaGaGGAGAGGAAAGggAAgGAggGgGAaGaGaagaGaaAGAaaAagaAGgaGggg	A?CACFEGFEFFFFFAFGFFCCFEFFGGCFCGFGGFGFFFGFEDEGDGGGGGFGFGFEEE?DDEEDFEDDFDFDGFFEGGDGFGD7CEFGDF@EDD<@?=?A	A	55	G	47
11	57176628	C	63	TTCTTTTTTTTTtTTTTTCCCTTTtCCTTCCtTCCTCcCcTCCttCtCTCtCtTttccCcTCt	D@8=GGGGGEGGEG@GFG=DDGGGFDCGGDCEGCCFCECECCCFGCFCFCFCFFFF<EBBCAB	T	38	C	25
11	57313469	C	56	cccGGCgcGCgGgcCCGcCggGGGCggCCCCgccCcccgcGcccCCcGCcCGcCgG	AC?;;?BACDCACBDD?BDCCCCCDDD@DCDDCCDABCD@BCCBDCC?CCCBAC?A	C	34	G	22
11	57556673	T	36	ataattttaataaAaTtatTtataataatttatatt	@CCDDDDDCDDCDDDDADDEDDDDEEEEEEECECDC	T	19	A	17
11	57798942	A	302	GgGAAGGGaAGGGaagGggAGAgAAGGGAaaaGAgAGGGAGaaAAAGGGAggGAgaGAggGAAgAAGAgaaGGGGGGGaGgAgAgAGGGAaggaGGAGaaGGagaGGAGGggaAAAggAGAGAAGGGagagagAagAgAGGaaggGgaaGaGGaGGGaAGGGagagggAgAGAgagAagggGgGAGGagaaAAAAggGGagGAgagaGGAAAGAAAAGGggaGggGAGAagGAGggaGGGaaagaAaGGGgaagAAaaaaAaGAAggagaAAAGgaaggGAaAAaGAagAAAggaAgaGgag	DCB?9>>ABBDDDCDDFFGDHDFCCHHFCFFFHEFEGHEEHFFECDHHHEFFHEFEH@FFGEEFEFHDFCEHHHAH;HGHFEF@FEHHAEFAG;HGEHGFGHFFFH:EHHGGEDEEDGEHEEBBHGGEGGGDGEGG?GEHHGFGGHGFG9GHHGHHH=EHHHGGGFFFEGEHDGGGEEGGGG>FEGGGGGGDDDDGGHHGGGDGGGGGGEDDGDDDDGGGGFFGHGDGDFDGCGGGGGGGFGEGGCFGGFGGGGDDGGGGDAGDDGGGGFDDDFGEGGGCCFDDF@CCDAAB>AA=B?C@?A	G	161	A	141
11	57958497	T	182	TcTtccCCtcCTcttcCTtCTTTTTcttTCtCCTCTccctcTCTCTTTTtCTtCCTCCCTTTTTCcCTCCTTTTTCctTCcCTccTTTccctTCtCtcttCCTTTTTTctcCCCTcccTtCctCtctttcCtTtTtCttTtCCCCTctTCccTcCCTCTCCtCttCTctCCccTTcctCttc	BCAC>?<>E@>CBFGA?GGDGGGGGBAGDDGDBGDG?BBGBGDGDGGGGGDGFCDGDDDGGGG@DCDGDDBGGGFC?=GDBDGCCFEGB@@HGDHDGCHHCCFFFFFFCH>@CCFD@BFHC@HCHCHHHCCHFHFCCHHFHCCCCFCGFCCCFBCCFCFCCCBHHBEBGCA==CC7>@AED@	T	94	C	88
11	57996084	G	100	gAGGAGGGGGGGGAgAagGgGAGAGaAGGAGAGAGaagaAGGAGaGGgGAgaAggAaaGAGGggaGaAggAggGAGagGagaggggGgaaagaGAAggga	?:BD=HHHAHFHHEFEFFHBHEHEHGEHGEHDHEHGGDE?AGCHGGHGGEEFEGGCGFGAGGGGGFGDCGDGGGCGGGGGAGGEGGGGEGGGFGEDC>8@	G	60	A	40
11	58125620	T	115	TCTCTCCCTTCTTTCTTCCTTTCtTTCTTTTCtCCCTTCCCcTTTTCctTttCCCCtTTTTtTCtCCTTCcCTTTTCTccCtCCCttTCtTCCCCcCTTttTCTCCcctcctttC	DGGGGGBGGGG=GGGGGGGFGGGDGGEGGG?GEGGGGGGGGHGFEGGHEGEEGFFFCFFGFEFDFFFFFFHFFFEEFFFHFEFDFEEFFEFFFEEHEFEEEFEEEFGBDFGD?=@	T	62	C	53
11	58126305	A	82	AtATtAaaaAAtAAaATaAattaTTAttTtTtTatTaAAttatatttaAaAaatTtTttaaaaaTatATATTTAAAtaATAt	CC?ACEDDDFFDFFDDGDEDDDCGGFCDGDFDGECG@FEECEDD?EEEEEEEDDGEFE:E=EDEFECEFEEFFEDE5EDA?B	A	43	T	39
11	59573980	C	121	tctccTtcTttCTtctCCTTTttCCtTTTtCttcCctTCcCtctTTtctcctctCCTTTcTctTCctcCTTtCtCtTCccCctTcCctTTtcCTtCTttcCCttCTCCtcccTTCccTctt	A@B:>?>@ADEEDEAGGGEEDGGGEGEEDGEGGBEBECGB>GBGEDHCFCCHCAGGDEEC>CHDGCHCGDEFFHFHEFCCFCHDCFCHDDHCFDAFDHGCFFHHFDFFHCCCDCB>:B7BE	T	65	C	56
11	59831716	C	101	CCCcAaCcAACCCCCCCcAAAACCCCaCAcAcAACAaAACAcCACCCAAACCcACAACCACAacAaACCCCaAccAAaCcaAaACaAAAAAAAccaCCacc	BBGDCDGCEEGEFGFGHDEEEEGG>CDGDEDEEEGEFEEGEEGDGGGDDEEFEEFDDFFDFDFDDF=FFFFFDCDDDFDCEDEDFFCCCCDCBD@DBAA>@	C	51	A	50
11	60271325	A	61	ACAcacCaAACCacacacAAacaccaccccAacaaaaccaccaAaCaaccCAAcaccccaa	@BBFFFGFEDGGFFDFFF@FE?FFGFGFFFDFGGFFGFGGGGGEGGGGFGEDDGGGCGFGF	A	31	C	30
11	60531346	T	35	GtGGtGgTtgTTGGggtgtGgttgtgGgTTGTgGG	<B=;GCCGACGDCCDDGDHCDHGDHDBDEEAE@??	G	21	T	14
11	60638753	C	77	ccccAaacccAaACaaACacaacaCCCCAaAccAacCaACaaACCAaCCcaaaCaAAcaccacccCAcaAAaccacc	@@@B:FEDDDFDFGEEFFEDDD<EG6GGFEDEDFFEGFFFFDEGE@FFFE=FFEFEFEEEEDECEFEEFEEFEEFBE	A	39	C	38
11	60642325	G	183	GGAGAAGAAAGGAAGGGGGGGGGGAAAGGGGAGGGGGGAGGGGAAAGGGGGGAAgGgGAGAGGaAGAGAgaGGggGAggAGAAGGGGAAGAAGGaAgAAGGGAGgGAAGAGGgAGaAaAAGgGgggAgagaGAaaggaGggGGAAGggggaAAAAGaagAGAaGAgaaAAaaGgAGAAAagag	;=CBGHCHHBCCHHC;CB>C@C>CHHH@CCCHCC<CBCHCCCCHHHC?CCCCHHDCDCHCHCAGDCHCHDGBBDDAHDDGAGGB:ABFGCHGBBGGDCG<BBGBDBGGBFBBEGBGGGGGBDBDDDGDGDHBGFBDDGBDDBBGGBCCDDGGGGGBEE@EADC?E??AD@@@:?AACC?D@CA	G	104	A	79
11	60701136	C	64	CgggGCcGGGCGGGGCGGCCGGgcCgCcCgCGCCCgGgCgcgCGCGCgGgCGcCcCCCGCCCCg	A=DDBDDCC9>;CCC@CCD8BBGEDFDCCGDCDCDF<FCGEFCBCBCGBGCBECDCCBBBC==;	C	32	G	32
11	60785038	A	84	GAaGAAGGAAAGAaagaagGgAAgAGGgggGAaAAGaGGAGgagGGggaaggAGAgaaGgaGGAgaggaaAGaAaAAaGGgggA	BCC?BDDDFFEEFDDF<DFDDFFFFFFCFFEEDFFEDEEEDGCGEEGGEEGGFEFGEEEGDDDEGEGGEDEDDEEEEEDDCCCA	G	43	A	41
11	60785352	A	69	gggAgaaaaggaGGgAgAaAggagAGgAGGGgAAaAgGAgGgaaGgaaGagAGaGgggGAgggggaggg	AA>A8DEDEBCECCCHCBFHCCFCF>CHCCBCHHGGDCCDBDGGCC5GC=8HCGBDDDBGDDBDDGDDB	G	42	A	27
11	60886913	C	119	TttTttCCcccCCtccttCTtCccTCtTctCTctCtcttcTccCCTTCCcCtcTtTCTCcTtcCcTCctTcctcCCcCtcTTCtttttcCCCttTtCtcTCccttTCTTTctttTTTtC	CC?BA@>@GFFD?DGGDDCGDDG?GDDGGDDFGDDEGDBHGHHDDGFCCHAEHFBGDGDHFEHDGFDGDFHGDHCDHBEHFFCEDDEEH@BCCEFECEHFC>HEEFCEFEHEB=CBC@A	T	61	C	58
11	60893235	C	194	CcTCtCCTttCtTTccCTcTCtCccTTTCtCCcccttTCtCTTcTTTCctcTTCTttcCccTTCTtcTCtCTcCCCtTCCCtTCctCCcTCCTTCcCcttctCTTTtTTctTctccctTCcCccttctttTTCTTtttcTcTtTtcctttCTcccTttctcttCtttctctttTtccTttttcccTctccttcc	D?A@CD?BFEBDEFBFFDFFFEGFF;EFFEGFFFFEEFFEG@GFFEFGFEFFFBCEEEFFFFBFFFGFFEFFGG?EEFFF9EFFGFFFGEFFFEFGAGF<GF6CFDFFFG@FFEGGG7FGGFGGFFGFEFFBDF;FFFGEGEFE:GGFBFFDFBHEFFGFGFEEFFFGFGEFFEFGGEFFFEGFGDG9FFDA@>	T	104	C	90
11	60899815	A	49	tAtaTAaTattattAtTaTtTTtaaTTAttATtaATATAAATAtatAaa	A@DDCFEEEEEEEEFEEE5DF:A;DFFFABA=<;DEDEDEEBEB?9D<=	T	26	A	23
11	61730036	G	71	GAaaGaaaGaAagagAAagaAgggagaaggGAggaggaAAgAgGAggAAaggGAaAGAaggaGagAAaAGa	7@8CBEEECDHEEEFHEE6EHFEDEGEEGGCHFFFFFFGGGHEBGGFHGFGFBF@GBGFFFFBFFH@:BCA	A	40	G	31
11	62365665	G	27	aaagaGaggagaaggaaaagaGaAAAA	CAECG;ECCFCFFADGFFFDFCG>GFF	A	18	G	9
11	62378801	T	58	TTTtTCcTTccCctttccTCtTttttTtcCTTTCTCcCtCTTtTtCctCCctCTTTcc	;BFFGDBGEBBDBGGBBBGDGGGHGHGHCDEGGDGDCCHCFFCFFCBFCCAHCGGF>;	T	34	C	24
11	62381808	G	151	gccCCgccgGGgcGGGCgCcgcCGGggGgGccCCCCGgGCggggCgCcCgGCCCGgggCCgCccCGGCGGCCcgGCGGgCCccGcCCCGCCGGGCCgGgGgGcGgcCCccgGCgCGCgCCgCcgcCcgGCgCccCcCCgGcgcGCGcCcgG	AC@>?BCCCCEDC;E>GFFDED@EEFFEEBDDFEGGEG?FEFEEEEGDFEE66ADEB7GGF=EE6EEEDEDGEFEEEEFEDEDEBFEFCFFEDDEEDDGDFDEDGEEEEEGDFGFDE@6FGFCEDEEFDEGDEDDEDEFE@@<BBB=>@>?	C	79	G	72
11	62400016	T	46	cTTTCcCCTCCTCtCTCCCcTccTcCTcCCtCtccttctcCctTCc	ABEEGDGEEBGEGEGEGEGEEDCCEFDEFFGFFEEFFEFDFEFDED	C	29	T	17
11	62414017	G	96	AgAagAgAAAGAGGGaGGAGgAGaaaGGagaAAAAaaaAGGaaAaAAgGaAgAGGaggAAAAGgAgGGGAaAAgAaaGAGAGGAaAgaGGAAAgAg	BCAAFEEFFFGFFGG@FGFGFFGDCDDGDFDFFFFEEEBC@EEFEFEGF;EGEFFEGGEEEEFEEGFFFEEEDEDCEFECEBGFCDC?BB?9BBC?	A	56	G	40
11	62438819	G	43	gGTTTggtTttTttgTttgtGtttggtttGgtttgtTGTgttg	C>?AFEFEGEEGEEDFEEF?CFFDEFFEEBG<EAFEFAFGDA@	T	28	G	15
11	62521475	T	274	CCTCTTTCTTCcTTTTctTCTCCTCCTCTTTTTTtTTtTtTCTTTTTCCCTCTCCCTCCCTTTTCTTCTCTTCTttTTTCCCCtcCTTcCTTTtTCCCCTTCtCCccCTtCtttTTtCtTCTCCTcTTctTCTTCCTTTctCcTTTctCtttCcccTCTTTtCTTccTTTtCtcCCCcTTctCCtcCCTtcCTCCCttTCTCCcTCtctctcCCCttcTCCtcCCCTTCtttTTCTCTcccTCTTTttttcctttTCtctcTtCcTtctctCCt	D<=BAAC;DDDCEEEECEEGEGGEGGEGEEDEEEEECDEEEGEECEEG?<DEEGGGEGGGEEEEGEEGEGDEGDFFEEEFFDFEEGEEEFEEDFEGGGGEEGFGGEEGEFGDEFEEEGFEGEFEEEDDEFDGDDFGDEEEFGEDDDEAFEFFFE9EDFDD@FFDDE@EDDFFEEFFFEDCEFFF@CFFDFEFDF@FFFDFDFFEDFEEEDEEFFFBFDDFFFEFFFDCFDFDDDFCDC=EEDFDDCFFEFEEE?@ECCDEDD?>@9A=<8?@@B	T	152	C	122
11	62761161	C	220	TtTcctCTTTtcTCCTTtTcttTTcTTTccCtTCcCCtttttcTTCCCcCTCCTTCCCCttCCtCtTttCTcTTTTccCcttTttTCctCccccccTCCCCtcCCttcCTcTccctTTTctCtccttTTcCCttTCCtTtcccccTctTTCccctCctTCTCcttttctTTctcCTtctctttTTttcttCCCccccctctttcCtTTTcTtctttTcTT	@CACBC?BB@BBA@ACDDFGEEFGFGGGFFDEGEFDDEEEEEFGGCCDFDGDDGGDDDDEEDDEDEGEEDDFGGGGEFDFEAEEEDDFDDFEB=FFDDDDDDFCCFEG@GGFGGGFGGGGFDFGCFFGGFDCFFGDCFGFGGGGFGGFGFCGGGDCGFFCFCCFFFFGBFFFEGCCCGFEEFFFFFFGFE?CCGGGGGFGEFFGCFFFEGEDF@DDEDDA	T	117	C	103
11	62951221	C	154	GCgCcCcggggcggCgggGccCCccccCggGgcGcgGgcGCcGgcGCcCGcccggCccCggcCcCcCcGGgGCGcCGgGGcGcCgGgCcGGcggcgccCcGCgcGgcccccGgcGgccCcgCcGGCcCGcGCcCgcgCcGCgCcgCggCGCgCC	A>CAC<DDCCGFEFEFFFHEEGGFFFFGFFHFFFFFGFFHGFHFFHGEGHFFFFFFFFGFFFGFGF>FHHFGGHGGGFHGG@GGGHGFGHHGGGGGGGGFGAGGHDGGG9GGGGGGGFFGGFGGGFGFGGGFGFGGGEFGECF5GEGEEEB@@?	C	85	G	69
11	63767249	C	28	cTTttCcCTctCTcCtcttttcccccct	?FEGFGBGGBGG@BGGBHHHHCCCCA>A	C	15	T	13
11	63978534	C	37	CcTcTttTcTTCCttCttTCtCtTCTctTTctttCTc	GDGDGEFGEGGGGFFGEFGGEF<FFED@FFBEFFFF?	T	23	C	14
11	63979162	C	44	CCTCCTTTTTTCccTCCCcCTCCTCtCCctTtcTTtCtcCtCTT	CDGDDGGGFFFDCCGDDCCD>D8FCHACCBFHCFFHCHCCH<FC	C	23	T	21
11	63993287	C	81	CCTTttTTCTTTTCCCcCTTCTCTTTcTCCTtcCCTTtTTTTtTTcCTCTTCTTcCccCCtttTcttccCtCTTTtTctTt	=>CF7EGGCGFGHDDD@DGGDGD<GGEGCDGBEDDGGEGGEF>FFECFCFFCFFEC@DCAEBECCFEEECDCFF;;E@>C<	T	49	C	32
11	64026219	C	136	ccctcctCCcCctCCTctCtCctcccccTcTtTCcTCtctttCcCtCcccTTtTTctcttCtttTtcCcccTttttccTctcccccTctttCTcttcCttTtctCccctcTtcctccTCcccTttcTttCttCcTc	C?CCCCB>8=@@FBCEBHCGD@FAABAAGBFGGDBGDGBGGGDBDGDBBBCGGGGBGBGGDHGGFGBDCCBFGHGGBCFCHBCCCBGCHHHDGCHDCDAFG?BHCCCCHCFHCCHCCFCC@<FHHCFGHBHHB>A<	C	73	T	63
11	64085063	G	162	CCCGcgccCGCCcCCGCCGccGgGCccgcCCGCccgCCGgcGCcCCccGCcCCgCccgGGCcCgcGGCggccgcgCGcGCgggccccGcggCcggCGGcggcccccCgggcgcCcgcgCccgggcggggGccCcgcCggggccgcgcgcgggcgcccgcccc	AAA><A>?>=@C:BDBD@BBACC@DABCBCCCCBBCDDCCBCDBDDBBCDBBDCEBBCCBD<DCBCBDCCBBCBCDCBCDDCCCBBBC@DDD<CDABCCDDCCCCCCDDDCACDCBCCDBBDDDBD5DDC=CC@DCC?ADDCCDCDADCDDDCDCCBDA>>;	C	95	G	67
11	64110668	G	27	GGGGGGAAGAAGGGAAggAAGAAGGGA	DCCABCHHCHHBBBGGDDGG@FGB@9@	G	16	A	11
11	64111928	T	58	CTctTcctccTTTTTtccCtcCCttTTtCttCttTttctTCcccCCCTcCTCTTttCt	AB>>FBBGBBEGEGHG?B@GBD9;HEGGDHGDHDGHGBHGDCBCCCAFC@ECFEH>A<	T	32	C	26
11	64559808	G	34	agCaCCgAggaggggggCagaggGagggggaAaa	?B9DCBE<GGFGFGE?G@FCFEG6?EGGGBCBA>	G	19	A	11
11	64833935	G	99	AgGAGAGGAagAGGaGGGgAgAAGgaAGAgaagaAggAaaaAGAgGgGGAGgggAGagGGggGGGAGgAAAGagGgGAAaGggaaGaGgaAAGAgGaag	@CE8DFD:FFCFEFEBEEDFCFFE=FBEDDGECFFDDFGGF@=ADCDEEFDDDDEDGDD<DDDDD9DD<BEDHEDDE=EGDDDGFDGC@FE@=@>A<CA	G	56	A	43
11	64977937	A	83	AaggggagaaaggAGgaGgagAagaggGaagaGGaggggGgaAGGGGaaAAaGGagAgGgGaggggggAggagaggggggggg	<?@ABBA?BCEFFFGCDGFDEFEFEEEEEE6BCGDEEFFEFEEGG;GEFBF;GFFAFEGFG<GFFGGFEFFFGEGFFBGEBB>	G	54	A	29
11	65384727	C	89	TCTcCTCCtTTTCCTTTCTCTCCcCTctCTCCTTTtTcttCCTTTTCttcTcCtCtTCTTCCTctTTCTTCCtTTccTcttTctCCTCC	<DGBDFDCGGGGDDGDCDGDGCCCCGCHDGDDGGEH<CCHDAGFFFCHHCDBCEBHFCFFCCFAHEFBEFBAGFFCBE<C?F@DB@AC?	T	49	C	40
11	65480090	G	56	TtGTTGtgTTggGttggtTtGGgtggtggtgTGgttgTggTgTtTTGggTTTttGT	<@CGGGFCGGCCFGGCCGEGFGCGCCGCCHDFFDGEDBDDFBFHAFFDDFFEGFDC	T	30	G	26
11	65480768	A	34	gAAaaGGGAGaaAAGAGGgAAAGGAGGGAAAGGA	BHHF>CCCH@8FGFBGBBFGGGBBGBBBGFE@8A	A	18	G	16
11	65650883	A	107	gaAgAAAAGgaAAAaGAggGGgGgaaggAgGaGGgAaagaAggGaaGagGAGGGaAGaagGAaaGagggAAAgggGAaAAGGgGGAgGgAAggGagaaGGGGGAAaG	C?<A>A@ACGFEEDFEEFFEGFDFFEEFFFGFGGFFFFGE7CGGEGFGGFFGFGGFGGFDGFEGGEGGGDEE@DCFDCEEFFGFFEFFAEEGDFGG8BFFEEDCA9A	G	58	A	49
11	65652678	T	40	ttttttTttTTTTTTTTTTTTTTTgTTtgggggggggggg	C@7DECDFFEEFFFFFFFFAFFEC>EE;@D@D?D9DAC@:	T	27	G	13
11	65652684	T	34	tTttTTTTTTTTTTTTTTTTTTtTttggggttgg	C:BB><FEFFFAFEFBFFDFDE@DCFC:>?;=9?	T	28	G	6
11	65732800	T	84	TCtTtTTTcctTTCCTCTTCTCCTttTTCtCCCCcCccCtttCTTcctTtCccccctcTttTccCcTtcCtctTCccTTTtTcC	8BCDEEEEEEDEEEGEGDFGEGGEEEEEGEGFGEGGGGEEFFEEE>FFDFGGGGBGFGDFFDGFFGDFGFFGF@FEGDDC@C=?	T	43	C	41
11	65811208	G	42	gTgtTGgtggggTtgTttgTttgtgTtggtgtgtgGggtttt	B@CFEHD7FFEF;EFE>EDEEEGCEE@GFEFEFFFHGG>F?@	T	22	G	20
11	66052832	C	42	CCCCCCCcGCCCCGcGCcGCCcccGcCccgcgGgGcCCGGcc	AD@E>DDDCDDDCCECCDBDCEEECDCEEGEEBG:ECBAAC9	C	30	G	12
11	66083782	G	128	AGaGAAAggaAAAAGgGgaGaaggGAGgAgAaagGAggGagaGGAAGAggGAGGAaAaaaGgaAGggGagGAgAAaggaAGGaaGgAAaaggaGgggGgaAaAagaGGGgagaaGaGaGAaggGaaGg	C@C<=?BABCACHGCFCEDCFDFF@HCFFFHEFFCHFFBFFCCB>HCGFFCH?CHFHGFFCEFHCG@CEGCHGHHFDGG9CAGFBEHGGDGGGB>GGBGGGFGGFG@BBGEGGFBGBDBGGFFBCC>A	G	66	A	62
11	66105817	C	25	ttttccCtcctTcttTctcCtTTtC	?ADEDCGEDDEGDEEGEFEBFFFEC	T	15	C	10
11	66325484	T	395	TCCcctcctCTTTcCCTCCctTttcCCtctTTccCCTtcCtttTctCCTCTCTTccCtTCCTCTccTTtcTTTcctCCCtttCcTtttttCTcttcCTTTTTTcCCCtttttCTTTTcTTTCttCtctTCTccTcTTccttcttttctTCTTtttCctttcTTTCttcCTtcTcttttCTcTCtctctttTCTttttcTTTTtcttctCTCCTCTcCTTCttctCcccTTtttTTCTcCttTCctttccTTTtCTttCttccCctcTTtcttttTCcCctCCtccCtTtccCCCTCtCctttcCTcccCccccttTCtcccCCtctttcTTcctTtcCCTTCtcccttttcttcctctctCCcctttttctcTctCcTtcTtcCcccTctttcct	CAACCAA???BB==>>?<85DBDD?@@E@FEFBBCBFGBBFGFGB9DDFDG?GG9BDGGDDGDF:BEG:BGGFBBGDDDGG=DBG:B?GGBGBGGBDGFHGEGA@DEGEFGGDGGGGAGGGDGGDGBGBDGBBGBGGBBGABGGHGBGGDFG<GEDCHFEBGGGDGHBDGHBCAHHH9DG?GDGCHCH@HFDFHHHHCDGGGHCHH?HCGBCDDGCCFGDHHCGDCCCGGFHCGEDGCC:HGDCHGGBCGGGGDGHHDHFC<@CFCGFFACHGAFCBC6GDB@C@DCFHCA>CCFCGDCGHDCCFDBBCA9ACHEF>HAC?CCHCHHHCFDC@=FHCCCFFCHCCCHDHHCHDCCHCH@HCCC@HH>HHCECD<GBCFGAEC?A==>?;@A@>@@	T	218	C	177
11	66458696	C	27	CTCCTCTTTTCTCCTCTCCTTCCCTCC	AGD>FDFGGGDFCCF@FCCFFCCCDB?	C	15	T	12
11	67049100	T	117	tCttttttTTttttTtTtTttttttttttTtTtttTCTTttttttttttttCttCttttttttCtTtTttCTTTTtTttTTTtTttTtTTTTTTTTTtTTTTTTTtTTttTTtttTt	?:?BA=BC;8CEEB<EGE=EEEEEFEDFEG<DAFFD97BFEF9DEEFDFEEBEE@FF8FFFFF?F?F7FF8FF@6ECFEFFCFDEEEEEEEFCEFEFEFEEEEFEC@DA?BC@::C?	T	111	C	6
11	67196544	C	164	GGCCGCgCGCCCcccggGcCGCGCCCGCGGccGCCGGgggGGgCgCgCCGCGCcCgCCGGCCcGgCCCgggGcGGgcccccccgGGggGCgcCGGgcgcggggGCGCGCGccCCcCgcCGCgGcGCcCCGCggGcccgcGcccccgcCCggCGgcgGCCCCGCg	D??:ACBEFGEGEEEEEGEEGGG:GG6GFHFFF6GFGFFDGCFGFGGGAGGGGGGDGFGGGGDGFGGGGD>GFEFAFCBFGFGGFFGCFFA?;FFFFFAFCFGFGCFFFFGGFFBFFHFFFBFGFF=9FEFDGEGBFBDFF?;FFGBEFGG?>G>DC9==@AB?	C	87	G	77
11	67202044	G	155	gAgagGGaAAggGGAAgaGAggggagAaaaAaAAGaAAGGaAAGAaaaaGGagGggGaggagaaAaaagAaAGAaAgagaAGgGGaggaAaggAgAaaaagAggggggGggGggagAgaaaggggagAaaGAaAGaaaAagggagaaaggggggg	?AABA=5BCBCGAAHEEECHFDEEAEBEEEHEHHCEHHC?EHHBHDEDDCCEFBEED?FFDEDEHEDDEGEHCHEHFEEEHCFCCFFGEHFFFHFHFFFAAHGGFG@ECGGCGFDFBEFF=FGG8FG?FDBGFGBF:EGFGFFFGFFFEFGGED@	A	79	G	76
11	67205978	G	50	GGAGAaggGggaAggAgGGaagGAggGGagGgGgAAaAaGggaggaggAg	DEFEEFCCECCFECCECEEFFCEFD<DDE9ECEDFFGEGDDDGDDGCDBA	G	32	A	18
11	67351585	C	82	CCCCCCCCCCCCGGCCGGcGCCGccGccGGCGGGCGcGCcCgGccCcgCCcGGGGCGCCCcGGCcCCCcggGGcGcgGCCgg	@GGFGGGDGDGGGGGGFGGFGEGEGGGFGFFFFFFFGFFGAGFGGFGGFDGFFFFFFFFFFFFFGFFFA?FFDCD>?AACDA	C	49	G	33
11	67353844	C	160	CTcTTCTCTCTTTTTTccCCCttcCcccTTCccTCCTTTCCtctTCcTTCCcTCTTTTCCCCTCctcTtCcTCtccTCTcCCcTctTcCCctTCCCTCcCtctTttCttCtcccTctCTTtCCCTCctctctttCtCTccTtctcccTTCttcCCcttTc	D>A>ACBDDEEDDEEFDDGGFEEDGCDCEEFDDFFAFFDBEEEFEFEFBFEEEFFFEBEEE=DGEF5F<GDC=FEEFFEEGFEEEFEAEEEFFFEFEEEFFEEEFFFCFF?EDEDCFDE?FFEFEECEDFEFFFECEDEDEEEDEDDEDC>@?BA@A<CB	C	86	T	74
11	67374581	T	50	CccTtttcCttcttctcCttcTcctTtctcTtctttttcctcccctctcc	DCC=CEGAGFGBGGBGBGFGBCB@GEG6G<E?BGGGFHC=HCB@CHCHC9	T	26	C	24
11	67399970	C	37	CtTccctctctttCTTCttTttccTtcCCTtCTCCCT	A?ADEDDGBGDDD=AGDCDGEEHHFEHCCFCC9BBA?	T	20	C	17
11	67401635	G	65	GCcCGGCGCCCGCGGGGGGCGGCCGCCGGGCGGCCCCCCcCGcCGCGGCcgCCgCcCGCCCcGCG	>BEDCFDCDD?BDBBBCCCDCBDDCDCBBCCBBCCCCCCGCBGC@CBBCGGCCGBBCAC:CF?A>	C	37	G	28
11	67434010	C	41	tCCCtcTCTCtTTTTTTCCTTCTCTTtTCCCCTCTTtTTCT	?>BEFBFG<EDBD;B>EEFEEECEEDHEEDEDD?CCC:@AC	T	25	C	16
11	67793509	C	95	TCTtTTTCCTcCTTTTCCTCtctTCtCTTTtccccctTTtTcCttTCCcCTTCctCCTTTCCCCTTTcTCCCcCTctttcCTcTtttCtTcCTCt	BBCGFFEFC?BGFFEFFGEFGBGFGHGEFFHCBCCAHEBHFCGHBA6GCFEAECHFEDEEFDFE@DECEEEFCFECHHHCFE<EHHGEGD?CA?=	T	51	C	44
11	68030506	C	38	ctcccccttCttccCctccccttcccttctcCcctccC	C?>BBABFG=GEBB7BGBBC5GHCCCHH;HCFCCFC<F	C	26	T	12
11	68678962	T	69	TCcTCTCtCCCtTCcCtTCTCcTTTTCTCctTcTtcCTttTCTcTTTTTtCTCCCtTCCTCCCtttcTC	B;GEFEGDEGGD=GG@DEGDGHEDEEGDFHEDHDEHFDEEDFDIDDDDD?FDFFFED9FDFEDBAADCB	T	37	C	32
11	68839334	G	145	AAAGAAaAAAGGAAGAGAAAgaGGAAAGaaGAGGGGAGAGAaAGAAAGAGAAAGaAaAgaAaGAggaAGggagGaAGgAGaaAGgaggAggAAAAagAAAGGaaAGGGgggaaaaAGAGaAaAGGggGGaAGggGGGaaggGAga	@@C<EHFHHACC=HCHCHHBCFCCF6HCECCHCCB5HCHCHGD<GHHCG@GCHCGGGGDGGGBGADGGBEDGEBHEBDGBGGG;DGDDGDDEGGGFDGGGBBGGGBBBDDDHGGFGBG>GGDFBABB?@CD??>>:=BB<<C?AD	A	80	G	65
11	68853504	C	51	ttttCccccctcctcccccctctcttctccttctctctttctctccttctc	CBCEF@BABBCABFBBBBBBGBGBGGBGBBGGBGBGBGFHCHCHCCGHB9C	C	28	T	23
11	69934085	G	203	gaggGAAAggAgggGAAGGAAGAagGGGGaAGAAaAAGGAAaagAGAAAAAaGaaagAAAAAgagaaaAaAaaaAAAAaAGGGggAGAAAgaAAaaaGGGgaaaGGgGAGaGaAAAGGgagAAGgaaGaggaGGAGGgAagAGaaaagggAgagGGGaaaaaGAGggGAGagggGAaaAGgAAGgAgaaagGGGggGagaAag	A??@>B@CAAGCBBCHHCCHHC?FCCABCFH6DHFFHCCHHFFCFCH:HHHFBGFFCHHGBDCFCFEFHGHFFGHHHHGGCCB7@H@GBHDGHHGGGBBB9GGGACCCHCGCGHCHCC8GAHF@DGGCGDDG9CGBBD<G7GBGGGGDDDFEHEBBBFHEGHBGBDDBGBEBCDBBGGGBCGGBDGDGGG?BBACCBE<;B?<	A	111	G	92
11	69957917	A	55	agGAGGAgaaaAAAAagGAGAGgGaagGgagGaggAGGagggaaaggggaGagga	C<BACCBCDDDEEFFDFG6GEGC@>DEBF9DGDGGFG7EDGGCDEE9G?BEAB@9	G	30	A	25
11	70229171	G	122	GgaGGGgAAagagAgGgaAggaagGggGggGGAgaGAaGaaGGaaGaagggAgaagaagaggAAagAAagagagaAggaagagaaGaaaagaAaAaggGgggggggaagagaAaggggaagg	@?CBAAA?BEBEBCCCBEECCFFCDCCGCCEHBCFHEFHFFHHFFHFFCCCECFFCFFCFCCEEFDEDGDGDFDGEDDGGDGDGGHFG=FDCDGDG=DGDDDD7DEGG=GEGDFBDA<BB<?	G	64	A	58
11	71952356	C	29	cccccccccCcccCCCCCCCCgggggggg	CA?C=?=>CCA@@@DEDDDCC8CB<A;?<	C	21	G	8
11	72290199	G	49	agggAagAGGAAGGAGGGAAaAAGGAAAAGGAAGaGAAAGaAAAGgGGg	ECCCFFBEEDFFEEFEEDEEGEEDDEEEEDDEEDGDEDEDFEFEDA=B;	A	26	G	23
11	72295530	C	91	CaccaccaacacACCacccAcacaAcacAAaACaaaaAcCaaaaacCaAacccaAccaaaacCAaAacccAaaaCaACAAcaCCacaccCC	AC>@B6B9AACBEBCEEDDHCD@DGDEDH=EGDEEEEHDDEDEDEDDEH:EDDCEEEFFE;EDH@C;9EEGBFFCDGCGGEBCCDEFEECC	A	50	C	41
11	72316344	G	77	tTGttgTtGTTttggGtggGTtgtgtGtTGgggggtggtTtGtgtgggttgggtggttgtgttttgtttttgGtggg	A<@ABC>CB>FDDFFAEFFEFEDE;EEE<EFFFFFFFFEFEEEFDFGGEFGGGEGGFFGFFBFFFGFFFEFGCFA=E	T	39	G	38
11	72414189	G	31	aaAaGgAgaaaggaaAaagaaAaaaaaaaaG	?CCDACHCFFFCCFFHGEDGGHGDGGGGGBC	A	24	G	7
11	73575320	T	143	CCcTCCttTTTtCtccTccCctTTCCtCtCCCtTCCcTCTTTCTCTCCTtccCTCTtTTtcTTctctccCCtTCTCCCcttTtTtccTTtcTCtctCctcTTCtTttTtTtCctcTtctCttcTtcTCcTCcCTCcctTcTct	AACEEDEDF?GDGDFFGF?GFEFGGGEGEGGFECHCFGGGGGGGGGGGFFGGFGGGFGGFEGGGFGFGGFGFGGGGDGG?EGFGFGFGEFGGEFGF7GFGFFFFFFEFFFFFGFFFFGFFFFGEFGEEGEEGGGABB@?@?CC	T	75	C	68
11	73789777	T	45	TgtTggGtggTTgTtGttgggtgTttggTttgtttgttttgttgt	B=BEGFGCFF>GFGDGDDFFFDFDDDGGFEEGBCEGE<EEEEEG=	T	27	G	18
11	74022429	C	44	TTTtTCTcTtcCttctTccTcttCCtttttctCtTtTttccCCt	?DEG>GD;EGBGGHCHDCCECHGGGCHHHHCHFE=HDHHBCFCA	T	28	C	16
11	74349638	T	121	TGTGTGGTGTTGTGGTGTTGTGGTTGtTTTGTtTtGTTGGTTGGGTtTTGgGtgGggGTTgtGTTTTgTGTTTGGGtGtTTTtTGTGGTTGTGtgGtGGtgtGTGGtTTGgtTggttggtt	BEEDEG?EHEEHEHHEHDBHEHHDDHHEEEHEHEGDAEHHDEHFFEHCEHDGHDGDCGDC?HGDCDCEDGDDDGGGHGGDDDHDGDGGDDGDGHDGGGFHCHGDGGFDCF@EC>?>B>?EE	T	66	G	55
11	74429987	G	26	aggAggaGGggAGggaagaagaaggg	C@AADEEED@FFEEFFEGFEGFEGFE	G	16	A	10
11	74842207	G	49	AGAAAGAGAAAAGaGAGAaAGGGaGgAgAGAGAGagagGGGGaGaaGGa	GCHHHAHCHHHGCECH>HEHCCAEBGHGGBGBGBEGDEBBBBEBEEB>9	A	25	G	24
11	75429157	C	47	CctttCtcctttctTTccttctctctccttcctttctccttccctct	ACCC>CEDCDDEDEGGDDEBDEDEDDDDEEDDFFFEFE?FECEEFDC	T	25	C	22
11	76891585	G	42	gaaggGAgaggAGggaGaaagGggagggaagggaaaggaaaa	BCDFFBHFDFFGCFFDCDDDFCAFDFGF=EFGG=FFFDEEED	G	23	A	19
11	76894235	G	54	cccCggGggGgcccgCcgggCgggcccGcccccgCGCcgccccggggccggggG	CC?DBBFCCGCAA@CGBCCCCCCCBBBHBBBBBDGFGBDCCBCDDEEBBDDDEF	C	27	G	27
11	76918322	T	48	TTTTTCTCcTtCTTCcTTCCCCTtCTTTTTTttTCTCtcTTCCCcCTt	BGGGFDGCCGHDGGDCEGDCCCF>CFFFFFFGHFCFCHBFFCBBBBD@	T	29	C	19
11	76919468	A	79	TATTAtTTaATTTATTAATtaTTTtTAAAAtAATAATAAtATtatAAATaAAAtatTAAAatTtttTaaataAaTAAAa	?@F7FEEFBEFGGFFFFDFF@FFFFEFFEFFFFAFFEFEAEEFFDEEEEGEEEFFFEEEEFFEFF@EFFFF7ECCBA?C	A	42	T	37
11	76919619	G	34	ggaGggggaGgaggAGggggaaaaAggAgAAgaa	CC?ACCCCFCCFCCHCDCDDGGGFHDDGDGCDGE	G	20	A	14
11	76923017	G	175	GgaGGAGGgGGAGaaGAgaAAaGagagagggggGGagaaGaaAAagAAGaaaAggGGGGaGGaGgGGgaGaAaGaaGGGGGgggGGGGgGGAGAaaGgAGgaGaAagaAGggggAGAGaGgGGaaGAaAgGAaggaGAgagAaaGGGGGAGAGgggAGGgAgaggAAAgGaGAgg	BAD@=A?>?AAD?FDEFBFFFFEFCFCFCCCCCEEFCCEDFE8DFC@FEFFFCCCEBEEFDEFEDDDDGEG>G9GGDEDEEDDDEDE@DEEFEDGEEDFECGEGAGDGEDDDDDFDEDGDDDDGGDEDBDDDFDEGDECGDEGGDDDDDEDEDCD9ECCDDDGBC>CCAABAAAA	G	103	A	72
11	76944015	G	42	AAAAAAGGGGAAGGGGAAGAAAAgaGgggAaAggGAGGgAaA	BEFF=FEEEEFFEEEEFFEFFEEEFCDDDEFEDDDECECABC	A	22	G	20
11	77825275	A	103	AAAggGGaGaGAGgAGaAGAAAaGAGaaAaagGAAAggaaGGaGGGagAGgAgAaAAaaGGAGaGaAAAgAgAaGGGgaGGGaAGgGAaaGAAaaagAAaAAa	?>9A>CFCGCGFGFF5DFGEFFDGBGDDAEEGFFFFGGEEGGEGGFEGFGGFGFEFEEEEFFEEFDEEDGEGE@FFFGEFFFEEFGED??EEECDB@BA?AAB	A	60	G	43
11	77850517	C	237	ACCaAACAcaAAAACAAaaCAACAacCaaACcaCAcACAAAaCAaCAAAcAAccAaacAAACaaCACcaAcaAcccAAaaACCAaaaCCCCcacCCcAACCACACAACCaaAacAaaaAaACACCCCccAaacaaCaACacacCCcaAaCaAAaCCAAcaacaCACCaacaCcacCCAAaCaCcAAcaCaAaacaCAcacAaacaCCaccacaCaaACACaaaacaccacaAaaaAC	EAA@@B?BBCEBDGEFFDECHGDHEDDEEHEDECGDHDHHHEDGEDHHGDHEDCFEEDFHHDEEDHDDEHDEHDDDHHEEF@DBEAEDDDDEEECDEHCDAHDFDHG=DFEHFEA?FFFFGCHDDDD@EHFE9EFCFEDEEFCBDEFEFDFGGFDDGGEFF@FCGCCEFEFCEEECCGGECFCEEEEFCFGFFEEC?EFEGEFDFCCFEECE>C>CGBFCEFEFE@?@A??C=A>@@	A	139	C	98
11	82443672	C	80	cgggGcCgggCgcGgccgGggGCgCccgGcgccGGGCGCcGcgggCcgGcCcCCCggggccGGggggCggCCGGgCCgcc	?C?A7>ABCBDCBCABBCCCCCDCDBBCC>CBBCCCDBCCCCDDCDCDCCDCDCC@CD7CCBBDDDDCDDCCBBDC?C@=	G	45	C	35
11	82595975	T	74	aTaaTaATAAtTAATtTTaatTAaTTtaTTatTTAtttATAAtaattaattataAaaAaaatAtttTAttaaTa	??AB=DAA=EEEECEEEEFFEECDEDEFFBEEEEEEEFAEDEFGGEFGFEFGEFDGGEGGGFDFFEDDFFE?AD	A	37	T	37
11	85610109	G	41	CccccgGccggggcgcccGcccgcgggggggcgcgcccccg	DDEEGFGEFFFFFFFFFFCFFEFFFGFFFFDGGGDAG?GGA	C	22	G	19
11	86133784	C	127	TctcCCttcTcctccTtttctTccCCCTCTCTcCCCctccctccTTtCTtcCctTcCcCcttctTCTcCctTtCTCctTCcctctcTCcTcTTTCTccTcttctTCtcTtccCTcCCtctTCCtCCt	DCC?@AH5B@BAGBBGEGGBGGBBDDDGDGEGBDDDBGBBBGBBGGED?HCBCHGCDCDCHDBHGDGADBCFHCDDCHGDBCHC>BGCCFCFFF@FCCF6FHCHFCHCFHCCCFBBCGCGEA@CA?@	C	70	T	57
11	92702962	G	39	gGGGGAGGAAAgAAGAGGGAaGGGAAGGGAAGAAGaAGG	CEEEEFEEEEF>FED6DDDEFCDDDEDDDEEDD?DCC@B	G	22	A	17
11	93540914	T	25	ttgtggtttgttttgtgggttttgg	7CBDFDEEEFEDEEFEFGGFFFFGG	T	15	G	10
11	95569253	A	83	CCCCAAAaCACACACCAACCCAAAcACCACCACACCcAcAACCcAcAAAcACCACccaAcaCACcACaAAaaACCaCAcAAAa	B@=<FFFFGFGFGFGGFFDGGFFFCEEGFGGFDFGFCEADEFFCFCEEECEFDEFCDGECGFEFCDFGEEG9EFFGCF?C:B?	A	42	C	41
11	96116444	T	55	CTTTCTCCCCtTTTCCTCtTCCTTCCCTcTCTCTTTCTCTCCCTTTcCCcCCtcc	DGGGDGBDDDHGGDDDG>HFCBFFACCFCFCFCFFFCFCFCCCFEFCCCBDCB=@	C	30	T	25
11	99690286	T	45	GTGGTGGTGGGGTTGTTTTGGTTTTtGGGTGTTGTTGTTTGTTTG	GGFGDGGGGFGFFEFFFF>FFFEFFFFFFFFFEFFFFEECGGECC	T	25	G	20
11	99690428	T	191	TtTgGTtTTgTgGGttgTggttTtTTTTTggttTTttTgGTTTgtTTGTTtTGtgTTGgtggggtgTTTttTtTTggttTGtGtTTTggTTGtgTgTttgtttTGgtGTtttttTtTtTTTTtttggttgTTgggggTTTgTTtttggtGGTtTtttttttttgTTgggTtggtTttgTttTtgttttTTt	CA@@>7@BACCCABDBEGEEDCGCGG@GGFFDDF@DDGFCGGGFDGGCGCDGCDFGGCFDFFF@DFHHGDDGDGCFFDDGBDCEGG@FFDG@EGDEGEEGEEEGCGECGEEEEED?5EGGGG?>DGGEEGFFGEGGGF<FGFF;CE:GAB9FEFEFECEEEEEGFF?EGFEFGEFEEGEEEFDFDA@?D?@	T	133	G	58
11	100812490	A	25	AgaAGgAgAaagGGaaaaAGGAGaA	CCAFEFFFFDDDEEEEEAEDDEDE?	A	15	G	10
11	100820555	C	252	GCGGCCCgCGCGCGCcCCgGgcGGcGGCGcCGGCCGGCGccCGCccCCggGGGGGCGgCGGCGcGcgGgCcggGcCcCGCggGcGggcCCCGGCgGGGggCcGcGcCcCGccccCcgCGCCggGCGGGgGGccGGCcgggcgCCCcggggGCCCggcGGCgcgCcgggcGGGGgGCGgcccgcGgcgGCcgCgGgcgCgcccgggGccGgCcccCggcCgccCggcCGcggggcgGcgCCgcCgcgggcCcC	DDF@BB?AGFEHFHGFGGFC?FHHFHHGHFGGGGEHHFHFFGIGFFEFFFHHGGHGHDGHGGHFHGFHDGGGDHFFDGHGGFHGEGGGFGGHHFGGHGGGGGHFHGGGGHGGGGGGFGHGGGGHFHHHGGHFFGGFGCGEGGFFF>G<GGGFFFDGGGGFGGGFGGEGFGGGGGGFGDG>GGGGHHHGEFGFGGGGGFGGGGFGCGGGGGFFGGFGDFFGBGFGGGEBFGGFGFGFFGDFFECDD>AB@C?A	G	132	C	120
11	100846936	A	25	gagAgaaagagaggggAgGaaaagg	>CBFFFFFFFEFFFFFGGBFGGGBB	G	13	A	12
11	101918686	A	55	ACcaACCAccaaAAaaaAaCCccAcccacccACcacccaaAacAaAcccccaaaa	CD?FFGGFBBFFFFFFFFFGGBCFCCCG@CC@;CG<CBGGEGBEH>CCCC>FG?B	A	28	C	27
11	102622758	A	66	GGAAGGGAGGAAGGGGGGAGGAaAAAGAAAGGgGGGAAaAGAGAgGaGAAAGgAGGgaaAgaGGag	FFFFGGGFGGFFGFGGGGFGGEGED:EFDEGFDFGFEEGEEEFEDFGFE<DECEFFDGEC>AC>?A	G	36	A	30
11	102641452	G	44	CCGCGGCCGGGcCCCGGCCGCCGcCCGCGCCCCCcCgcGCcGGG	BFDGDEFFEEEDEFFDDDFDEEDEFEDFDDFEFEEFGECEDBA?	C	27	G	17
11	102661595	A	65	AAagaggGagaaaaGaggaaGAgaagagaaaggaaaagagagaAggggaGagagagaagggaaga	D?BDCEDGFFFFFFGFFFEEGAFFFDFFFFF==EEGFFGFGGFFGGFFDFF?>GGGGGGGFDA;<	A	36	G	29
11	102663482	A	64	AaaaataaAAtatttttaAtttttAaTAATaaTAAaTaaAtTtaTaaATTttTTAtTtaTaaaA	>CCADAECDFADCDDDDDFDDDDDFCGFFCDEFFFEGEEFAGEDGDEFGFEEFFEEF;EFDEAA	A	34	T	30
11	102713620	T	77	tTTtcttTCCtTtTctcccTtCtctctTcCtCccctTtCtccCtcccttCTctttccCcttccttcttCTctcCccc	CB;GBFGEGG=FG:BGBBBEGGGBGBGEBGGG@BBGEHGHCCGH6CCHAGEAGGHBCGCHHCBHHAHIFCCHCFB>=	C	39	T	38
11	102735103	A	42	aAAAaGgGaagGggAaaAGgGaGgagGaAgAgggggagagag	=@?DEFFGDCFGFFFDDGGFGDGGEGGEF?FFFAGHFGEGEE	G	23	A	19
11	103041040	A	36	ccaaaAaaaacaaaccaaccaaacaaaccaccaaca	DDACEFDDCCGDDDGGDDGHCDDHEACGHEHHCEG@	A	23	C	13
11	110118364	A	40	CCCACCcAAACCaCccacCacAacACcccACcAACaCcCA	BAGFGGFGFFGGGGGGGGFGGEGGEFGGGDFGEEFGFGEE	C	25	A	15
11	111156836	T	38	TcttTttccttcccccTtCctcTtccctcctctctctc	B:EFEGGBBGG@BABBDGGCHBEHCACH@CHCHCHC9?	C	20	T	18
11	111784229	C	147	cCTTccCTTCTTccTcCTCCTtCTcCccCtCCtTcCCCTtcTtTTtTTtTCCTCCTTCCtCTtCCtCTctttCCCTtCCtCCCCCTcccCTCTtCCCtCcCtTTcCTTcTTTTCCCcCTccTCTtTCTTTCcCCcctTTtCCtcttC	C<>B@CDGFDGGBBGBDGCCGGDBBE:BDGDDHGBB?DGGCGHE@HGGHFDDGADGGDDHDGHDDHDG?HHADD=EHCCHC@CCCFCCCCFCFHCCCICCCHFF;CFFAFFFFCCCCCFCCFBCHECEFGCACC?7DDCB@@B:@@C	C	79	T	68
11	111933088	A	31	GGGGGGGAAAGGGGGGAAggGgAGgggAGAg	8GFHCEGCEEHHGCAGADDGGGDGGGGEDA:	G	23	A	8
11	113133676	T	149	TtggtggtggttGgtGTTTTGTTgGGGtTtTtgGgttTGtGttTGgggtggtGTttgGTTtGTgGTTgGGTtGttTtTtGGTggTGtGTTGgtTtGGGGgggTtTgtGTTGGtgtGGtTtGggGTtggGGtGTGggtgtttgtTTtTtT	BA@@ABCBCDCBDGCHEEEEHEDFHHHDEDEDDHFDDBHDHDDEHFFFDFFDGEBDFHEADHBFHEDGHHEEHEEEEE?HHEGFEGCGDDGEEDEGGGGGGGDFDFEGDDGGEEDGGEDDGGGGDEGFGGEGDGGAEFDADC?BA9>@A	T	78	G	71
11	113143557	C	27	CTCCcTCCCtCCcCCCTTCTCTTTCCC	BGDDDAADDFCCECCCFFCFCFF@AC@	C	18	T	9
11	113233059	G	43	AAAGAGAAaAGaGGAAGAgAGAGaAGAGAGAaAGgGGgGAggA	>?DBFGF;FFGFGAFFFFFFFEFFEFBFDFDFEEFFFFFEBB?	A	23	G	20
11	113706122	G	28	aaAaagAgggAagaggaaGgaggaagga	AFEFECFC?CFFCFCCGFGDGDDGEDAG	A	15	G	13
11	114442103	A	112	GAGGAgGGaAAAaaaaGAGGGAaGAAGAgAAgGaAgGGAagAgAGaagAagggAaAAGAAGAGAaGAAgaagggagAGGaGgagAAaAGGGggGAaAaAaAaggAGgAaaaa	@BGH?FGGFEEEDFEFHEHHGDEHEEGEFEEFHGEGHHEFF>GEE;GGEGGGGEGEEHEEHEHDGHDDGGGGHHHGDGGFGGGGDDGDGGFDGGCGDGDFCEFFDGEBAA??	A	63	G	49
11	116707684	A	44	AAGAAAGAGGGGAAAgaGAGGgAGAGaAGGaAGAGGGGAAgAgG	EEHEEEHEHBHHEEEBEHCGGEDGDGFDGGFCGDGGGG>DEBBC	G	23	A	21
11	116708020	A	67	GAGAAGGAAGGAAGGaAAgGagAGGAgGAgGAAGGgGGAAaaggaAaGGgaaAGaaGaGgAaggGgA	GEGFE9EFFEGFFGGFFF@GG>>GGFDG:DFFDGGDEFEEBGDDDBCFFDFEEFFGEGEDDFBBC=B	G	35	A	32
11	117163765	C	76	ACCCACAACAACCCAAAcACccAACaAcCcccCacCCaCAAaaacAAACCaAcCAAAacccacaacCcccCAaccC	;BAEEF?EF>EAEGEE6FEGFFEEGGEFGGGGGGFG5GGEEDFGGEEC>FG@GFDDAGGEGGGFGGFGGGFCDC>C	C	41	A	35
11	117241760	T	35	TATAATTATAatAaTaTAAtAttaATTTAAATAtT	AEEEEEEEEEG?EGEFEDCFDFFFDDDDA?DBA@@	A	18	T	17
11	117280516	A	70	aaaaaaaaaaaCaaCCaCCaCaCCaCaCCaaaCCaCaCCCCCCCCaaaaCCaCCaCCCaaaaaaaaaaAA	CCBDDEDDC<EDDD;?E8AF5=@>D?B9?F@ADBF=9D>C?C?CCBDFEAA>C8ACA?FB>?EBE@DBB?	A	41	C	29
11	117309581	G	96	AAGGAGAGAAGAaAggAGaGGGAagAGAaAGGAAAAGAgAGGGaAGGAGGGGAAAGaGAGGGAAgAGAAGGgAGGAaGAgGAAagagGGGGAGgaG	EACCHCHC=H;HEGFDF>DC>CHEFHCGFG:CA@GG:GGGBBB;GBBGBB@BHGGB;BGBBBGGGGBGGB9F;BBEFAGCAGGCEBD@@>=B=>A@	G	50	A	46
11	117647461	C	35	CGCGCGcGGGGGGCGGGCGgCCCGGGCgCGgGGcg	AAGG=GGGGGGGDFFFFFEGFFFFFFFGFF=BBAC	G	23	C	12
11	117800033	G	58	gaAaAgAgGAaGgggggGgAAGGAgGGgGagGagggGaGgAgagAAgagGaagAaAaa	CD8DFCFCDFFECCCACECF:CECCEEDCGCDGDDDDGCCDDGDEDDGDDFGDEGECD	G	33	A	25
11	118108003	G	52	aAAgAagGgAgAgaGaggaaAaGAaagaaAggagaagaaaaagaggaaaaga	ABDDAFCGCFCFCFGFCCFFFFGFFFCGFFCCGDGGDGFGGGDGDDGEGGDF	A	33	G	19
11	118499077	G	79	gaaaaAgaaAAgggaAGagagaggagagggagaggGagAAGaGGAagaAgAGAAagAggaAagAgGaAaAgaggggGga	AAC?B?BBB?BCCEEFEEEEEEEFEFEFFEEDEEEEEFFFEFEEEFGEFGFEEFFGDFEFEFFEFDFEFEGEFFDBB@B	A	41	G	38
11	118533594	T	147	CCTTtTtccttTcCtTttcTCctccccTCcTTTcCCTTcttcctCctCctCTcTcCTtcCCTCcCTctcTttcTcTctctccctcccCtcCCcTttCCtcCTCcTTtCTCtcCcttCtctTTtcttCCccCTTTTtCcTCtttcCcc	;<BDDEFEEDEHFDEGEEFGDFE<FFFGE?FGHFDDGGEEEFEFDFDDFDDGFGFCCEFDDGDGDGGEFGEFGFGFGEGFGGGCFGGDFGDDGB<FCCFGCFCDDEFCFCFDCG@FCDEDEFCGFECCGGCFFFFBCFG:E=>=CDD	C	78	T	69
11	118773105	A	27	aAAAAAAAAagAAAAAAAAAgggggAA	?DEFFFDEE8>EEEEEEEEADC=:DBA	A	21	G	6
11	118851138	C	54	TTCcCTCTCCTCCCTCTCCTcCttTCCcCTCTCCCCCTTcTCCTCTCTTTCCCc	FGDD8GDGDD5D=CFCFC@=ECFFFCCECF5F@CCCCFFDFCCECFDFFE@@=>	C	33	T	21
11	118955679	C	192	CTTCCTTTCTCCCTCTCTCTCCCTTTTTTTCTTTCCTTCCTCTTCTCCTtCCtTCCtCTTTtTCtcTTTTCCCCCctcCCTCTttTCcTCCCTTtctCTcTcTCTTTccCTCttTTCTctCtccTTCTCtctTTCTCtCCTtttctctTTTctCTCCTCcCtCCtTCTCTTcCCCcctCCTCtcTTCCTCTt	A?A?AGFGDGDC@GDFDDDGDDCGGGGHGGDGGGDDGGCDGCGGDGDDGFDDFGDD?DGDGFGDDEGGGEDDDDDAFDDD?CFFFGCEFCCCFFFDE@FDFEFCFFFEECD?FFFFCFEFCFEEFFCFCDDEFFCFCDCC?FEFDCEEFFFDFCFCCFCECFBC?FBFBEEDDCBBBBAADBA@CDA@CC?A	T	101	C	91
11	118971251	A	27	AAagaAAGaaaGaAAGGaAAgaGAGGA	AECFDFDGDDEGEFEFFEEEGEEDFEC	A	18	G	9
11	118971562	G	54	AaAaggAAaaAGAAaGgaagAgGaagGagAggggAggggaagggaAgGgAGaAG	AC@FBCFFEEFGFEFGCFFCFCGFFCGFDEDDDDFDDDDGGDDDEEDFDEFGDD	A	27	G	27
11	119005132	C	97	tcTtccTcCtCccCtttctCCctcCccCtccCtttttccctttctCtccCTCtcttcttccctctctTcTccTttttCctttctcCtcctcCtcTtc	?B?BBACCDDGDDFE6EDEFGDEDFDDEEDDGEDEEEDDEEEEDE?CDEFEFFEEFEFFDDEEEDEEDEEEEDGDFFEDFEFEFEE?EAFDE@@B=>	C	51	T	46
11	119043656	C	68	tctCCTtttttCCCTtCCCCtcCCCTtTtcTcttCcTcCttTcttcCctgcTctTcTCcctTcctCtc	=CB;GFDDDEEGGGGEFGDBEDCGGGEEFDGDEFDEFEGFFGEF9ECEF6EGDFFEEFEEFEEE=FDC	C	34	T	33
11	119059404	G	119	GGgaAGAAAGgGGGaagAgGGAaGGGAgAAGaAaAAagAGAAGAaGGagggaggGAagGGaGAAAagGGaAAAAAAggagggAGGgGaAGAAAAAGAaGAAgGAGagGAAaGagGAGGA	@@BGFCHHGCCC@CFFCBCCCHFC:C>BHHCGHGHHDDHCHHCHC=CFDDDGDDCHGDABG9GGEGD9BGGGGGG>DDG;D?GBBDBGGBGGGGGBGHAFFDBFBGDBGEEAC><AA?@	A	61	G	58
11	119181170	T	105	CtTttCTcttcttcccttCTCCcCCcctCTTCTtCcttTCctCctttTttTCCcctttTttccTTCcTctcTtcTttcTtctttcCCtCcccCTtTCTtCtcTtT	C??>@>A?ABDDDGGGDA>FGGGGGGGDGFFFFDFGDDFFGDGGDDDFEDFGECHDEEAEE;FEFFHFCEHEBHFBEHE=HEEEGEFEEH?H?EBEEEDE@GECB	T	58	C	47
11	119214710	C	50	ttCtcCcttccCCtcccCttttttccttCccttcccccccctcttccccc	?B9BCADDDDEEDEFFFEBEFEEEGFDFCGGFFBGGGGFBGFGFFFFBF?	C	31	T	19
11	119244095	C	105	TTCCTtcTtcctCTTTcccCTTCctccCCtTTCCcCCCCCTttTcTctctCtTTcttCTCccccCcTcCCcCttctcttttTCtcCTtcCTcccccTTCcCtTcC	B@<;CGBAGB<GG@DGBBBEGG?AFBBGGCEG:GCDGEGGEGHGBGCHCHFHGF:HHGGGCCCCGCGCGFB=AHCHCHHAHFFC?FFF=FFCCCCBDFE7EHD?>	C	59	T	46
11	119290034	G	57	GGgGGCcCGGccgcGCCcGggCGgCCCcCGCGCGGGGgCGGcGGcGGGgGGGCccCG	?CCEEGBG?ECADCEGGC?DDED>FADCFDDDFDDDC;FDDCDDCCDDDDCCC>>>?	G	33	C	24
11	120111041	G	87	GGCCGGGGCGGGGGCCCcCGGgGGCGGGCGCgccCGCGgCGcGGCGCCCGGGgCccGgCcGCCCgcCCCCCCcCCcGggCCgGCCGg	=ADDCCCCCCACCCDCDDDCCFCCCCBCDBDGE@DBCCE=BEB9DBCCCBCBFCFDBDCEBCCCEDCCCCCCE=CEAFFBBFAAA?A	C	44	G	43
11	120385841	T	35	CTctCTCtTTtTttcctcccttcccttTccttTct	A?BGDG@FGGGGGGBBGB?B<HBBCHGGBCGHFCD	T	20	C	15
11	121483401	C	157	CCTCCtTTCTTTCCCTTcCCCTCTTcCTCCTtccCcTtCCTTTTccTTCccCCtCTccTCtTccccCTccTtcTcCCCctCTTTCcCTCccctCCtCCCTtTCTTcTcttcctTtCCtCcccctTCCttcTCcTCccCCCCCCtTctTcctttcctc	A@B><CGGDFGGDDDGFDD?DGDGGDDGDDGEDDDEGEDDGGGGEDFF@DEDDFCGEDFDDGECEDCFEEG?EGEDCDDF>GGG@EDC:DEEF6=FDCCGF5CFCEFEFFEEFFE@CFCEEEEF@CCFEEFCE6CEECCCBCBFFEFF@CBB@?@?B	C	92	T	65
11	123396674	G	33	CGggCCGCGGCGCGGGCCCGCCCGCCCGCGGGG	BEBBGGEGEEFEGEDDFDDEEEEDFFBCFCDBB	G	17	C	16
11	124078704	G	98	GGAGgGAAGaAaGAAAAAaaaAAGaAaGAAAGAGGAGGAggGgAggAGAGGAGaGGGAGgAGgaaGaaAaGaaaAaAaggaaAaGaAggAaggaGAgg	?FEGFGECFDBCGFFFFGDDD<FGDFEGF?FGFGGFFGFGGGGFGGDGFGGFGEFFFEFGECGEEFEEDFFE<EEEEEGGECEEFEDGGDCFFDEBA?	A	55	G	43
11	124096247	G	159	GAGAAGAGGGGGGAAGGAAGAGAAAGAGGGAAAGGAAGGGAGAGAaGGGGGGAAGgAAAGgAAGaggAGgGgaagAGgGGagAaAAAAGAaGgAAaAGAaaagagaaaaaAaAGggaGGGgAGggagAgGgaaaaaGgagAggAAGgAaAAGaGaGAAg	BBCFDAFEEEEDEF9EEFDEE?FGFEFEEEFEFEEFFEEDFEEEFGEDDECEBEEDFFFEDEFEDA;FEDABGGDFDDEEDDCGEAEED<GDDEEGBDDGEGDGDGGGGDEGEDBDGDDDBEDDDGEDDDDFGGGGDDGDEDDEEDBCDBAA@>?CC??	A	81	G	78
11	124109508	G	42	TgGgGggttGtGggGtgtTTggtgtgggggtTtgggtggttg	D>>ACFFEECECFFBEFEGGGGFGFDGGGCFGFEFGFGGFF@	G	26	T	16
11	124309966	T	27	CCCCTTTTCCTCTCCTTTCCCCTTCTC	GGGGD>ECCFDGDCFDDDFFEEDBBAC	C	15	T	12
11	124386346	T	28	ttTtctCTctccccttcCttCtttcccc	>CADA>GFBGCBBBHHBDHGGHH:DD?C	C	14	T	14
11	124494913	T	112	CCCTCtCTTTCCCTCCTCCCcCCcCttcCTTCCCcTCTcTCCCTTTTCcTCCCTCTCCtTTCttTTCCtcTCCCTCTTcCtTCCccTTtTttTcCcctCccccTCcCCcttt	ADEAEDGEEEGG?EGGEGEHFGGFGEFFEEEGGGGDGCGEFEGEEEEGFEGFGDGDFFDDDFFFDCAFFGCFFFDFDDGFFDFD9GD8D<FFDGEFGFEGCCCCCBABB<>C	C	65	T	47
11	124824839	T	56	ctctttctctcttcctccccttccttccttccctcccctcTctTctttcccttttt	BBACDEDDCEDDDDDEDDDDEBDDEEDDEEDDDEDDDDEEEEFEEFFF9EE@FAFB	C	28	T	28
11	124951311	T	43	TTTCTTtTTtccttCcCcTtcTCtttttTttCCCCTTTTcttc	CEEGECEEEEFFDEGEGFE@GEG<FDD6EFEFFFFDDDDGF=@	T	28	C	15
11	124954849	G	97	CccgcggcgGcGGgGccgggcCGGgCCgGggCGGggGCCgCGGCgCcgCGGGGCGGGccGGCgGCcGCGGGGCCCCCGGgCGCGgCGCCCCGGGCCG	C?BACF<CDEDEEEEDDFEEDFEEGEGFEFGEEEFEDGGFFEDFEDDEGDADDG=DDE6D:FGCF=DFCDDDFFEEFDDFEDEDAECDGEEECABAB	G	56	C	41
11	124967487	T	115	AATATTTTTTAATAATTTattTAtAAATaTAaTtAAaATttattATAaTTttatAaaaATTaatAAATTAAtaataAtAATAtTaaTTtatttTAaTAttTaaaTtTaaaatAtt	;>EE5EEECEEEEEEEEEFE=EEEEEEEFE<GEFEEGDEFFGFFEEEGEEEFF<EGGGDCDEGFDDDDDDDFGGFFDFDDDCFDGGDDFGEEBDDGDDDFDGFGDFDGFEBA@>C	T	58	A	57
11	125255715	A	64	gGggGgAgGaaaggAaaggagaaAagGgaaaAgGgaaAgggaaagggagggggggaaaaggaag	A9DFCDGFCDCDFFHDDFFDFD8HCFCFCEDHFCF:EHGGGEEDE@GEGGGGGGEEEEEGGE><	G	35	A	29
11	125323965	C	37	CTCttCCTTCTTCTCCTCCtcCtTcCTCtTCtccCCT	CFGEEGGCD=FFGEEFEFGE8C;DG9EEFEEFGDCAA	C	20	T	17
11	126074192	A	71	AgAGaGAaggagaGAagaggaaaaggGAaaaggagaagagAaAgaaaaaggaaGggggGAaaagggggaAg	CAABEEEFCCFCFGFFCFCCFFFFCCFFFFFCCFCFFCFC@FFCGFGFGCDFFGDDDDGFGGDDDDD9GE;	A	38	G	33
11	126174164	C	99	tttCtCcttttttTttccttTCcCcCCctcTcTcttcTtTctTTCctTTtTcTTccCccccccttTTCttcTTttttcttttTcctttttttTcctctt	AA?@AABBBBEEDEEDDCEEEGCGDGGDEDEDEDCEDDEEDEEEGDEEDEEEEEEDGCDEEEEFFEDGFFDCCFE?EEFFFCDDECEGFFFFDE:FEFF	T	62	C	37
11	126283785	C	34	cCcCTTCTcTtCCTCCTTCcCCTCTCtTTTCTCT	EDGGFFGEHFEFFEFE9DFH5FEFEDEDDDBBAA	C	18	T	16
11	128846547	C	170	ACcCCcAacACaccCacACAAcaAaacCCAcCACCaaACCcaaAcAcAaAaACcAAACAcAAAaAACAcAcCcacACCcaacaacCcaAacCccacaccccaaacaCccaAacCCaCaaaAcAcAcacAccaaaaacccaaaaaccacaaccacAaaCcccCccaaacaa	C>@?@CACFDGDFFDCFFGEFGCEDDGGDFGGEGGDDFEGFDDFGFGFDFDFGGBFF?FGFFFEFFGFGFGGHDGFGGGDDGEDHGGEFEHGGHEHDHHHHCEEHEGHHEFEHGGEGEEEBHFAEHEGEHHEEEEEHHHEEEFFHHCGCCHHEHECCFHHHFHHEDCD:=	A	88	C	82
11	128868239	T	135	CTTCCtTCTCCCCtCCCcCcCTtCCCcTCCCcTCcCtCcTtCCctTTCCTTCcCCCcCTcCCcCccCccCTCTTtttcTtcTCttCcccTTTTTtTcTTTCCTtTCctCCttTCcccCtCTTcCccTTcTcctCc	>:@@EDFGFDGG?DGAGFGFGFEGFFFFG6FGFGFGFFGEFFFGFFFEFFFFGGFFGFD=FF5FDGDGGFEGEEFFFGEFGEFFFFGGGDEEEEFEGEEEEFEFEFBFFFFFEEGGGEF>DEGEFGECCB>;>@D	C	81	T	54
11	130332263	C	55	tCTtcTCTCCCtcTtTCCTCcTCtCTTCCTTCCCTTTTTTCTTTTTTCTCTCTCC	AA=FBFGEGG9GCEH<GGEFCDAHFDDFFA<FCFDDDDDDFCCCCCECCD9>@C?	T	31	C	24
11	130332313	C	128	ACCACcACCAACCAACCCAAAAAACAAAAAACACACACCAAAcAACACCACCAACAACCACaCaaacacaCCAAAAcaCaCAacCcCaCCACCAAcCACaCcACAcAaAcccCCCAaaCCaCAacCCa	?=GEFDEEGEEGG@EGGG?@EEDEGEEEDEEFEG:FBGGEEDDEEGEEGEGEDEGCCFEDFEFFFBEEDDGADDDDEFFEFCFEFEFEFFDFFDBEFCFFFEDFC;DFCEDDGGFDABDC@B?A9CB=	A	66	C	62
11	134064540	T	41	TTtttTTttttTTTTTccTcctTcTCcTTTTCTCtCCTCCt	@EGGG==HHDHFCG>;CCDCCH?AFFCEEFEGDCEBBBC?F	T	28	C	13
11	134180874	G	38	AAAGAGAAGGAAGAGGAGAGGGGAGAGAAGAaAAAAAg	FFF;F@E?GGFFEEGFEFEFFFFDFEBEEFE?EEECCB	A	22	G	16
11	134244123	C	132	GgGCCGGGGcCgCCCgCCGCCCccCGcCCccCGGGGcGCgCCcgcCcCcCggcgCgCgcccGggGgggcCGCggcccCcCgCcgcggcGGgccgGcgcccccgcGCCcgcccgcCCccggcgCCgGgGgccg	;A5>>=@?AEBEDCCFDDCBEDDADCDBDDBDCCCCDCDEDDDEDDDDDDEFDGDFDEEEECFFCGGFDD<DGF@EEDEDGDEFEFFEC?FEDFBEEDEEEEFCBCCEFFFEEECCCEGFEGCCF?>>B?BB	C	76	G	56
12	2705356	A	36	AaaaagaagaaggaagaaGaaggagggaAgaagAag	C@CCCEDDFDDFFDDDDAGDCDGEGG@EFGBDGEEA	A	22	G	14
12	3047466	G	33	aAaAgaaaggAaggggaggggagaaaaaaaaAg	DAD@BFFEC?DFCCCCECCCCDDGGGGGGGGDA	A	20	G	13
12	3701464	G	139	AgGaAGGAaaAAAgGgaGAaAggaaAagagAgaAggaAGgGgAAGgagAGagAAGAGaAGaAGAgaggaaaGagaAgggaAGaaGaGggaaAggggggaAaaaaaaggagaGgaagAggAaaaaaAggaggAAAaggga	<B=AABABDDD;BEEFCEEDEFFDC?DFDFFFDFFF=GEFEFCFDFCEEEEFFFEBEDFEDFEFFEGGEEED<GCE?GAEEEEED=EGG9EFGGGGEGC?;DE=EECGEGE5GEEGEFEE8CEEEBGEEAFDDD>FB?@	A	77	G	62
12	4744818	T	30	TaataattTaTtAAAatAAtaaTATaaAAT	@ABBEFECFFEEEEEGFEEFFGDDDGGCDA	A	18	T	12
12	5541624	C	40	ggcggggcgccggcccgcgcGgccgccgggCcgcgGggcg	?@CEFFEDECDFEDDDEBFDCEDDGDEGFGDAFEGCGFEE	G	23	C	17
12	5756783	C	37	CGGCCGGgCGCGCGCCGcGGCGCgCGGggGGGgGGCC	?CCDDCCFDBC;DCCCBDBACBCGCBBFEB:BE?8=A	G	23	C	14
12	6579812	T	48	cctccccttttttctTccttcttcccccccccttttttctttcctcct	GHDFGFGDDDD<DGDGGGBDGED;GGHAHGGHEEDEEEBEEBDDEE@?	C	24	T	24
12	6588972	A	43	cAACCcaCAccAacacAcAAaccaAcaaacaaaacCaaaCCCA	BDEFFDEGFDDFEDEDGDFEED<EFDEFFECFFFEEFFFEFCB	A	24	C	19
12	6635374	G	228	AGgAgggGggaAgGaAAGaAaaAAaAGGAgAaGAGAgAgGGGAaAGAaGaAGAAaAGGAAagAAGGAAAgaaagAagAAagAAaAAaGGgGgagGAGaGAaAAAGaGGaGGGaaaGggGGaAaaAGGaGaAGgggAagAAgAGGGGAAGGGGgggAgGAAaGGAAGgaaAaaagAagAgGGAggagagAGAaGaAGAGAGaaAgaAggAAAaAagGgggGAGAAaaaG	B@????A;@8DABBCCDED5FFEFFFDEFCFFDEEFCDCEEEFFEEEFEEFEF:FFEEFFFCDFC:FFECFFFCEFCFFFCFFFFFFEEDDCFCDDEEEFDFEFEGDDGEDDGGDDDDEEGFGGFEEGEFFED>DEGCEFDEDEEDEBDEDDDDDDDDEEGDDEEADGGEF;GDEGDEDDDEDAGDFDEDDGDGEDEDEDGGEDGEDDEEEGEFCCBBCEFBCCB@?A	A	124	G	104
12	6940254	A	115	GgAgggAaaagggAaaagaggGAggaAAGaaggggggagaaAaGgaagaaagagAgaGgAGaagagggaaggggggAAgGAAAAGGGAAggAgGagaggggGGgGAAaaAGaAaA	B??@@A@DC5CBCDFFGBEBCFFCCFF<<FFCCCC?AFCFFFFGCFFCGFECGDDDFGDEGGGDFD?CGGCD9DDDFADCDEEEFCFEEEDEDFEDGDDDDFECFEDFFFDCB?C	G	60	A	55
12	6942823	A	137	AGgGgAgAggAaagaaggAAggggaGGGAAgaagaAAaAgaGAaGaagGagGAAGgAgGggaagGGgaGgaAAgaAAgGGgaaaaGgaAGaaAGaAgAGagAgggGgAaAGGaGggAAAAagAAGAaaaaAGGggGg	E@A;@ABGFFHFFFFFBFHHFFFFFBCCGHFDFFFGG<HDFCCFBFFFCFFCHHCFHF@GDGFGBCGDCGFEHFGHHG=CDGEFDCGDHCGFGBFGGGBGGGGGGBHGFGB@GBGGGGGGEGGGBECEGGGBCFE:D	A	69	G	68
12	7014962	A	37	GaGgGGAAGGGAAaGgagGAgaAAgGAgGAAgAGgGa	@?ECEEFFEEEFFBEDCCEF@GFFDDEDDEEDEDCCG	G	21	A	16
12	7069425	G	66	GGggGgGccGgGCCcGGGcCCGGggGCcGGGcCCCCCGCGCCgCGGGCCCGGGCgCgggggggGGG	B@?ABCDBBEFEGFBCCE6GFCED9EF?EED9EFFEFDFDFFCFDDAFEECCBB?A=<DCCDD@AA	G	41	C	25
12	7087711	T	81	cCCTtcTCTTTcCTTCtCTTcTTTCCcTtTtTCTtTCTCCTTTCTcCTcCTCtttcCCtTTcCTTtCtCCCTTtTtTccCt	C?FGDGG@GG<GGGG>DGGFGGGGGGGF7GEGGEEFGGFCEEBFFHFF:FFFEDEHFFDFFHFFFEFEFFFFEBD@A;;AB	T	46	C	35
12	7242299	G	166	GgAgaagagAAGggAagGaGGGGAAgagAgGGggggGGGGAGGAAaGGagaAGaaagAGgaGgGGAAAaggggagagggaAGaaAgGgAAgAgAGAGaaAaGgGgAAggGaaggAGAagaGgagGggaGAAgagggaGGGgggaggGGaAgAGGAGAAgagAAaAa	D?@BBCCDGC:FFDDDFHDHHHGBEFDFEFHCFFFFHHHHEHBDDDHHDFDDHDDAFEHFEHFHHDDEDGGDGEGEGEEE:ED>DGHGEEGDGEHEHEE7EHGFG;DGEHEEGGDGDEG=G?E9GGGEGCDGBEEGCGGGGGGEGFGGDDGDGGDG>DGEGED<?>	G	94	A	72
12	7463241	A	80	AAATAAaaTtTATATATATAatATTTtATTATTTAaaaAATtaTAaaTTAaTtTTAtaTatTattaAAtaaATTtttTta	CHGGBHFFGGFGGHGFGHGH>HHGGGHHDFHFGGHGDFHHGHGGHFGGGGGF9FFGHGFGDFGGHFFGHGGGF@HHFDDB	T	41	A	39
12	7842932	C	102	TTcctTCTtCCcTTTCCCTccCCTCccTCctCtTCcCCCTtCctTcCccTctTTctTCctTtcTtCCTCTCCtCTctCTCTTtcCCTTTtCTCCCctccCCT	@?BEEGDGEDDFHGGEDBGFFDDFDGGGDFFDFFCDD?DFDDFEBGCFGFGFFFGFFCGEFBFF?CCFCFCCECFFFCFCFFFGCBFFEFDG@@ABA@?AA?	C	56	T	46
12	8023500	A	55	GAAaAGAAGgagaAGgGGgGAAaggGAGAGaggAaaagGgaAAagAAGAggAaGA	DB?DCAFEBCFC@FGDG:DGF>GDDGDGFFG@DFGGD>FCGEEGDEEFDC@BBBC	A	29	G	26
12	8023680	G	45	tggtTGgtTgGGTgGgTTTGGtGggGTttTgTGGTgGTGGGGgTG	C>CEEEFDEEDEEG@GF<F?EFEGFDFAAECED>DGDEDDCDBCB	G	27	T	18
12	8808006	T	50	TCCTCTCcTcCTcTTTTCtCTTCtTTTCCCTTTTTTctCCTCCTcCCTcC	@GGGGDGFG?GG9GEFFFCFFFFFFF6FFCFFFFFFGFEFEEEGEA@CB?	T	26	C	24
12	9220729	G	84	AaAAAAaGgAaAggGGAaGGAGGgaGGAGaGAaGGGAAAgaGAGAaAGgAaGaaggagGgAagGAggaaagagaaggagagaaa	@AA?D9EDEEEAEE8DCEEEEEEEEEEDEFEFFED8?FEFFE@EDFDDFFF?FBCFEEBGEFFDCFFCE@FFFFEF?EECB9>>	A	45	G	39
12	9242623	A	91	taaaaTATtAtaTTATTATttTAaattaAAtATttAatTTAttTAATtTATttTTttAAAatttttAtaAAaTtAataaTtAaTataaAta	A?@CAFBFBFDDFFDAFFFDDEFDDDDEEFDFFEEB;EEEFEEFFDFEFFEEEEDEEFECEEEC6EE@FEEEEEEEEEEEC=EDDCD>ED=	T	49	A	42
12	9305473	T	136	TTtTTCCtTCTCctCCTTtCtttCCCCCTTCCtttTCCTTTCTttCctcccctTTtctcTCccCCccTccCtttcTtccttCttctTtttCtTTcctTcTtccccCttccCcccttTcTtttccctcTcTCtTTtt	<8BADF@EEGAGEEF9EEEGEEEGGGGGEEGGEEEEGGE=EGFBEG=EFFFFEE9EGFFBGF>GGFGEGGGFFFGBFGGFFGFFGFCEEDGEDEGGFEGDEGG:GFFCGGFGFCFGDFDFFFGGGEFDGDFEA<9?	T	73	C	63
12	10015177	A	25	aAAAgaAAAAaAgGGGAagAagAaA	CDFFFDEFBFEFGGGFCEGEE@DDA	A	18	G	7
12	10046052	C	127	AAccACACACAAACAAAACACCaAAAAAAACAaAAACCCcCaAAACCCAACAAAAaCACCAcaaAcCCacACcCACCaCCACACcACaAaCccaACAcCCCACccaACaAACaCaAcAcacccAacc	C@DDEGDGFGFEEGFFFFGFGGAFFFDFFFGFEEEFGGGE<EFFFGGGFFGFFFFFG@GGFDFFEEGFFDEFEFEFFFCFEEEFEEFBEFFEEFEFEEFFFEFEEFEFFDEFFFFDDFDA@=?BB<B	A	68	C	59
12	10165593	T	30	tTgggggtgtgttgtgtgtgttTggGgttg	BABGFFFDFEFDEFEFEFEFEFFCGBGFFG	G	16	T	14
12	10525878	G	25	Gggggaaaaagggagaaaagagaga	@CCCCFFFFFC>=GDGGGGDGDG@G	A	13	G	12
12	10560957	T	26	cTCTtCctTtCtCttccttTcctcTt	BGGFEGFEFEFEGEFGGEFFGGFGFF	T	15	C	11
12	10562089	A	188	AcACCCcaACAcACCCcCCACcacAAAACAAcCCccccccAaCaaAACAacCcccccACCCcacAAaaCaCAacaaCAcCCCccCAaCaCCACAAaAaCAaacaACaCCAcCCCcCaaccAccaCcaccacaacCCcAAcaAacacAcAcaCAccccCAaccAAaacCcaaacacAAAacAcacaaaA	AC<>??CB@9?C<BBDECEDDFFFFFBFFE9EFGFFFFFFFFFFFFFGDFFGFFCFFFFFFFFFAEEFGEGFFFEFGEFGF:GGGBGFGGFFFFFGEGFFGDGGEGFFEFFGGFGFGGFGFFGGGGGGGGGGGGEEGEEGGDCFDFDGDGGFEGFGGFEGEFEEGGGFGE9GGEGEEEGGDGBDCC@?	C	100	A	88
12	10748314	C	36	CCTTTCTCCtTTTTCtTctTcCCCcCcTtCCcCTCC	EGFGGGFGGHDBGGG?F<HFAFFFCFCFHFFCFDB?	C	20	T	16
12	10748403	A	52	aATAAAaaTTAATaaTTTAattaAAttaTTaataaTTAtTAttAaAtTTAaT	CDGFFACDGGFFGDDGGFFCEEEFFEDDGEDEEEEEFEEEEEEE<EEEFEAB	A	28	T	24
12	10865971	G	64	GggCCgGCGCccGcgcCgcGccccGCggggggcccccggGgcccgcgggccGgcGGcgcccccg	@C9AADGGGGGGFGFGGFGGGGGGGGFFFFFFGDGGHEGFFHHGEHGGGGHGGGFFHHDGGHHF	C	33	G	31
12	11149720	A	61	AaAgggGGGggaggagAAaggaGgaggggagggAaAgAaggggagGAagaggaggGGggaa	CA>CCCCDFFEDEF>FFFDEFCGCDFFDEDGEFFCFGEEGGGGEGFEEEEGGE?GFFDGC=	G	38	A	23
12	11201041	A	56	GgGggGAAaggAAgAgaaAgAGgaGAGGAGGgaAgaAAGaaaagaaagggagggaa	DADBCGEFFCCFFCFCFFE<FGCFGFG>FBGDGFDGF?DGGGGDGGGDDDGBDDGD	A	28	G	28
12	11418867	A	74	GaaGGgAAAaAGagGAagAAAGgGggGaggAAAaAgGGagGaaaGgggaggGaggaGGgaagGGagggagaggg	DACAAEDEEFEHFFH>FFCEC=FHFFHFFFEEEFEGHHGFHGGGHEGGEGGHFGFGFHGGGFGGGFGGGGEGGC	G	43	A	31
12	12334006	G	141	GGCCgGgccCcgggcgGGCgccCgCGGGCcgcGGGGcCgGGGgCccGccGGGgCcGcgGcGcCGcgCGGgCGGgGcCGGgGgGCcCgCcCcgccgCCgGGGgCCGGCGccGCCgcgCggGgggCgcgccgGgCCGGGgccc	BAEB@>B@?FABBB=CEEECBBGCGEDEEBCBEEEE>DCEEEDF?BECBEEECGBDACECDCF?=DFEE8GEADECGEEDEDEGCGCEC=@DCCDFEADDDDCD:DEDCCD?FDCDFDDDDDDFDCDCCBC@CB>AA?;@@	G	79	C	62
12	12419719	G	36	ttggtgggTGGgtgTggGttgggtgggggtttgtgg	BCAAFCBCEHHCGCE;CHGFDCCBD@DDDCEHDG?@	G	23	T	13
12	12974543	G	42	AAAGAAGgGAGGAAAAGGaAaAGAggGgGaAGAgaAAagGaG	@8=FEEHCH;HECDEEHHGDGDGDDDGDCGDGDDGDCEDHDB	A	23	G	19
12	13061294	C	236	TTccCtTTTttTCTcTtcTttcTTcCccTttCtCTTcCTTCCCCTctcCTtCTTctTCtCttcTCttCtcCtcCTcttcTCTttCTcCtttTTCTCTTCCTtttTTctttttTtccttcTtTCTCCtcTTTCttCtcTcTTctCTCCcTCcTttcTctCCCCCTtTTCCCTcTCctCTcCTTTctCtctTCcttcTTCCCCCTtcTttcccCCTtcCTCCttCTCTCTtTtttCCc	C??CCGGGGGGGDD@DGBGGGBGGBDBAFGG?GDHGBDGGDEDDG=<BEFGDGGBGFCGDGCBGDH?DGBDHBDEBGGBFDGHHDGCDHHHFGCFCGDDDGHHHGGCHHHHHGHCCAGCFGGDGCDHBGGFDHHDHCFCFFCHCFCCCFCCFHGCFCGC@@CCFHFFCCCF?FCCHCFCCFEFCHCECGFCCHHCDFCCCCCFHBFHHCCCCBEAACEBBHHDFCGCEEDCC@CA@	T	131	C	105
12	14018777	G	34	gGCCgCGgGccgGgCgCCGCGGGCcGCCGGCGgG	?=EGCEECHCBDHDFDFFGFGGCFCGFFGHCE?C	G	20	C	14
12	14649147	T	90	GGTGGGTGGGTTGTTGGGTgTTTGGGTGTTGTTTTTTGtGGGgGGGTTTtTggGGGGTGTGTGGTTTGTGGGGTTTGGGTTgTTGGGGGG	BFDHHHEHHHEEHDEHHHDDDEEGGGDGDDHEDDDDDGFGGGGGGGDCAFDGGGGGFDGDGDFGCDCFBFFGEDDEEEDCCBB>DCCCC?	G	51	T	39
12	14993854	A	163	GgAAgaGGGGGgaAgGaaAaaAAgaAGAAaaGaAggGAgaGAaGGGGgAAAGAaAGGAgaGGgAAaGgGaGAAGAGgaaagAgGGgGgGaGAaagaAgagaAGgGgGgaaAAAgAgGAGGAGgagggaaGaggGGaGAAAaGGAAgGGgagGaGGgAGagaAG	EC@<BFHHGC>FFCFHFFEFFEDFFEHEFEFHFEF;H?FFHEGHHHHGBEDGEGEHHEGGGHGEEGHGHGHEEHBHAEGGGDG?GGHG<GGDFGG?DCGGGDGAGGGFEEBDDFDGGDGFDFGGGGGGGGG@:GGCGDDDGDFDCGFFGG8GFEEC:D<@?C?	G	86	A	77
12	15082004	T	44	aAttaattttatattattaataatttattaatattaaatttttt	AB:CBDCCDDDBDDDDDDADDDDDDEEEDDEEEEEEDEEEEEA>	T	26	A	18
12	15102681	G	64	CGGCCCGGGCGCGGccGcCCgCGCGgcCccGCcGgGCCGgGCGGCgGGCGGgCCGGGCCgcGGg	GGGGGGGGEGFGGGFD>GEFGGGGGGGFG:FDHBDFFFFGFFFFFGFFFFFFEEFEECGDACC:	G	35	C	29
12	15273932	C	85	CTTTTTCCcCCTCTTCCTcTCcCCcccttcTCTcTCCCcCCCCTCTCTtCCCtCTTCCCTTCCTTTTcTTTCCCcCTTTTttTCc	?EF<GEGGDGG>GFFGGFGGDGGGHEHEEHEAFCF<FFH@FFFDCEFDEFDFDF<FF=FFFFFABFFGFEFFFFGFCBDD@=?@E	C	47	T	38
12	15273957	A	118	aAAGAGGAAGaGAaAAaaaggaGAGaGAAAaAAAAGAGAGgAAAgAGGAAAGGAAGGGGaGGGAAAaAGGGGggGaAGGGGGAAGgGAGgAGGAGAGGGGAgGgaGgGagaaaAAagg	?>E@FGGFFGDGFFEFFFGGGFGBGGGFFFGFFFFBBGFGFFFFGFGGFFFGFFFBFGEFFFFEEEGEFGFFGACHEFFEFFEEFGFEFFEFFEFEFFFFDAE6GGFDBC=;@B@DD>	A	59	G	59
12	15722555	A	37	GGagAgaaAgGGaGGgaggagaaaggagaaaggagag	?@BBEFEEEFEEFDE@FFFEFFFDGGDGGGFGGE@DC	G	20	A	17
12	21054369	G	48	GAgAGAGGAGAGGAaGaGGgGggGGGGaGgGGAagAaAAgagGgagaG	EFCEEFEFFEEDEFGEGEEDD@DEECEGEDDDDCEEGEEDGDDDGDG?	G	30	A	18
12	21627745	A	50	AAGAAGGGGGGGGgAAGGGAaAAGaGGGAaGGGAgaGGGGGGGAgaGGGg	DFAFFAEEEEEEEEFFEEDEGEEDGDDDEGDCDEEEDCDDDCCC=?CACA	G	33	A	17
12	22354921	A	70	agaggGagggggAagAGagggggggaaaAgaagAagGagagggaaagggagaagaaaaggaGaGgggagg	ACCDCEEFEFFFFDFFGDFFFFFFFDCCFFCDFFDFGDGDFGGEDDGGGDFDEFDEDEAGAFEFGGHEFG	G	40	A	30
12	22478425	A	64	gagAaaggAagAggGaGGagaGgggaaGGGGgagAggaggGagggGgaagaggggaAggaAggg	C?CA6?ABBEEFFFGFEGFFFGFFFFFFHGGAFFFCFF5GGFGGGGGGGGCGGGGGEGGGEGGG	G	41	A	23
12	27625823	A	153	aAAAaatTAttttTTAAAtTtatAtatATtatatTAAaattAAtTtAATTtATtAAattAtaaATaataattataTAAAttaATaaaTaTTaataaAAtatAaaaaaAtatattatATaatattaaattAtaAatTaAaaTatTtaTaaataa	C>@@DD=EDFEFEFEDFFDGEFEFAFEFGEFEFEGEFFFEEGEEHEF?GGEFGEEFGFEFEFGFFFFDFFFFEDGGFEEFCGFGGGFGEGFAAEGGFEFGEEGGFFFFEFFGFFGFEFGDEGFFGGGFFBFGEHEDGEGGFGFFFGFDDC<@?	A	86	T	67
12	29721945	C	31	ctctTCcCtCcctccTcCtTtttctctcttt	?ADDFF@FEFDEEDDFCFFFFFFEECFAFDD	T	16	C	15
12	30948848	G	34	cGcCCccCGCcGCcccgcGGggGCGGCGgCgCgc	?BAEFDDGBGDH:D=EGEGHEGGGHHGDGFGAGC	C	19	G	15
12	31132479	A	103	ACAaCCAACCCAAACcACCCCCCACACACACAaAACCAAAAcCCACCCaCCCAACACAaAACCaaCCCACacAcaccCcAAAAACCCaacACcaAACAAcAcC	=EDEGFFFFFF;FAGEEFFGGFFBG?<FGEGEFEDEAEEEEEGEEFFFFEEEEEFEEEFEEFEFFFFFEFEEEEFEDFEEE@@EFFEFFEDED6B:>>>;A>C	C	53	A	50
12	32134240	C	263	ctcCCTCCCCcCCCcTccctcTTTTtCctCCtttttTcTTCctCTctCtTCtcCTtCtCtTCcTcttCccccTTttcctcCTcctCCCCCtTCCtCCTttTcttcccTtTCCTCTCCTCctCTCTtCCCTctcCTccCttccCCCCtCTCCTcCctCCctTCCCCCTctCtctTcccttTcTcCCcCCTTcccCCCctCcctcCTTtcttCCCctcctCTCtccTcctTctTTTttcTcTCttCCCTCccttcTTTCcTTCcc	A?C@??@CCCCEEEBGAAAGAGGGEFDBG7GGGGG:GBGGGBGGFBGGFGGGBGGFG=FGHD?GBFGGBBBBCFG:BBCBGGB@HGFGGGGFGEHGFFHHGCFHCCCFHFGDFGFGGFDCHGGGGGGGGFBG;GECCGHECCGGGFGGGFFDCGCGFFCBGFFFCFEAHFHCHFCC?BHFCFCFF:EEEEC5DFFFCHFACHCFEEFCHDFFFCHCCHFFFHCCFCBHECHEFFHHCEBFFDFBD=CB=>AA<A?CA>C??@A	C	151	T	112
12	32778581	T	51	CCCCCCTCCCCcCCTCCCCTTTCTCCCCCCCCTcCTCCCTCTCCtTCTCTC	@DDBDDGBDD9CCDFCCCCFFFCFCCCCCC=CFGCFCCCFCFCBEFCCACC	C	37	T	14
12	33576990	A	54	cccaccAaAAccacacaACcccCaaccAacacCaccacacccaaaccacaaacc	DDEDFGEDCDFGCGDGDEGGGGFDDGGEDGDGGEH?EHEHCHE9E5HE@E>EGC	C	30	A	24
12	40645257	C	28	aCCCcccaaCaaCCaccCAACccAaaCc	AD@DDDDEEEEFDAEEEDGGCEEGAFA?	C	17	A	11
12	40799969	C	63	ccccctctcCCcttTcttTtccTtTCcttctTTtttttTtcttTcTctctcCcctCcTgctcc	BAABCDCDDDCDEEGDEEGEDDGEGDDE?DEGGFFFFCGFEFEGDGDEEFEDEBBDAF7AB@E	T	33	C	29
12	40808832	A	88	AAGGgGgagaGggaGaggAgAAAaGGAaGaGGAGGgaGGgaGAGAagAgAaGGGGgaGAAgagAGgGgGGAAGGGGGGGagagGgGgA	@BADEHFFFFHFFFGFFFEFEEEEGHEFGEHHEHGGGHHFGGEHEFGEGEGFGGGGGGDDGGGDGGGHGGDDGGGG>GEGGEGFCEA?	G	55	A	33
12	43769228	A	93	cCCCCCAAcACAcccCCAAcCccAaAcAAACcaACAaAaCAaCCaACcaAACAaaACAACcAaACaCCaaCAaacccaCaAaaCAcacccCCc	C:<ABDHHAHDGBBBDDHHBDBBHGGBAHHDCGGCHGHGDHGDDGHDCGHHDGGGGDEGBCGGGAG?CGGCFHHCCBFCGGGFCGCGACCBC;	A	47	C	46
12	43860526	A	57	aAAGaAggGGaGAGGGAgGAAAAGAGaaAgAagGGggaaaaaaaaaggAgagggggg	C>?AEHCCDDFBHCCCHCCHHDH@HCGGHDHDDC=DDGGGGGFGGFADGDGDDDDC?	A	29	G	28
12	44148259	T	185	CCCCCCtTTctTtCCtctTcttTcTTCtTTcccCcttCTCtCCtcTCTccCtTccTTcTTCTTCtCCcccTtTCCTTTTcCttcctCccccttttCttcCccCTcCtcttTcttTCTcccTCccCtttCCCTCcTtcctttcCctctTtctcCTcttCttttttcctcctcTcttCttCCcctcc	B>A?BA7DDGCCCGFDFBEGDDCGEEGDEEGGGGGDDGEGDFFDGEGEGGGDEGGFD:EEGCEGDGGGGGEDEGGDEEEGGDDHHEGHHHHEEEEGEDHFHHGECGEHEEEHEDEGEHHHEGAHGEEEGEFDFHDE@HEEEHFHEHECEGEHFDHDDFEEEEEEHAEHHEHDHEEEAABCAC=ED	C	95	T	90
12	45410075	A	152	AGGGAGGAAGaAGAAaGAaaAagAGGGaagAgAaAGgAgAaaaaggGGAAGggaGGgaaaaGgagaAGGgggaagaggAAGgGAagAAGAaAAagAaggaaAagGaagggaGGGAGGAAgaaGAAGAgaGAagagAgAgaggggaaaAaGAa	E;=>DAAGGCFHCHHFCGFFHFCH;CCFFCHCHFH@CFCHFFFFCCCCHHCCCFCCCFFFGCCGDGHCBDDDGGDGDDHHCDCHGAH;:HG?HGCHGDDFGEGDBGGDDDEBBBEBBGGDGGBGGA>CFBAGDGDGDGDGDDCDGGFGF>@D	A	82	G	70
12	46318571	A	56	aAAaAAAAAAAAAAAaAAAAAAAAaAAAAAggAAgAAAAAAAAAAAAgggAAAAAA	CBDEBB9EFFEAEEF<FCBFADEF8FDE=C8@EE@EDBEEEE><DE<?@DB:?BA?	A	50	G	6
12	48134360	G	55	GtTGGGTgtGggGTttTtTTTGTTTgGTTttTGgttTtTGTGTgGTgTtggttTG	=EEEEE=CGECCEFHGFGFED@FEFDDEBFHFDDHGEBDDEDEDDEDEFDCHGBA	T	33	G	22
12	48359676	G	90	TGTGGGGTTGTGTGgGGGTGTGTGGGGGtTTGtTgtTTtGGggGTTGGGGgTgGtTTttttgTgTGGgTTTTGTttTTTtgGTgtTGtTG	=AEEEEEFFFAEE<FDCEEEFEFEEEE@FFEAFCGFFDEEEGGDFDEDC@GCGDFDBFFFGEDGEDDEEDD?DEFFEECEGCDEEDCCAC	T	46	G	44
12	48373181	A	67	GAGgAGGGAAGAAAAAgaaAaAAAAAaaGGGGAaGAaGgaGaagaGAGagggAGGGGaaAagAAAGG	<C?CHCCCH;BHFHHHCGFHGGHGGCGGCCCCHG9HGCDGA7GDGBDBHDDDGB@BAGGFFDFGB>?	A	38	G	29
12	48375258	G	39	tttTgtgttgtTTTGtTgGTgGGtTtttTgttttgtttg	C@DD:GCFGCGFFFEGFCEFDEDFFHGHECB;FBCHHHA	T	27	G	12
12	48377947	G	58	TgTtGgTtGtTtGtgtTGGGGtGTTTgTTTTGGtgGGtttTttTGtGttTtgGggGGg	BCFE>FECFEGEGECEGGGGGFGGGGGGGGDGGEEGGFEFFFFFFFFFFFFFFGGFC@	T	32	G	26
12	48398002	G	41	cggGcgGcggCCCgcgCGGGGCccGCcgCCcgCcggGgGcg	??ACACDBCCGGGCBCGECDD?CCEF>DGECDFDBDDDD<D	G	22	C	19
12	48545553	G	70	tggtTtgGgttgGtgtggtGttgttgggtgtttgggtttggtggtgttgtgtggtttttgtggttggggt	A?ACBDAACGGCBGCFCCG?GGCGGCCCGCGGGCCCGGGCCGCCHDHHDHDHDDGHGGHDH9CHHDDC;A	G	35	T	35
12	48737245	A	66	aCaaCAcccaaacaaAaaaaaaccacCaccAacccCAcacCCAAaAAACAcAcAaAcCccCaCccA	??AC<:>CBEBEDEEFEDEEEEDDEDGDED?ADCEFEDEEGDEFEEFE?E8EDEFDEFEEFCC@>A	A	35	C	31
12	49170191	A	74	aaaaaaaaaaaaaaaaaaCaaaaaaaaaCCaaaaaaaaaaaaaaaaaaAaaaaCaaCaaCaaAaAAaAAAAaaA	C?=>C@DCFBEBD=EADD:EEDBDEEEC7C<;@DEDEEC?EEEEFE;B;D<EE?FFDFFAEF@DBECFGGH>:?	A	68	C	6
12	49332366	C	33	TtCcCCCTTtTcCctcttctctTTtTTTtcTtc	7DGGGGGC:EFHGHEHEBHEHEFFDFFEEHB?A	T	20	C	13
12	49424616	G	136	GagaGGaggGgAGGGaAGAAgaAAggagAaagggGGGgGAaGAGgGgagGgGGaagggaGGgGagAGggAagggaAaggaaGAgaaAggggaAggGgggAAAggGaggagggAGGgAaGaaAAggGAGAAgAgAaG	>D@D?>CDDEBFEEAFFEFFCFFECCFCEFFCCCEFFCEFFED?C<CFCEC@EFGDDDGEDDEECFDDDFGDDDGFFDDGGDEDGGFDDCCFEDDDBDD<EEDD<GDEGBDDE=DDDGDBGEDDCADDEF<D@A?>	G	81	A	55
12	49434074	C	56	AACcaaaaAAcaccccacCaACACAcAaacacACCaacCCacACACaAaACaaACA	CA@AECDFFF?EDADDCDDDGGFGEDFEDDEECGGAEEGG;EEFEFFE=EF>=CCC	A	32	C	24
12	49582692	T	69	gTTGtTTTtTTTGTTGGGTGTTTGtGgGTTTTGgTTGTTGTTtTttGTTTTTTTTGTGGgTGTGGTTTt	BCCEEB;DEB;EEFFEBEEDFEFEFEFEEE:EEGEEEFEDDEGBFFDDEDEB?B5DEDDEEDDCDCB=C	T	46	G	23
12	50149604	C	31	ttccctcttTcttttctttcttttcttctcc	ABA?DDDEEGDEDEEDEEEDEEEEDEDDE<D	T	20	C	11
12	50156640	T	109	CTCTTCTCTTTTTTCTCTcTCTCtTTTCTTCcTCCCtCTCCTCTttTCTTCCTCTTTTCTTCCCTTTCCCCTTTcTtTCCtttCTCCcTTTCTTtcTCCTTtTCCcCCC	?CFEEGEGEEEEFEGDEEFEGDGFEEDGEEGGCGGEEFDFFEFDFFDFADFFDFDDCDFDDFFFDDDFFFFDDDGCEDFFFEEFDFFCCCDFCCFGDFECCCCCCABBB	T	61	C	48
12	50189834	T	48	ttTggGgtttggTtggTGTGgTgTggGgttgtGtGgGtGGttgGtggg	ADFEFEFDDDFFFDFFEDFEFFFFAGEGEEGEEBEGAEDD?EFDEFGD	G	28	T	20
12	50192009	T	61	CCCcCTCTTTTTCTCCCTTCTCCTTTCTTCTCtTTttTCTTTtttCtTtcCTTCCttccCt	CFGEGEGEEEEEGEGGGEEFEGG>EEGEEFDDDDEAFDFDCDFEFFDCFGFDDDFEDFCBA	T	36	C	25
12	50283465	G	32	agaaAAaAgGagggaagaagggagaagaaaaG	A?CCB<:FFGFFFAFEFF@FCGD<GEGGEGGF	A	19	G	13
12	50284583	A	57	AaaaaaAaataaTaataattataaaaaaataaaaattataatttaatttaataaata	;ACFFFEEFGFFDFFGFFFGFGFFEFFFFGF@FFAGG@GGGHH:GGHDHG;FHGFHC	A	39	T	18
12	52281920	G	71	GAAGAGGAGAAAGGAAGGGGGGAGAAAAGggGAGaaGAagGAAAGGAAAagGAAaGaGAGAGAGAAAgaAg	>BDEEGBEFB@FGGFEGGDFGFFFFFEEGGGFEFHGFEGEFEEEFFEEEGFFEEGFGEDFDEDBACB;<?D	A	38	G	33
12	52282748	G	88	GgAGggaaGGAaGgaGGAgAAgAGAGAaGGGgaaaaaagggGGaaGAAgGaagAaAgAaAgAGGGAagGAgAggGGggGAgAAGGgGg	@=A>DBFFCCGFCCFCCHDHHDHCH=HGC@CBGGGFGCDDDCCGGCHHDAGGDHCHDEGGDGBBBGH7BGDGDDBADDBHCCD=>:C@	G	49	A	39
12	52284620	C	251	TttTTCCCCctTTccTCccTTCTTctCTtCTctTTtCTCTCTtCTtTCCCCTTcTcCCTCTTTTcttCCccCtccCCTtCCtTtCCttCTctcCcCTcCCCCcTtTctcttttcctCtCcTCTctcCctCCCCttttTtCctCccTcTctCTCcttcctCCCtcCccccccttTTTCccCCtttcTCtTTTtCtCCCtttTctCttTccTTtTtctTctCcccctctcCtttCTTCTTCTccTCCCTCCcc	BC??=?<?=>DDC?@FCAAFGDGGBGDGGD@BGG@GDEAFCFGDGGGDDACEDBHA@DGDAGGGBCEDDB?DGBBDBGGDDH8GDDCGDGBFBDBDG;CDDC=?HGBHCHHHHCCHDHDCGDGCHCDCGDDDDHHHHDHDBGCCBECFCGCDC@HCCCHCCCHBC>CC=BCHHEFFCCCCCHHHAFCHFFCHCACCCHHHFCG@HHFCCFFHCH>HFCGCBBC;HCFBCAGGBDB>CDAC=<CAA@CCC@@	C	130	T	121
12	52471038	T	43	TaaaTttaatAtatatAaAatttaAtataaTaattttaaaata	BABBBEEEFEEDCEFEEFEFEEDF8DEEFFEGFFFEFBGGEE<	A	24	T	19
12	52708565	A	35	AGAgGagggAAaaaGagGaAaaGGaAAggaAAgGG	BCDCEF:FDGFCGFDGGEG;GFDCFEEGAGEEGDC	A	19	G	16
12	52790816	C	138	TTtTTTcCTCCCCcCCTCCTCTTTTTcCtTTTcTTtCCcTCTCcCCCCctTCccTCCTCcccTTCccccTtTccCctcTtcccTttTCcCTtccctctCCccttTTcttttcTtCtttCtCtCctcttCCccttttcc	:>FEEFDFFGFFEDGGFGFCGFFFFFDGE<GBCFFEEFCAFFFDGGEGAFDEAEFFFCGEEEE@GEEEEFEF?DGEFEFF:EDFFFDFE=EFDEBFE@FEFCEGEEEFFEFAEFEFEFFFFEEEFEFEFFCDDDCB=<	C	73	T	65
12	52818377	C	107	tTTCTCTCCTcTTTtTCTTccCCtCTTTccCttcTCCCtTtttttTcTctTCcCtTcTccCcTttttTtcTccCCtctCcCttCCtccCCtcCCttccCcttTCCCc	C?B>FBFD@GAGGGGHDFGBBDCGDGGHBB?GFCGCDDGGHHGGGGA?CHDD?DFGCGCCDCGHDHDGHCFCCCCHCHCBCBHCCHCCCCHCCCCHCCBCHHFCCB>	C	54	T	53
12	52827740	G	72	TccGGccGCCCgGGgcGccCGCCgCCGgGCgCGGGGcCcgGGCcgCcgGcGGgGgccgcgCcccGCCGgCgc	EGGCEGGEGGFFFEFGEGFFDFGGFF?GEFEFEEECHFHAEEDHGDHGDHDDGDGHHGGGDHHHDFGBCB:A	C	36	G	35
12	53002956	T	33	CTTCTCTTTTCcCCcCCtCTCCTcTCTcccTCt	<CGDG<GGGGDCDD5CDHCFCCF<FCFCBBEDG	C	19	T	14
12	53045777	G	45	aAAGgGAaAgGaAagGggaGaggaaagAaAaGagaggGGgGGAgA	A=C>CBGEHDCBHEFBGGDCFF=@FFFGEGDBFFCGGBBFBBGFF	G	23	A	22
12	53774029	A	31	aaCaCCCCaCaaaaCCaaaCaaaaAAaAaAA	DD9DD??DE>EEDE>7EEE7D<:>CC?C9C?	A	22	C	9
12	53876569	C	47	ttccCTCCtcTtccCtCCTTCTctTCccCTTtctcCTCtTcTtCtTT	:BBDDGGGEDGEDDGDGGEEFGEEGFEEDFFFD@EEFFDFEFC@;?A	T	24	C	23
12	54925072	C	58	tTCTcCTTCCtCtcccTctCtctcTTTcTcCcCcttTcCCCCCTctCTCtTTTcTtCT	?>>CDEFEFGEFECDDFDEFEDEEFEBEFEF?FEFFED<DCFFEEFFCFDEED9DFFB	C	30	T	28
12	54943775	T	85	AtAAATaTAtATTAAaTaaTTtTAtTaaaATTTTaaattAtTataTtaAtaaaTAtatataTTatttaTatTtTtAaattAtTtt	BC>>@@CBBCDDDFFDFDDEEEFFD=EEBFCCDFEDEEEEBFE;EEDFFE=CFEE?FFFF;FFEEFDFE>FEEEFEF6D7EFEA@	T	46	A	39
12	55794976	A	151	AaggAAAgagaAagaGaGagAAgGAggaaaggGGggAAggGAagAggGaaAgaagggggaaaagAGgggaGGaGgagaGaaagagAGaAaAgaaAggaagAGGGaggaagGaggaagAgggagaagaagagagggAaagagaGagGaAAgg	ACAC?CCCEGFEEEDGEGEEEFFGEFEEEEFEGGFDFFEEG=EEFEEGDEDCDEDFFEDEEDAEFGFDEEGGEGFEFEGEFFGCFC7FEFFGFFEFGFEDFGGGFGFFE9?FGBFF=EDGGFGFFFFEGFGFFGEEEFFFGFEEEFCCB?=	G	76	A	75
12	56080164	T	40	GTggGGtgGgTgtTtgtgttgGttggggtttgttgggGGg	CBDDFGEEGEGFCGEFDEDEFGEEFGFGDDFGFFFGBFF@	G	24	T	16
12	56088773	C	117	TTCTtCcCtTTTtTCCttttTCtCccTccctTcCccctTtttttctcctccCTTTcttTCctctCctcTTttttCCttTtCtcCctTTTtttctccctctcctcctTttccttcttt	DDDDC?BDDEEFEGGFEEEEGGDG?FG<FFEGFDFFFDGEDEEDFEF9EFFCGGGFEEFGGF5EGEEGDG<FEFGGFFFEAFGGGFGGFFFFGF8GFFGFGFFGGFFEFGGEEBA@=	T	68	C	49
12	56115585	C	78	CCCCtcTTTTcTtttCctCccccCctTcCCtTctTCtttctctCtcctcCcCcctcCtttcTCcctccTttttCTCct	DAB@D@BDC6BDFGFGBGGBBBBGBGEAGEGCBGEGGHHBHCGEHCCHCGBGCCHBFHHHCAFC@FCBDHHCGDDC=E	C	42	T	36
12	56151291	T	138	CTCCtTCCCctTCCTCCTTCTTTTcTtCtTCtccCccCTTCctCttTTTTTcTtctctctTTcTCtTttccCccCTTttcTCtCttcCTCCTCcTCTtCCtcTTtctccCCcTTCtttTTTTtTCttTttCCCcccCC	=>;?B@DFFEE>GGEGGEEF>EEEFEEGEAFEFFEFFGEEDFEGEEE<<EEGEFGFG?GDEEGDGFDFFGGGGGGDEEFGCG?;FFGFDGDDFFDFCFFFFGDDFFCGGFFCDDFEFFDDDDFDFFFDFFEEGFB?>?	T	73	C	65
12	56351346	G	175	GAAagaGggGGAAGaAAgaaggggGaaggAaAAGGgaGGAaGGGagAAAGAAGggAGAgggAggAGAAgaaGGgAgAggggGgGaAgaAgaAAagagGAggAGaagagaaaGAgaAagagggaAgggAGgaagGaaAaAagggAaaaggAAGaAagagaggAaaagaaagAaagg	A@>CA?=CCG7ECEF;ECFFAC?CHCFCCDFEEHHCFHGECHGHFCECEDECHCC@HECCCECCEHEECF@CH@?CEDDCDHDGGEDGEDGC?GCGCHCDDEHGGDFCFGFHEDGEGDGDDDGCDD9DGDGGDGGGDGDFDDDDHHGDDDD>GDGDGDD@DDFGBDGAFCCCCAA	A	90	G	85
12	56815281	T	101	CCctctCTCccCCtTTcctCccttCcCcCCCTCccTcCTtTccctCttCCCctctCCTTtTtTCTcctcccttCtctccttctctcccctctctccTtccc	B?CACECFGGGGGDE@GGDGGGDDGG=GGHGGEGGGGGFDFGGGDGEEGGGH=HEGGGGBGDGFFHHDHFHEEFEHEHFFDH?HE:HHHEH9HBGGF?AAB	C	61	T	40
12	56992345	G	153	TTTtTGGGgGTGTTTTTTTTTGGTTgGggGGgTgTTTTGGtGGGGGTTGTgTgGTGGgtTTTtgtTgtGTTGGGgGTGTGTgtGTTTgGtTTGttgTGTGTGgTTTGtgGTTTgtTTtGTTGGTtGGTtGTTttggTGgggGggggtGGtgGT	>C?CFEEEFE>EEFEGDFEF@DEDFFDFEEEGFCFFE=ADFEECDDFDDCGFGECEEFFFFF<GFDGFEFEDDEGDFBEDBEFDAEEGDFC@DFFEEDEDEDFEEDDFGDEE5GFEEFDE;DDBFDDEFDEDFFGFDDEFGDF?FC?BA@:CC	T	78	G	75
12	57146069	T	86	TGgtgTgGttGttttGGggtgGtgGGGtgtTGGttTgTGtTttgTgggtgtttttGGttTggttgGGtGTggtgggTgGTGtttgt	B@@CBADCEFEEEEEEE=FEFEEFEE@EFEFEEBBFEFE?FEEEEBDFEGFFFDDDEDFFFGFFGDDFEEGGFFGGDEDEDFFEC>	G	43	T	43
12	57346805	T	42	tGGGgtgggttTttGGtttttgTgtgttgggggttTttTgtt	A?@AEEFFFD7GDECAEEEEEGGDFGFFFGGGGFFGF@FFF@	T	24	G	18
12	57627717	G	146	GAGggAgaggGAaGGGgAGAggAGaAGgaaAgGAGgGGgGGGgGgagGgGgGAgaGaagGAAGgaAAAAGGaAgGAGGGGGaGaagAGAAaAGgGGGGagAgAGAGGAAgGGgaGGgAGggaGAaaAGGGGAAGAgGGagGaAaGA	BCACB:9CCFAEEDAEEF;FFFC=EFEEEDFFEFEFEEFEDEEEFEEDGDFEDFEEFFGEEFEFFFFFDEEDFGEEEEEEE=D=FFEEF>EEDF9DD>BGEGDDEDDDDGDBFGDDFE=FF;DEFEEDDD@EADDDDCEEBCB@@A	G	88	A	58
12	57865321	G	84	AAAgGgGGGgAGAAggaaGaGaaAGAGgAAAAaGgaaaagGAaGGGGgGAAGAAgGAAGaAgAGaAAAGAAAggGgAaGGAagg	?@?GDFEEE=FCFBF:FFEFEGFFEFDGFFFEGEDGGGGFEFGDEEEG8CEDDEGDEEDGEGEDGEEED;=EGGDGE>AACDDE	A	44	G	40
12	58139729	G	29	AgGaGGAagAgggggaagggGgaggggaG	>ADFEEFFCDC@?CCGGDDDEDGDDDDGB	G	20	A	9
12	58145156	C	39	cccttTcctcttcTccttCctCcCctTccccctttCctc	BABABFCDECEED>DDBEDDED:CEFGEEEEEEFFC>DB	C	23	T	16
12	62104219	A	98	CccCccCaccaAacaCcAAaacaacacacacccACAcccaAccccaCccacaaaaccCcccacCaaacaccacacAcacaaaacacacccaaccacac	DCC:?ABBDDCBFGFFFEEFFFFEFFFFEFFFFCGEFFFEEFFFFFGFFFFFFFGG>GFFFDFFFFFGGGGEGFGEGGCGFGGGGFGGGEFGGGGBD@	C	55	A	43
12	63359168	G	149	AAAAgAGAAAAaaAGGAAAAAgaAgGAGaGaGAGaGAgaGAAgaGgAGAAAagAGGAgAgaaAGaAAAgagaAaGaaaAGAAGGAGGaAAaaagggGAGAAGAAAGgAAAaGaGaaaGaGGagAaagaaaaggagAGAGAgaAaaaAAA	5EHHCACHHHHEFHCCEDHHHCFFCC;;FDECHCFCD?FCGHDGCCHCCGHGCGCBHDHDEGBCGHHHDGDGEGBGGFF<HHCCGCCGHGFFGDDD@GBFGBGG?9DGGFG>GBFBGBGBBGEGGGDBGFGCDFDG:GCGBEFD@CD>D	A	96	G	53
12	64491247	A	43	CCaaaaaaaaaaaCaCaaaaaCCaaaaaCaaaaaaaaaaaaaa	9ADD>EBEEDBD>7EDDDECEBDDEEFED=;<DFAFCAFEFFE	A	36	C	7
12	64668659	G	113	TGGTtGGGTGTTGGTGTTttGgTgTtTTtTGGTtTGtTgGTTgGGGGGGGTgTGGGGGgGGTgGTGtGGGGggGGTtGTgtttTGGGgggGGGgGtggttgTtgggGGtgtgg	D=<FECACGCGGCCGCGGFECFGFGEGGEGCCGFFCFG?CEEGCBCCCCBGGGACC@CGCGGGBGCF9BBAGGBBFFBFDEF>FBBBGGGBBBGBFGGFFGFFEFEB?A?>BD	G	69	T	44
12	66546100	A	88	gGAgGAgAAGAgggGGAgaGAAAAGaagGAAGgAGAAGAaAGAGGAaaaGGaggaaaAGGAGAagAgagggAgAaggGgGAgaaaaaA	A@>9CEEFFGFFFFGGFFFEFFFFGFFFGFFGGFGB@GFGFGEGGFFFFFFBGAFGFEFFDFEGGEGGGAEEDEGGGFEFEEFGEFCB	A	46	G	42
12	66696255	T	51	CTCTcTTTTTCCCCTCCTCTTCTTCCCTTCCTTCTCCtCCCCTCTtCcCcT	GGGABGFGFGGGGGGGGEGGFFFFFFFFDFFFFFFFFHFFFFFFEGABC?B	C	28	T	23
12	66909389	C	79	TTCCTCctCCCtTCCCtTTTTCCtCTCctCCCTTCCttcccCcctCCCTtCcTtTTcTCccccCctcctccccCTCCCt	DGDDGDDEDDDEGCDEEHGGGDCFDG>EFDDDG=DDFFDEDDEEFCCCFFCEEFFFEFCEDEECEFEEEE;DDBFCCCB	C	49	T	30
12	68707287	G	73	AgaAGaGaAAggAgGAaaGGAaGAAAGgaGgGaGGAGaAgGAAaggaaGaGaaggGgAgaGgGaAAAAAgaGg	=CFEFFHFBECCFCHEFFA?EFDEEBHDGH:HGGHE@GDDGDD>@DF6F7GGEDDGD9DGFDGGDDDD@;?B<	A	38	G	35
12	69199207	C	26	cCTctCTttCCCttcccctctccCcc	A8?AEDGEDDDEEEDEEDFEFDECCE	C	17	T	9
12	69202326	C	43	tccctttCTTtcCCCTcCtttccTcCttcCcccttccttcccc	CDDCDEEDGGEFDDDGFDEEEFF=FCFFGDGGGFFFGFF<FGG	C	25	T	18
12	69753830	G	86	GAAaaAAAGAAAagggaGGggaaAgaAgaAAgggAaggggggaaggagAggaagaGAaggaaagagaaaagaaaagaggaaaGaag	>@E??>BB:EGGFBCBFCCCCFFHCFHCFGH<CCBF@CCACCFFCCFCFCCFGDFCHEDDDGGCG;DGGFDAGGGAFCDGGGBGDA	A	49	G	37
12	70219408	C	120	ggcggcgcccGccCCGGgcggcgccgGGccGcgcGGCCgGggCcgccgcggcGCccGccCgcgggGccgcccgccccCgccccGgcccgcgCggcCcgggcgcGcccccgggcccgcggg	??A@BBADCC@EECCBBFEEEEFEFDCCFFCEFFCCDDFCFFDFFFFFFFFFADFECFFDGFFFFCFFGGG>GFGGGDGGGFGCFGDGFFGDGGFDGGGGGGGBGGGGGGGGGGGGGGBB	C	65	G	55
12	70291047	T	117	gtttTgtgggtggTtGGttgtGgtGttttgTTTttTTggtTtGgTtgggGGtGTtttgttgttgTTggGGTttgtGgtggttgGTttgttgtttgtgtTgtgggTggGgttgtggtt	AABC>FEEFFEFFEEHHEEFEHFEHEEEEFE<DEEEFFFEEEHFEEFFF6HEHEFFFGFFGEFGEC<GHHEFCGFGGEFGFFCH;FFGFFGFFFGFCFDEEFGGDGGGGFDFEFDBB	T	64	G	53
12	70963770	A	26	caaaaaCCaaacaAccaacccaccac	BBDDDDGGDDDGDFHGECGBHFHH8@	A	14	C	12
12	70989977	T	72	cTTTCTTCCtTTtTtTCTtcttCcTCcTTCTCtTttCttTCcTTTctCTcTTtCcCCcCTcttCTCctCtTc	?@BDGEEGGEED=EAEG=EEFFGFDGGCDGEGFEFFGEE9DGDDDGFCCGDDDFGF8GFDGFFDAEGFFDDC	T	42	C	30
12	72028147	T	44	TtgtgttgtggtgttttgttgggggggggtgtttgttgttgGgt	DCAGBGG9GCCGCEGGCCGGC@CCCCCDBHCHHHDGHDHFDF?;	G	22	T	22
12	72372862	A	134	GAAGaGGgGGaaGgAGgAgaggGGgAAgGagaAgaaAAaGggAAgaggAGAGAAgAAggaAAAAGaaGAAGgAGaggAAaAGgAgaaggagaaagaaAgaaaaAgaaAagggaaggggaAaaggaaggagggaa	@@@7D<=B8BFFBCG=CHCFCCCCCHGCCFCFDCFFHHFCCCH9@FCCFCHCHHBHHDDGHHHHBGG@HGBDHCF?DHHGHCDGDGG>AA>FGEDFGCDGGGEGDCGGGD>E?GEEDDFGFFDDFGDDADCEGE	A	72	G	62
12	72969198	A	64	cccCCcacaCcaCACcCaCcCcCcAccAAAcCCcaaaCCccCAAcaCaaACCcAAaCCCAaacc	CGGFGEFFFGFFGFGFGFGFGGGEEEGEFFGGGGGGGGGGGGCEGGEGGFFFDEEDAFFCGAA@	C	40	A	24
12	75057931	A	28	ttttATaataaaAattTtAaTattAata	EEED?DDEEFFGEFEFFEEFFGEFDGFE	A	14	T	14
12	75824460	T	49	CCTCTCCTCCTCTTCTCCCCCCCccCCCTcCTcccTTtcTCCcTTCCTC	GGEFAAFEGGEGEE<DGGFFFFFHHFFFDHFDHHFDCEHDFEFCDEFC>	C	33	T	16
12	76780471	A	45	TtTaatatTaaTtTaTatTTttTTttatttTatAatAttattttt	BCAEDDDDEDDEDEDED:EEDDEEEEEEEEEEEEEEDDFEEEEEC	T	32	A	13
12	78334053	G	116	CGCCGCCCGCGCCGCGCCggGCgCCccCCGCGCGccGcCcGccGcGCCCCCccggCGCCgGgCCCCCGGGcGGggGGCGCCCGGGGCGCGGgCccccccGCGGGCcCgCcgCGcCC	=>CEHGFDHGHGFHGHGGFFGGGGDGGEDEGHGHGGHGGGFFGHGHGFGGGFGGGGGFFGHGFFFFFGGGGGGGGGFFGFDFGGGGFGFGGGFEGGFGFGFGFGFGFFFFBACA>A	C	68	G	48
12	78534233	A	38	gaaaggaagaAgaggaaggAggaaAagggaaaaaaaga	CA>CDFCCFDHFDFFDDFFHFFDDHEGG@D9DE<EEFE	A	23	G	15
12	80663952	G	134	agAGAGAGAaAGAgAGaAAAgggAAaaGGAGgGGGGGgGAAGAGaaGGGAaAaAggGAgaGGGGGAggGagagAAaagaaAgAgagAAGgaGGGgGggAGgAGGGaGggGGaagGGggaaagGgGaAgaggAaa	CCDHD:=HEFEHDEEHFEEEFFFEEFFHHEHFHHHHEFHEEHEHFEDHHEFEFDFGHDGGHHHGCEGGHGGEGEEGGFFGEGDGGGDCGGGGG@8GGGDGFDGEGGGFGGGGGGGGGGEGGGFGF?CFFEF<=@	G	75	A	59
12	80762246	G	36	gaAgaagggagggaaagaaggagggaaaagggGaaa	CC:CBDFFEDFFFDDDFDDFGEGFGEEEDFGGGEEE	A	18	G	18
12	81063264	C	28	cttcttctcttcttcCccttttcctctc	>EFCHEBEBGGBGFB8BBGHGHCCHCD@	T	15	C	13
12	81696399	G	149	AGgGgGAAAaGGGgGGAGAgGAGGaGGAaGAaAAGGgGGaaAGAGAAAAGGGAAGgGAGAggGGaGaAAAGGGgaaaAgaaggaggggggGgaGgGaAagggagggGggaagGgAgggaaaAGaaaaaaggaGgggAgaaagGaaGggg	EAC9@7CGFFBACCBBHCHCCHBCFCCHFCHFGICCCCCFFHCFAHHHHCCCHHCDBHCHDDCCGCGHHGCCCBGGGGDG@DDGDDDD@DADGBDBGGGCDDHEDDBDEGFCBDGDDDGGGGBDGGDGGDDGBDDDGCGCEB@CD=;:A	G	85	A	64
12	82780676	A	66	AGaAGAAGgAGggGaAGGAGgAAgaAGAaaaAgagaaAAAAAaAgAAgAagAgAAggaAagaaGga	D@DDFFEGFFEFFGAFGGFGF?FFDEGFDCDFFEGECFFF>FCEGEE8FFDEGEEGFCEEFBACBB	A	41	G	25
12	82792787	C	49	ACcaACCcAccAAaAAAAcACaCCcaaCAACccaaCAACCAAAACcCaa	A@EDEFGGEGH<FEFEF?HFFEFFGEEFEEEHGEAFCEEEDEDFC@B?A	A	27	C	22
12	92818786	A	33	gGAggGaGggaGGgGAaagagaaggAagagagg	DEFFFFDGFFDHGFGFDCGEGEEGGECGEFEFA	G	20	A	13
12	96927986	A	27	Aatttatattatatattttaatataaa	><CDDDDDD=CDCDDDDDEDEEEEAEF	T	14	A	13
12	98849179	T	80	tCctttTTccCTccCtCcCtttcCTcTtcctTTcCCTtCtTCctcCCTCTTCcctTttttcTtTTCTcTTtTCtCcCttT	@<>CBAA>@?BECCFEEDGEEEDGFDGADDEFF=GGF:FFFFEFEGGFFFEEEDFEFFFFEE?EEEEBEEDDEFE@?A?C	T	44	C	36
12	98993356	G	137	GGCGCCCCCCCCGGCCGGCCCCCGGGCGGCCGGCGCgCCCGGGGGGGGGCGCCGCGGCGCCgCgCcCCcGGCgcccccgCGCGcCGGGGCCcCcgCCcCgcGGggCCccGCgGGgCGgcGGGCGGcgcGcCCgGCGc	>:GE@GGFGGGDGFGGGGGGBGGFGGGFFGDGGGGEDGGGGGGGGCGFGGGGEFGGGFEGFDGDFCFFCFFF>BCCC8DFFFFCFFFFFFCCFCDFFCFDCFFCDFFCBEFDFEDEFC@FGFCCC=>>C=>A<ACA@	C	72	G	65
12	99166805	G	36	GGgTTTTTGGTTTTGGGTgGTGGTTTGGtgTTGTtT	EECFDF=EDEEAEFDEEEDD;DDCEDDDHDDCB:>@	T	20	G	16
12	100676960	C	144	CccACCccACacaccCCccaCcCcAaaAAaAACAaCACCaCcCAaaACAAaaCCccacaaccCAccccaacccCcacaccaCccaAAccaacCaaAcaaaacaacccaaaaCcccaccacaccacccaacacaccaccacaccc	BACA>>ADA?DCDDDDDCCEDDDDHEEHHEHHDHE@HDDEDDDHEEFEHHEEDCDDEDEEDDAHDDDDEFECCDEFEDEEE@EEEGHAEEFECFFGEFFFEDEFEEEF;BFCDEBFEEFEFEEFEEEFF;EDFAEFEEFDEE@B	C	81	A	63
12	101018161	C	157	TTcccTtTTtcTCCttCctttttCcttctctTTttTTCTccCcccCCCcTTctttTTttTCtCcCTCCctTCTcCccTCTTtctcctcctcttctccttCCccTCccCCTcCcTtCCCttcTTCcccttcccttttttttTTctttTCttctccCtt	D?BBBBBEFAHGDCDCBGCBC=CDGDDGDGDGGDDGGDEGGCGGGDDDFG<GDDDGGDDFED@GD=D?GDGDGG?HGGDGGEHCEGEGBEHEEHEDHDEDBHHFCHHDDGH?FGECDDDEFFFCHHHDEGCI<EEEEEE<FFHEEEFCDEHBHHCA@	T	82	C	75
12	102045231	C	29	CTTcTccttcctttttccctttcttctcC	D@CGDEFEEFAEEEEEFECEEFFFFGFGF	T	16	C	13
12	102108345	T	115	TCCCtTTCCCTCTttTCtTCTTCTCTccCCcTCtCtcTcCTtcTCctttCctCTtTTCCCTcCctttccTTTCttcTccCTctccTCcCTcCTctttcCttcttTctcccccttC	?CFEFDCEEFEBEEEEFEF;EBFEEEDDAGDEGEGDDEDGEFDDGDDFEGEFGDFDEGGFEEGEFFFEEEEEGFFEEEEFDEFEEDFEFDEFDEEFED=FFEEFDEFE@EDBA@C	C	59	T	56
12	103237468	G	68	GGGGGggCGgGggGGcgCCGgcgGggcggcgGgggCggccccGcGCgCGCCGCcGCgCgCGcGCcgcC	<BDGFFFGGFFFFFGGCGGGFGFGGGGGGHGGGGFGGGHHH;FHFFGFFFFFFCFFGFGFFHEEC=C>	G	41	C	27
12	104124061	A	64	AAGgAaAGAaaaGAgAgagGagGGAGgaggaaaggAaaagAaaaaGAggaggaaggagaggaga	CCACHFGCHFFFCHCHCFCAFC@CHCDFDCGAGDDHGFGDHGGGGBGDDGDDAGDDGCGDDGDG	A	35	G	29
12	104703836	A	48	aaaaGaGgggGaGAgaGgGgaagagaaaaagagGggggGaaAggAGGg	?BCBGE<FFFHCHCFDHFGF@EGB8E;FE=FFFHEGG@GFEDFFDGFD	G	27	A	21
12	104733165	A	71	aAgaGaAggggagGggggAGagaGgggggAaGgGGaggGAgggaagaaggaaagaagaggggaaaggaggg	@ACEECEFFFFDCGCFFFFGDFDGFFFFFFDGFGGDGFGFFGGDDGCDGGEEEGEEGEGGGGDDDGEEGF@	G	44	A	27
12	104741958	C	28	CCCTCTTCCTTCTCCTCCTTTTTCTTCC	DDDG@DFDDGGDGADGCCFFFDECEECC	C	14	T	14
12	105444410	C	112	CTTctCTCTTCTtcCtccCCCcTTcTtCctCTCttCtcTctCCtttttcccCTTttcCcTtctttCctTccccCccCcCCTtcCcTCctttctttcTtccTttcCccctctc	=B?E6DGDDFDGDGDDF@DD;GEFGHDDGE:GDDD>CHGFE7DDEEEEHGHDFGEEHDHGDHDEEDHEGHGHH=HGCHCCFEHCHECHEECGEDFHFEGHFCEHCHCHEC;D	C	60	T	52
12	105611333	T	33	TCCTCTCCTCCTCTTCTCCCTTCTCTCTCCCcC	GDDGDGDCGDDGDFGDFCCCFFCFCFCFCBCCA	C	20	T	13
12	106708278	T	39	ttggggttGGgtggTtgtgttGtggGttttgtggGtttt	CDBCCCBFCCCGC<GGCHCGHCHDBBHHFAD=DDAHH;9	T	20	G	19
12	108035805	T	98	TCTCCCcTCcTCtCCCCccTCtctttCtCCCcTTctcctcTTCTTCTCcctCCTCtTCTTCcTCTCcCCTCCTCCtTtcCTtctCtCCcCTtTTTccT	<GEG@HCDGFEGEEEGGGFCEFFFFFGFG@GGAEGEGGFGEBDE9EEEFFFEFEF<DFD@FG<FCFGF=9FFCFFFDEGFDFFFDFEEFDCBBCCA=@	C	55	T	43
12	108086896	A	79	CaCccccCAAcCacccaacAacaaacaaCacccAaccccacAaACcaCcaacaaccccacaaccaacccaaaacccccc	D@AEFFHEFFGDDGFGCDGFDGDDAGDCGDGCGGDGGDGDGFDFFGDGG:EHEEHHHHEHEEHHDDHHHEEEEH9HHHG	C	45	A	34
12	108093241	A	154	GAAAAAAGaAAaAGGAGaGgAGAAAaAAGGAgGAaAaAAAaAGGGGAGGAGaGGGagaAGaaaGAAAgaGAAAaggGAAGGAAAAGgaGgggagGaaAAagAGaAaaAAaGAAAgaAaaAGGggAgaAaaAAGgaGgaGgGAGaagaaAAagGg	EC>==@?DDDDCEGHDGDFFEGEEECEEHHEDHEDEAEDDDEHHHGEHFCHEHGHEGEECEEBHDEEGEHDEEEGGHDDGHEDDDGGEGGGGEGHECDDEGDFDDE@DDEFD7DFDDDEDGGGDDGDDECDDGGCFEEFGFDGDBB??<A=9CB	A	93	G	61
12	108954502	G	27	GAAAAAaAAAAAAGAGGAGAAGGAGga	GFF=FFFFFEFDFFFFFEBEDFFEGBB	A	18	G	9
12	108956610	C	45	cgcgggcccgGcgCGgcgggggcgGggcggggcccccggggcggg	DECEEEDDDEHDDGHFDGGEEGDEHGFEFFGFEEEEDEGFGE8FF	G	29	C	16
12	110231717	C	70	CCCCCcCCGCCCGCGGGGCcGCCGCCCCCCCGCCCccGcCGccGCGGcGCCCGCGCCggcGGGGGGGcGg	@EABGBGDGGGGGGGFGGG5GGGFGGFFFFFFFFFBCFCFFC@FFFFCFFFFFFFFEDDAFECCB:B:C@	C	42	G	28
12	110783241	G	37	ggagagggggaggaggagagaaaaggagaaggagaga	C=DAFCCCCCFCCFCCFCFCFFFGDDGDGFCDGDAAE	G	21	A	16
12	111317904	T	45	tctccTttctCttcctCccccttTTctTttttcccccctTTctcc	@DAEGGD?GDGDDGGDEAGFGE:GDGD@EDEDGHGHHGBFFH>GH	T	23	C	22
12	111747963	C	54	TccTCcCCCCtcCCCcCctcCttTCCccTccCTtccCtTcTTTtCCTcTtCcCt	D?@ECBDDDDGBDDDBDCH>DHGG>D9CFCCDGGBCCHF;EFFFCCFBF<BBAC	C	34	T	20
12	111799681	T	100	CTtTccCttTCTCCCcCTCTtttTCtcCtcCcttcTTcTtcTtcTtCtTCTtCcTTCtTTtCTtCcctttcTTTCccttcttccCCtttTTTCctcCtCc	A=>AEGDCDHCGDDCGDEDGDBDHECG9DHDADDGGCHFDHCDHGEDEGDGECHGG@EDGE=GCDGHEEEHEFFCHI;ECEEGHCCE>EEEE?H=DB=A@	T	55	C	45
12	113531926	T	29	ttTTttTTTTTTTTTTTTTTTTTgggggg	AB>BCE?EDGEGGDFHGGGCFFF8D@?<5	T	23	G	6
12	113807039	G	47	AgaGgAgggAGgagaAggaagaaaagaggagggaaaaggagaaggga	?;CDD@CCCFECFCC=C8FFCFFFGCGDDFDDAGFFDDCGDGGDDCF	G	24	A	23
12	117287112	C	125	TTCTCcCcCccCTTTTCcccCTCcCTCCTTCTCCcTTctTccCCtCCcTTTctccTCTTCTTttctTTCTTCTcCCtctcTTCCtCttTcttCctttcCTTtCCCCCcCCtttccCtCcCCtcTc	<B?@BEBD8DDDGGDGDDDD@HDCEG>DG=DFDDDFGEEGDEADFD>9GGGEDEEFDDGDGGFFEEGGDFFCEECCFEFEFF=CDCFFFEFFCEFFFCCFFECCCCCEBC?FEEEBEDDBA<@CB	C	69	T	56
12	118508796	A	233	GAGGGAaaAAGGaaGAGAGaAGAGGGAAGGAAAAggAAAAAAgAGaGAAAAGAGAggGAgAGGgAGGAgaGGAgaaaAGAGggGGgggaAGGagGGGaaaaAaGAAGGAgAAAaGGagggGggggGgaGaAgAGaaGGGagGGGAaagaAGaaaaGgaAgGAgGgGgAggGGAgAGAaaaggggAGgagaagagaaGGgagAagGggaaaGGaAagaAgAgaAgaAaggGAaa	>C;;<;BBDHCCDDCHCHCDGCHBCCHHCCHGHHFFHHHHHHFHCDCFHHHCHBHFFCHFHCCFGC<HDD=CEFDDDH>HBFGCCGGFDHCCEGCBCEEEEHEC<HCCHGHHHECC9GGGCGGGGCDECDHGHCEECCCEGCBBGEEFEHBEEEEBG=GGBGGBGBGGEGB?FGGBGFFFHHFGGBGEGEEFEGEEBBGEGG>GBEE>EEBBEGEFEGGGACDDA@@B@C?>B	G	119	A	114
12	118509124	A	27	GGGAaGAGAGGAAGGGGAGGAAGGAAA	GGFFEGFGFGGEDFCFFEFFEEFFDB?	G	15	A	12
12	120614093	C	36	CcttCTcttcccttCTtttcCtttctTccctctctt	D@CDGEDEEDDDEEGDBEFDGFFEDB=DEEFED@A>	T	20	C	16
12	120791197	G	46	gAGGagAggAgagaaGgGgaGgAagGGagGGgAggAggaGAAgagG	C=DEFCFCCFCFCFFECEDGEDEGDCEGDEDDEDDEDDGDEEDG@B	G	29	A	17
12	120934407	C	242	TtTCTcttCTTTTcCCccctcCCTTTTttCCcccctccTCctcttcTTTCtcttCcctcTccctcTCCCTcCCcCccCTTctCTTtCCTCtCCtCCTTcCTCttTTccctccCtCttcCTTCtccccTTCcttCCTttCctTtctcctCtctcttcttcctcttctttccTccccttCTcccccctcttcccttCctcCcTTtcttctctcctctccctcCttctCtctcccctctctcttt	BA>B=@?CA?=>6ABBCCBCBCCAAAABDEFEDEEFDB:E@DCEDDCE@DDCCEEADEDEDDBEDDEGEDDEGDGDDEE>DDGEEEGGEEEEFEBGCDDGEGEEBEDDD=DDGEFEECFDFFEDCCDEEED<E8GEEEGDEEEEEDDE@EDBDEEEEE=DDDDEDEEFEDEEEEEFF<DEEEEEEFEFEDEEFFGBADFED>FEFFEEDFEE:9FEEEFEDFDEFFFEDEEEEE<EDDBB>@	C	131	T	111
12	120998443	A	31	GGAAAGAGAAAAAAGGGAGGaGGggAagAAA	BGFEFBFEFFEEEEFFFEFFEFFGGEEF?BC	A	17	G	14
12	121222411	C	78	GgCcCgcgcgCCcCggccCccCGGgGGcCCGCggCCGccgGGggccCcCccgCGCccGGccccgGGccGggggccggg	CC@DEFGEGFGGFGFDGFGGGGGGFGGGGGG9FFEGFGGFGGEGHHGGGHHFCGEHGFF@HHHGFFHHFGGGEHHB@?	C	42	G	36
12	121659999	G	193	gAaaaGAAAgggggGgaaaagaagGAAaaaAAagggaAagaGggaaaaagaaaaggaagaggaaaGaagggggggaagggaaggaagaaaaagggagGagaaAGgaaaagaaaagagAggaaaaagaaggggGagaaGGggaaAgagaggagaagaggggagggaagGagagaaaaagaggaggggagaagaa	ACACD7B??:A:CDBBFEFEBEFBCHGFFFGFFCC7F=FCFCCCFFFFFCFFFFCCFFCFCCFFFCFFCCCCCCCFCC?CFFCCFFCFFFFFCCCFCCFCFGHCCFFGGDGFFFDFCHCCEGGGGDFF:CDDBGBCGCADDGGHDGCBACFDGGCGDDD9GDDDGGDBFDGDGGFGGEGDEGDDDDEDFFAAD	A	104	G	89
12	121690555	T	37	ttTctccCtcttcctcctCCtttttctCcccTtcTtc	C?=>H5AGG=GGBBGBBGFCHFHHFAHFCCCAE<DD<	T	19	C	18
12	121861424	C	257	ACAaaAcaCAaAcaCCCccaccaCCCaaaAAcaacCACccAAaCaCacaaaaCCAACaCCCCCccACccAAaacaCaCaaAccaaacCCAcAcaAAccaAaaccAAAAaAaAACAcCCCCCacaCACaacAcAcaacacaacaccaacccccccaaaCAaacAaaaaccaaacacccaaccaacCcacacCaccccaaacacaccccAccacccaCAccaAacaccacCccaaaacaaaCaacacaaaaaaaaaaca	EACA???69BACEDCB5GFCGGDDCACDDHHGDDGCGDGGHHDDDDDGDDCCDDFH?DDDDDDGGHDGGEEDDGDEDECCD>DDDDGA=GGEGCHHGDDHEDGGHFGGAHEHHDHHAD7DDDGC?HDDEBHCH=DEGEHEEGEC9EEHHHHHGHEEC@HE;HHADEEHGEEEDE:HHEEFGEE:CHD8EHDEG6H9EEDGEHEHCHHGHGEHADE?GHHEGDHEGCEFCI:DCEEHEEECECHEGEEEEEC>CD??B	A	136	C	121
12	122353796	A	75	AGaAaaGAaGAAGAgagagggAaAgaaaGGAggaAggaaaAgAGgAGGggGagAGAaaaaAGGAagaaAgAggGA	AEDFDDEFDAFEDFFDFD<FFFDFGEDDE?FGGEFGGD:BEGFDGFCDGGCDGEDBF@EDEDDEEGEEECEGFAC	A	42	G	33
12	122396395	C	187	cttccccCcCCtTTTTctCCcTTCtTcCtTTCCTCtTtTcCTtCtTTttCCtccTcctTCctttccTTccTTccccCcCcCTcCCCcCtttTTCCCcttCctcCtcctcTTCccCCTccTttctttTTTctTtCTtCctccCCtCTccCttctcCCtTcccTcTttCtttCCtcttctcctccCtct	CCCCCBC?CBBAAEE@EEFEFFCEECFFEFDFFFEEFEFFDFDGBFCEEGFEFFFFFEFGFEEEFF;BFF=DGGG?FBGGGFGGFFGGFFFFFFFDGFFFGFGGEGFFFFEFFGGFFGGEAFGEFCDEEGFDFFFFFGDGGEFFEEGHEFFGFGFEE>GGBDGEF;EFFFFEDFDEFB=@A:??BB@	C	99	T	88
12	123028096	T	39	TcTtTCttcCttcCctTccCcTtcCTtTttccccctctc	>FDC9GBDGGDDGGGDEGHFHEEHGEEEEEHDGHHEHEH	C	20	T	19
12	123103016	G	94	tTtTtttGggGgTTgGGGGGggGGTTGgGTgGTGGgGgggTgGgGGGggttttgGtggGggtgggGgGgGggtggTggggGGggttgttttgGg	?=>ADDDGFGGEEEFHHHHHFFHHEECFHEFHEHDFHCGDDGHGGGHDFFEFFCHFGGGGG?DGGFGBGGGGDDGDGFGGGCDGF@EFEBAADD	G	66	T	28
12	124101041	T	82	GTGGgTGGGGGGGGGTTTGtTGGGGTTGTTGggggTGtTGGTTTgTTttTGgTGTTTGttggTTGGTGGTTTGTGgGTtGTG	CEHHFEFF@HGHFGEEEEHFEHHHGEE?EECEDDGE;FEHGDDDGDDFGDGGDGDDDGEEGFD:GG<GG;DDFC<AC@>AC?	G	44	T	38
12	124427887	G	68	GCCCGCCCGCCgCgCCgGgGCCCCgCGGGcccCGCGccCCGCCGcCCGGGCGccCGCCCGCGGCGggc	@DCDBCDD<DDFD8DDGCFCADCDFCCA@HHHCBCBGG@CBCCBHCABBBCBFHCABBC:A>:@=<AC	C	40	G	28
12	124829234	C	37	cTTCTTCcTcTtTccCtCtttCTTTtccTCCCtTCtC	?C>GEEGGBGDDEHHGEGEDEFDDDDHHDDDF=A9=C	T	20	C	17
12	124838591	C	32	CCCGCCGGGGGgCCGgCCGGGGCCGCCGCCCC	DD<CDDCBBBBGCCBGCCBB:BBBADC?BBA<	C	17	G	15
12	124859090	G	96	TTGgtTTGgGtGTGGgGTgTgGttGTtGGgtgtGggtggtggttggggtttgttggtgggtggtTggtgtgttgtgtgggtggtgggtgttttgtt	B??ABDCEBEEGGGGCFGCECGGGGGGGGCGCGFCCG?CGCCGHD@CCHHGDGHDDCDDDHDDEGDDGDH=HHCGDDDDDCD8HDDDHDHHHHDDC	G	53	T	43
12	124873079	T	30	TTGTGGgTTGGtTGTTGTTGgGtGGgTGGG	FGGGGED=@FGHGFF8FFFFDFHFFDFBAA	G	17	T	13
12	124957627	C	71	ctcCtctcTCtCCTctTttcttcttcTctcTtCcTtTTtccctttctTtcctCcttccccTCtcctcTtcc	CCC@D@HBDEFFG?BG<GGBGGBGGBFBGBEGG=EGEEHBA9HHHCHF9CBHFC@H@CB<EEG@@ACCH=>	T	37	C	34
12	124979833	C	34	gcgGGgccGgcggCggcGgggGGgCCcccgcgcg	AABBCFDCCFDFEDFCDCGFFCBFCCEDDFEGD?	G	21	C	13
12	125438414	A	32	AAAGGAGGGGAGGAGGGgAGAAAAAAAGAgaA	BBCCCHC;BCHCBGBBBFGBCGGGGEGAEB??	A	17	G	15
12	125438549	A	124	AGaAgAAaAAagGAgGAgAGaaaGGaGGaAaAaAGgAGAgAAaGGaaaAGagaAAAaGgaGgGGAgGAAaggAGaagGGAAgGGAGGAAaagGaagGgAaAAggAAGgGgggaaAAGgGgaAaa	@>BDF?FDEFCFEFFEFFFEDDDEEADECFDFD9EFEEFFFEEEEDDEFEEGEEEFEEGEEGEEFGEFFEGGFEDEGEECEGEEFEDEFEEGCEEGDFEEEEGFEEDGBFGFDEEDC?CAA?BB	A	68	G	56
12	125451532	G	26	cCcccCgccgcgcgcgGcgcCcccGg	AA@CBCBBBCBCBCBCCCDBCCCCBD	C	17	G	9
12	125456004	C	34	caAcCACcCaccCCacACaaAcaacaAcAcacac	C7EDFFFDFEDCAGEDFGCFED:FEEBEEEBECE	C	18	A	16
12	125457203	G	30	gggaaggaggaagaggaagaggggaagaga	=BDEFCCFCC?FC=5DGFDGDDCDGGDGDB	G	17	A	13
12	125834095	C	103	aAcccAccaacaaCcCCAcACACccAcCaAAcACcCacCcaCACcCCCcCCaCacacaaaaCCccaaacaCCACAcCaAAAcaAccacaCcAAAcAccAaaac	CEFFFGFFFFFFFBFDCHFH@6DGFGFDGHFFHDGCGGDGGDHDGDDDGDDGDEGGFGGG<DDGGFGFGGCCGCGGCFGGGGGGFGGGECEGGGED@DD?@?B	C	56	A	47
12	129028401	G	55	GCCGGCGCCCGGCCCGGCgCGgGGCCCCCcCgCcCGCCCgCCcGGgCGCCCGGgc	DCEGGGGGGGEF8GGGGGFGFGFFFFFFFEFFFFF=FFF6FFEFFGEF>BABC9B	C	32	G	23
12	130830906	C	38	TCTCTCcTTcTTTTCctTCcTCtTCCtCTtCTTCCTCt	?>HDGDGFGFGGGFDGFFCGFCFEBDFCFFCEEBCG?C	T	21	C	17
12	131687263	C	81	CCTCTTTTCCTTTTcTtcTccTTTCCcTTTTCCTCCCTTCtTTCcTTCTTtCCCcTtcTTCTCCTcTCCtCCCtCCcttTc	A@DCGGGGCDGBGGDGEDGEEFGG:DEGGAGDDEDDDGFDEFFCDFFCFF<?CCDFFEFFCFCCFDECCEBBBDB>AA@CB	T	42	C	39
12	131692116	T	45	TCCCCTTTTTCCCTCtTCTCCCTTCCTTCTTTTCTCTCTTTTTTC	>FFGFE>FEGGBG@FHFGFFFGFFFEFFGEEEEFEEEE<EEDEEA	T	26	C	19
12	131692211	G	138	GGGGGGGGGgGGGggGAggGGGGgGgGGGGGgagGGGGAGgggagaggGgaaGgGGggGGGGGGGGgGGggGGGGGAggaGGGGgGgGGGggGGGGGaGgagggggGgggggggGGGgGgGgGGggGGgggggGgggG	?B;=CCCCCFCCCFFCHFF@ADCFCFCCCC?FFGACCCHCGGGFGGGGBGGGCGCCGGCCCCCCABEB>EGBBABAGGG?BBBBGBDBBBGHBBBBBGBGGGGGGGBGFGGGGGBBBE@G>DBBGFBBGGGFGBEB@A	G	127	A	11
12	131954010	C	75	CcccCCCcCcTcCcCCccCCcCCCccCccCCTTcccTcccCcccTCCcCcCCcCCcTTTcCCCccCCcccccctc	DC>BEG@BDBDBGBGG:BGGBGGGBBDBBGDCE@BBGCABGBACGGFBGBEG=GGCFGGAFGFCCFDCCCCC=E@	C	66	T	9
12	133306589	C	152	ctttCtctcTccCCTttTcTCcTtCccttTTttTCtcttTCTtttCctCCctTcttCTtcTctttTCcCTcTcCTtCCctTTTTccCtctTccTTCCCctCccTcTCccttcTttCTCtctttcTCcccctccttccTcTCtttttttttcT	ACDECD?H@FABGG;GGGBGDBGGGBBGGFFGGGGFBGGFGGGGGGBGEHBGCBGGGGGBGBGGGGFBGGBGBGFHGGBHG@GFCCGHCHG=CGGGGGCAGBCEBGGCCHHCFHH;EEHCHHHCFFCCCCDCCHHBCFCFFFHHHHFFHG=A	T	83	C	69
12	133311888	C	33	CGCCCGGCCGGCCGCCGGGcGCcGcCGGgccgG	AEGGFDEFGE;FFEFCDDDEDFEDEFDDFDEFB	C	17	G	16
12	133311944	T	59	TTCTTCCCtCTtCtTCCcttcCTTCcCCCTtcttCcCCcTCttcTcctCTTTCTctTTT	AFFFGGGFCDGGGGGGGBGGFGFG8CGGGGHCHHGCFFCEFHHDFCCHFFFEFFCGGFF	T	30	C	29
12	133349764	C	81	CCctcCtTCcCTCTcCtccTttTctTtCccccccCTcTctcctcccctccCcccctTtttttcCTtTttCctccCCcccCC	CCCDCEDGGDGGGGDGEDDCEEGDEGEGEEEEEEG:EGEEEE:EEEEF;;GAE8ECCEF<FFDFFDE??FECEEDB:>>B@	C	50	T	31
12	133354485	G	106	GAgggGaaaGAaGaagAGgAgaGagGGagggaGGgagagAagaaaaGAagGGgGGagggagaaaggggaagggagaagaggaggaaagggagagggaaggggagaA	;@>AA>BCC=BC>GEEAA@HFECFFCBFFFFFCCFFFFFHDFFFBFBGFFC<FC;FFFFFFFFFFFGGEGGEGGFDGGGFGGGGGDGGEFGGGGGGHHBFEGEGEG	G	60	A	46
13	21729252	T	137	CTccttcctTcttCTTttcTTctttTtctttTtctcTTTctTTtTTTttTtCccTcCtTtCcTttCTttttctcttctttttctcttcctttctTcttTccctttttttttttttcttcttctctttCTtCttttCt	BBCCCCCBA@DCCFDCEEFEDFDEEEEFEEEEEFEFEEEFEECEEEEEEBEGCEEFGEEEEFEEEEDFEFEGFGFFGFFEFFGFGFFGBFFFFFEFFFEGGFFFEEFFFFFBFFFGFFGFFGFGFFEFDFFFFFFFE	T	97	C	40
13	22033122	G	30	GCGCGGGCGGCCCCGCCCGCGGGCCGCCCC	EF;DEEEG9EFEEFDFFFDEDCDEEDEFCA	C	17	G	13
13	24242165	C	149	tCTTCtCTCTTTTTCCCTTCCTTTCTCCTTCCTTCTTTTCcTcTTTtTTtttTCCCCtTTTCCtTTCcTTTTTTCttCCCcTTTTcTcCtttCTtTtTTctCccTCCtTTtcTTCcCCCTTcCTCCCTttccTtctCCtcttttTCTct	BA?@?CBCDEEFFFGFFFFF:DEFGFGGGF?GFFFEEEFFEFDFFFFEFFEFEGGEGFEDFFFFFFFE;BFFFFEFFFE?EEECEEEEGFFFFEFEGEEEEEEEEFFAEEEEEEEEFEED>EEDEEDEDFC@EADDCCC@@=@ABA?BB	T	89	C	60
13	24242801	A	32	AGAGGGGAAAaAAAGGAAGggaAGAgGGGgaa	>FE<GFGFFFEEFFGFDDFGGEEFDEDCB@BB	A	16	G	16
13	24334215	T	95	GtGTGTGGgGgTTTGtgTGTGGgTTTgGTGgTTGGTGGGGGgtGTtGTTTgTTTTGtTTgGgTTgtgggtTTtGGgGgTTgGgTTttGtTgTGTg	BDDDGFHHFHFEDEHEFEHEGHGDEEGHEGGDEHHEGHHHHAEHEBHEDEGEEE9GFDDEGGDDHFGGGFDDFGGGGGDDFGGCCFF@DCCA??D	G	49	T	46
13	24865029	G	72	GgGAgGGAgAAaaaAgaaagaGgAaggggGaaAaaAagggAAGGAAGAaaaGaAgaAAGaaGGGggAagGga	@A?ACEEFCFFF6FDCFEFCFECAFCCCDEFGEGGDDDDDFFBEFFEFFGGD8EDGEED>GDDDDEEGBD@A	A	39	G	33
13	24877445	T	125	cTTtcTCtttCCtttcctTtcTtccTCctttCttcCCcTcctCCTcctCtcTCctcCcctcctccctttcCTccCcCcTTctttctTttCttcttcccctccttcTCTccccTccttcTCctctt	CE=FAGDGGGDDFGEBBGFGBGGBBGDBGGGDGGBBE;GBBGDDFBBGDGBGDCG@DCC@CCCCCCHHDCDB5CDCDBGGBHHHCGGHHDGHCHH>CACHCCHFCFCFCCBBFACHHCECB@AEE	C	66	T	59
13	25425723	T	50	AaTAATaATtTAaaTTAtTTttaATttttTAatttTTTtatTAAatttaa	CECEEEDEEDEECCFFEDEEDDDBEEECDAEEEEEEEDEEEDDDDECEDD	T	30	A	20
13	25876066	A	64	CaaACCCaACaaaaaaaaaCaACaaaaaAaaaCaaaACaaaaaaaaaaaCaaaaaaaaaaaaAa	;CC9C:DB57C5=D56DD6BC=DDE<>E5@D@?7?F:D5CF=FEFF7EFB6ECFEECE;C>AB;	A	54	C	10
13	25876072	G	74	CCCCCCgGgggggggggggCggCgggggggggggggggggggggggggggggagggggggggggggGggggggg	<A?:::A:FEEEE7FDFDEAFEAFEFEEFEEFFFGGFGCEFECFGFGGDAGGCFGFGGFGAFGGFG@FGEEFC=	G	65	C	8
13	27845548	C	44	CCCGcGCGGGGGGGcGGCCGCGGGCGCGGgGGcCGCcGCGgGGg	CCCCFCABC@CCC@GCCDDCDCCBBBDBBGBBHCBCGBB@D=AB	G	28	C	16
13	28882948	G	59	ggAaGGggaaGGAGAAAgggAGagGAGgAaAgaAgggGGAGgAGaaAGGgAagAAggAg	CCFFCECCFFEEEEF9CDDDEEGDEFEDFBDAGEDDDDDEEDEBGGEDAEEGDEDCC?A	G	33	A	26
13	29898881	A	159	aGaGGgaAAaGgAGgAAGaggaAagAaAaggGGGGaagAaggAGGagAgagGGggAAgggaGGgaAAaaAaagaggAagagGAaaaGgGgagaaagggaGggAgaAaaAAaaagAagaaaaggGaaggaGaagagaaaaggaagaagaaaggAaagaaa	C=A@?CCBCCCGDDFE?ECFEDEDFFDEDFFEEEEDDF9DFFDEDDFBFDFEEFF8GFFFDEEFDFFDDADDFDFFFEGEFEF;EEEFEGEGECEGGGEEGGFGEFDDFFEEEFFEG<EEEGGDDEGG>DEEGEFEEFEHGEEFEEGEECGGDDCF@?=	A	88	G	71
13	30346188	A	91	CCCCAaCAAaAAAAaAaACAAAcAaAAAAAAAAACCCCCACCCCCAaCCACCACACCCCACAAAcCACCAcCaCaCCACAaACCaCaACAC	GGGGFDGFEEFFEEECEEGF:FHFEEFFFDDEEEFFFFFEFFFFFEEFFEFFEFEDFFFEFEEEHF@FFEHEEFCFFDFEDCAB=@<?@A?	A	49	C	42
13	32336040	C	25	ccttttctCtctcccttttttccct	?<CCFGAGDGBGBBBGHGHHHBCCH	T	14	C	11
13	32828553	A	36	aaaaAggaaggaggAgggGgaAggggagaaaaaggg	C?@DFFFDDFFDFFFFFCGFDFGEGEEGEEEEEGEC	G	19	A	17
13	32832149	T	63	tTtctTCCCCCcCTccTTtCtCTtCcTctcTTCTTtTccCtcTtctttCCcCCtcctTTtTtT	A?E@FGGGGGGBGGBBGGGGGGHGGBGBGBGFFGFHGCCGHCGHCHHHFFCFFHCCGFFGFDC	T	34	C	29
13	36822849	C	32	TTccCcCccCctcctTTttccctttTcttttt	A@BBCDCCDDDEDDEFGEEDDDEDDGEFFFFF	T	17	C	15
13	37014366	G	51	gGgaagagaagagaagaagagagaaggagaggggaaagaaaaagaggaaga	B=CEDFFFFFFEFFFFFFFDFFFFFGFFFEGGGGGFGGGGBGGD@GGHGGG	A	28	G	23
13	39263731	C	290	TTcccTTTCCttcTccCCTCcctcCtcccctcctCTcCCTccTCTctcttccctttcCCCccttCCTCTTTccCtCcccttttctTCCcTTTCcCtCTTtCCTTctcCCCCTctTtctccCtCCCTCcttCtcTTtttTtccTTCTtccccCCCCccttcccCTcttccctcCtTCcctttctcctcCcTctcccttCCccTCccttTTTcttCCttCTccttctCtCcCCctCTTCcctTTCctttCtcccCccccCTcctccCtTTCccCTctTtCctTtttccccCc	ACAC@?;=BFGGAEAAGFGGBAFBGE;BBBG5BGGEBGEGB>GGFBGBGFBBBEGFBGGGBBGGGEGGGEG@BGGEBBBGCGGBFGGGBGGDGBEGG>FGGEGDBFBGGGGFBGGFCEABGHEGGFDCFH8HC?FHHH5HACCGG8FCCCCGGEDCCGGCBB<FCHHCCCHCGHGE@BGGHCGBCHCABFCHCCCEGGF>CBFCCHHEEFCHHGFHHFECCHH;HFHFCBFDIFFCFCCHFBFCHCGFGCCCFC>CCFFCAHCBFEFFFCBFECHFFGBDCCCC>>;<@@	C	167	T	123
13	40230216	G	48	AGGgGGGAAGagAgAGAAaGAAAagAAaAgGGAGGAGGAGAGAaAGgG	EFGEGGGCFGFG6GFGFFBGEEEFEEEFDFFFEFEEFFDEDEEEECAA	A	24	G	24
13	41834744	C	219	ccTCCCttCTTcCTctCCCttTtcTCTTctTCttCcTCCccctTTTCCTcCTCCTCtcTtCCTctcccCCctTCtCCTTCcctccCctccCccCctCcctTCTcctCccCcCccCtctcttCcTCcTCtTTctctCCcCCCCcCCTcttCTcTCCtctcTCCcTTCTTcTttcCCCcCTCCctCCCTCtTcCtCTTccccccTctcCCTtctCTcTctc	A?A@?CDEDGFFDGFE?DDEEG@FGDHHEEGDEEDFGDCFFFEGGGCDGEDGDCFCDGGE>DFGEGBGCDGFGDEDDGGDGGFGGDG@GGDGGDFEDGGFGDGGGFCBGCGCGGCFGFAEFCGGDGF@FFFGFGFCCDCCCCGCCFGGECFGFCCFGFGFCCFFFCFFGFFFFCCCBCFCCGECCCECFEGCFBFEEGFGFFFFBDABC=???DBADCD	C	134	T	85
13	42873782	G	77	GGAgagaAggagAggggAggAgAGGgggaAaaaAaggAaGagAagAgAGAaaaaGggTagagaagggggaGGGGAGg	@5@>A@EFFFEFHEEFFHFFHFHC:FCFFGEFGHFDGHFCGGHGGHGHBHGFGGBGG=GGGFGG;FGAGGBBB>CCD	G	42	A	34
13	43597932	C	100	GcGGGgCGGCcccGggGGCCGgCGcGcgccgCCCccGcgggcCGcgGGgcgGGcCgggGGCCCcGcCGGcccGcgGGCgggggcggccccGgCggcccgc	A?;>@CB5BCFFFAFFACDD7FD>FDFFEFDDDDFFC?GGGGDBGG@CGFGCCFDGGGCCDDDGBGCBBGGGBGGBBCDGGGFGAGGGGGAGB<GCCABB	G	54	C	46
13	43798077	A	49	ACAAAACCAACAACCACCCACaACAACAAAaAAACCACAAaAACCCAAA	HDHFHFBDFACGGCCGCCCGCCGCGGCGGGEGGGCCGCFFEGGCBCBC?	A	31	C	18
13	45148257	G	168	gGaGGagaGGGggAGagaaGgaggAgaAgGGAggAGGAgAagAAaggagAAggAaaGaaagAaGagGAgGGGGgGAAagAaGGAAaAAaAGggAaAAAagaaGAagagaAgGGagaGggggGgAAGaGAAagAgggGGagaAgAGgAGgAGGgAGAgaGaGgaGaAgg	C=@==BCBCCEDEEECFDDEFDFDEFC=FEEFFFFF=FCFAFBEDFFDFFFFFFDDEDEDGFEEBGEFGDEEEGDEFDG@E?EFFEFFEFEFGFEDAFBGDEEEEGEGD;GDDEGEDGGGGDGDEDEDEEDGDGGEDDE?CEGED=DDG>DCFECDGECEDFBD?A@?	G	89	A	79
13	45912634	T	33	TCCCTCCTTTCCcCTTCTCTTCCTTcTCTtcTt	?GGEDGGEEEGFFFDDFDFDDFF@DGCEBA@@>	T	17	C	16
13	46093284	C	60	gcGcgcccggCCCccgCcGccGggGgGCcgccccgcggccgcgcggcCggccccccgggc	CCFDEC@DFDGFGDDEGDGDDHFFHFHGDEDDDDDD:EDEFEGEGFEGG7EEEDEEEG?E	C	34	G	26
13	46629944	A	109	GGAAAAAaAGaAAGaaGGgGGAGGaGaGAGaAGGggGGGGAAAGGGgAAAGAgAaAgGaaAAgaggGAGgAGaaAgaggagAaAgGagaagagagaaAAgagggagaaa	DC?@BDFFEGFFFGEFGGFGCFFGFHFEFGFFGBCGFGGGEFEGFGGEFFGFGFGFDGGGFEGGFEEEFFEGGDFGGGGGGEGEGFGGGGGGFEF:GEEGGFFDCB?DD	A	57	G	52
13	50050620	A	37	AGGGAAAAAGAGAAAGGGGAAGGaGAAGGAGAAAGAA	EEEEFFFEEDFEFDFBDCDEEDDEDEECCFDCBA@AA	A	21	G	16
13	50129615	A	94	GAGAGgaAGGAAGAAAgGAgGGGgAgAaAAGaGAGAGAAAAGAAGGAAggAAAGAggGAggGagAGgAGaAGgAAgAAAAAaAgaaAgaAGaaa	BA?FEFDFDFEEEFFEFEEFEEEFFGEEBEEEEFEEEFFFFEFF=CFEEGFEEDEGFDEGHDDDEDGEDEEDGEEGEEEEEDEGEEEFDEDC=>	A	53	G	41
13	51594741	T	87	TgGTGGGGGggGGtTggGTGTttggggttTTGggGtTGttTTGGTggtTGGggTttTTTtgtTTtgtgtTTgTggGgtGGGTTTGTt	>>BCHFHHHCCFGGECBHEHEGGDD<BH;BEEDDHHEHHGEEHHEADHEFHDDDGGDDEHDHDDHDICGDDDD=BGDHFGFCDCC<C	G	44	T	43
13	52515354	A	104	AGAGGggAGAaggAaGGaAAaGaaaggggAaaaaaAaAAAAGgAgagAgAAGAAAGaAAaaGGgAAaAAGaaGAAAAagaagaaaAagGGaaaggaggaaaaga	=?>AADD@DEDFFFEEEEFFEEEEEEFFFFDEBEEFEFFFFDGFFFF<AFE9EEEEFFDFFBEEFFFADDFFDEFEEFGFGG:FEEFFDDFECFGFEGFFBA@@	A	67	G	37
13	52585548	G	104	tTGTGTTTtGTTTtTgGggtttgTTggtGggtttgTTGttgttttTtGtGGtgGtttgttgtGtgtttgtgtttgTgtTGgttttttttGtggggggggggggg	CA?>>@?BEDD9EFECECCGGGCEDC>GECCGGGCCEC;G@GGGGFGEGE@GDDGGHDGGCHDHDHHHDGDHHHDFCHEEDAHHHHDBEDHDDDDDDCDCDCB<	T	59	G	45
13	52709938	A	164	cAccCCCaCCccCAACCACAAcCcCCcAaAACcACccaAaaAAaaccAacACCcaAAcACAaaCCaaACcaCAcCacCacacccaAAaaAcAcacCACAAACaccCCAacCcAcccaACcaAacacAcaACacaCcaACcacCCcaaCcAACaacaacAcccAC	@@:=?8>E@@@CAHFD>FCHGBDBCDBGFGHCBHDB@FHFFFHFEB@HD>H;DBGHHBHDHFFA8FDHDBCDH:DGBDGCGCCCGFHBGHCHCFBDGDHHHDGCCDBFGBCCFACCFGCCGGFCGCGCGGCB;CCABGCCGCCCCGG@;G<CGGCGGCFB@>B=	C	86	A	78
13	60590299	C	76	CTCTcTCCTCCcCtTTCtTtCCttcCCCcCctctcCcCTttCcccTccTTCttcTcctcccttcctttcCctcttt	B;DCFEEGFGGGGDGGEDGDGHDDGCGGGGHEGDGGHDFEEEGHHGHHGGGEEHGHHEGCHEEGCEEFHFHEHC@>	C	43	T	33
13	76055397	C	50	CCTCCCTCTCCTTCtTTCTCTCCTCCCTCTCCCCCCCTTCTTCtTTTTTT	DCGDCAGDGDDG>CECFACCBCCFCCCFCFCCCCCCCFFCDEBFEFEGFC	C	26	T	24
13	76055820	G	56	CGcgcgcGccCCCcggGcgcCgcgGCccggGGGggCcCCgcgGgggCcggcgcggc	@65<=CAAAADDDBC=CBC@DCACCCB>DCC>CDD<CCCDBABEDDCCCCCDCA@@	G	29	C	27
13	76427410	C	82	cgcGccgCccCggggGgCgcgcgcGGgcgcgGgcCCgCCcgGGcCccCcccgccGcCgcGGgCCCGcCccggccggccccCC	C?D@HGFDFDDDFFFCD@FGF8FGBCFGFGFCFGDDFDCFECCGDGHDAHHGHHBHCFHC?FDDDAFCGHCGHCGAHGGGAC	C	48	G	34
13	78188078	A	85	GGAAGAgAAAGaGGGAGAAAagAAGGGaggaGaagaGGgaggAaAAGgGgagaGgGggAAaggaaGaagAggaaaaagagagaaa	C?@ACEGDFDBDGGEFGFFFDFEFGFGDFFDGDDEDGGDDFFFEFEGFGGEGEFGGGGFFEGGEEFEEGEGGEEEEFGDGFGE@A	A	44	G	41
13	90644328	G	49	AaaGaGGgAAGaGgGGGAAaAgGAGGGAaaAgAgGagGaggggAAaggg	BBACEHHFEDHDGFGGHEEEEGHEFHHEDDECEGHEGGEGGDEDDDGE=	G	27	A	22
13	93142312	T	32	AAATAATAAATAATAATTTtTAtTTAATTAAa	?BEEEDEEDEEEEEDEDDDECDEDDDDDDEB?	A	18	T	14
13	93142362	C	63	TCTTCTTCCCcCTcCCTTCCTTtTCTTcctttCtCCtTcttTctCttctcTTCTCtTTCCcCt	?@EFDGHD?DADHBDDGGDDGGGGDGGCCHHHCHCCHFCHHF;HCFHCH=FFCFCHFFCC<AE	T	34	C	29
13	95275576	C	95	cccGcgGCccggcGGgccggggccggCGCgcgCgccGcgccccccccGcgcccGcggggcgggcccgccggcggcggcgggGggcgggggcccgc	C?C@<ACC?@BCBGHBABBCBC@ABBGDGCBCGCBBH@CBBBBBB:BFBC@BBHBCCCCCCDCBCCDBBDDCDDCDCB?DDFDDBDDDDDCACC=	G	49	C	46
13	95279505	T	39	AaatAattttatttatAtattataAataattaaaaatat	C9B?@DDCCCCDAD@DFDDDADDEFEEEDEEEEDDFEEE	A	21	T	18
13	95847020	A	64	gAAGGAGGGAGAAAGGAAGAAGgGGGAGAGGAGggGAAGGAGaGGAAaaGAGGAGGGgggGGGG	BAHCCHACCHCHHHABHHBHHCGCBBFCHCBGCGGBGGABGBCBBGG:EBGAAFB@@AB?AAC?	G	40	A	24
13	95858978	T	174	tCtTCtCTtCTTttTCTtTTCCCTttctTttTccccCTtTCcCcCtTTCCCttcTCCtTTtCTCtTTttTttCCTTcTTTtTCCCtttTTtTTctttcctcCtttCttTTttCtcTttcCttcctcCcccccttccTttCCTtCccctCcCCCtTcttTCcctCttTtctcCct	??B=AFE=FGGEFFGGEGGGGGGFGG@GGGGGBBBBGGGGGBGBGGGGGGGEGBGGGGGGGGFEHGGHEGHGFFGFBDDFHGGFGHHHGGHGGBHECCCGBGHGHGGHFGHHBGCEHHCFHHACCCFCCCCCHH>DEFFFFFHF@CC=FCFDFHFCHHEECAHEFGGF?C>B7F	T	100	C	74
13	96743860	A	65	aaaCaaaaaaaaCCaaaaaaaCaaCaaaaaaaaaaaaaaaaaaaaaaaCaaaaaaaaaaaaaaaa	A@C?B@DDDBDDA9EECABDEDEE7EEFCDDECEED;E?DE:FEDED=7BC@BFFFE;FFFEECA	A	59	C	6
13	97639414	C	182	tttctctttctTCctTtcCTtTTCtcccCTcTCtctTctcTccTCCtcctcctCtttctTtTttctCCCCcCCttTctTTTcTCCCTtCCcCCTctccCtcttTttCTCCCTtCTctCcCCTCtctCTTccTttCCTTcCTTtCTctCCtCCCcccTtTCTTtCTCCtCTCcTCTcctTcCt	C@@CBDCDEHEEGFDEDGGCDEEGDGGGGDGEGDGDDGDGFGFEGGDGG>GGDGDDDGDEDECEGEGEGGBGFEEDHEEDEHEGGGEEEFHGFEH6HHEEGEDCCEFDFFFD<FDHEFFFFDFEHEF=CEHDDCF?DDHFDDEFDHDFFEFFFHHHCEDFDDEECFFEFDFFCDC?C>>@AA	C	91	T	91
13	98017211	A	27	AgGGGAGAAGAAAAAGAGAGAAAAAAA	CGHGHDFDDGDDDDDGCFBGCDBAA??	A	18	G	9
13	99098882	A	143	ACCACCCCACACCACAACCCCACAACCCCAAAAACCACAAACCAAAACaACCcACACCaCCcaACACACACCCACcAACaAACCCaAAACCAcCcaCaCCACACAAAACAAAAAAACCCCaCCCCCcACCacCCACACCAacc	=@A@FFGFFGFFF>GGDFFFFFFFFEFGGFEFB<FCEGFEBGFFFFFFFFGGDEEFCBFDDEEDFFEEEEFF>EEEEEECEDEFEFECEFFEEF;FFEEFDEEFEBEEFEEEEDDDEEBDFEEEDEDDCCBA>@?AAC??BB@	C	77	A	66
13	100945603	A	44	ggggaaggaggaaaaaaaaagaagagGGaGggaaaGaggaggaa	C?AADDBBDFEFFEFFFFFFFFEFFFEEBDGGGGGEGDGEGGGG	A	23	G	21
13	101144031	A	28	AgaGAagGaaggGgaaagagAGAaaaag	@BDBHEFCEEFFCDEEFEDGHCHFFFB?	A	16	G	12
13	101287404	G	30	gGaggagggagaggagagGAggaaaggaag	C<C<DGCCCFBFC=FCFCCHDDFEGDDGDD	G	18	A	12
13	102698459	G	83	GgggaaAAGagggGgaaaaaggggGaAGGGgggggggaAgagGAagagaGgGAggggaaaGggaaagaggggggaaggggggg	CACACB?AEEFGFHFFEFEFFFFFHFCGHGFFFFFFFFEFFFHCFDFGGGFGEFGGGGGGHGGGFGGGGGGG<GGGCGGGGG?	G	54	A	29
13	103346806	C	41	cccgCgcgCcggcgcCCgccgggCgCgccCcCCcCCCcCcC	A9AB?BDFCCEEDFD8DFEEGGFDGDEDECECCECCC@C@C	C	29	G	12
13	109496813	T	171	TtttTttcctCCcccCTtctttCCCcCTTTCcCcTCTTCCCTTCcccTCccTCcCCTtTCCtCTCTcctcCttCctttttttTCCTTctctTTcCTtCctTtcctTccttcCCcTtcctccCCCCTttCttctctTtTtCCtCtcctTTtcccccTctTctcTtcTctTCC	?AAC:@B<>C?B>?>BCGBGGGDGGBGFGGGBGBEGGGGBGGGGBBBGFBBFHBGGEGGGFGGGGFBAGBFGGGCHHHEHHHFGGFGCHCGGFCGGHCCHGHCBFGCCHHCGGCGHCCHCCGGGFFHFFFG;ECHF>FHFFI?GCCEDFHACCCCFCHF@HCFH=FCFEAA	C	87	T	84
13	110844721	C	36	ctttctcTcTCtTtcccccctcccttttcCctcttt	CBFEFEFEFBFEEEFFFGFFFFEGEFFEFGGF9EF>	C	18	T	18
13	111109859	A	115	ggAAGAggAAaAAGgAaaAGGAgaGgaAaAgAAgAAaAAGAgGAGgAaaAagAAAaGAgaAAAaaAaagGGAAggaGAaGAGgaGaaAGGGGAAaAAgagGaaagaGGaGaaGAG	CACC?HFEHBEHHCGEFFDCCGFFCDFHEHFHHECHFHHCHDCHCFHGG=GDGHGEBHBGHHGGFHGG89AGGGGFAGGBGBGGBGGFBBBBGGCGGGGGBFGA@EBAC?=<AA?	A	70	G	45
13	111110418	G	208	GCGGCGCGGGCGGCCGCgCCGGGCCCCCCgCCCCGcGGCGCGGGcCGgcgCGCCcCCCggGCGCGGCgGGcCgCCGCcgGGccCCCGCCGCcGCGGgcgGGCGCCGGGGggggGcGCggGgccGCcCcgGgcgcCgggcCcCGgGCgcCGggGGggggGCGggCCcGGcCgcGCcccGccGgGgggcGCGGggCGccCCgcggCGGCG	B@=<BBEDECEAAGGEGFGGEE;FBEGGGFGGFEEGFEEEFEAEGGEFGFCEDDGGAEF:EGEGEEEF?EHGGGEDEHFBBHHFEFEGEEFHEGEEGHGEEFEFGDEEDGGGG9HEFGFDGHHDFHFHGDGHGB7GEGHFHFBG;EFHFD?FDDGGGGAEDEEEEFDDHDGHDEBGHDHHCGCGGFGDEDDFGECFBFFFECB<ACCC	G	112	C	96
13	111111043	G	70	aAGAAGGAGGAGAAGGAGGGGGAAAGGAGAGAAAGGAAgaAAAGAGAAAGGagGAgaGGAGGGAGGAaGA	EHCGFCCCCCG7GHCCHCCCB@HHFCCHCHCGGGBAGHFDGGFBGBGGGBB;DBGG?BBFBB@F?AD;C?	A	35	G	35
13	111121444	C	58	CCAACCAACCAAACCCCCAAacaCAAAACCCAcCAACCAAACaCCCAAacCcCCcaca	?F;EGGBEGCCEDGGGGEE?EE;F?DDCFFFEEFDDCFDDDFEFFFDDEEEDBC@@?;	C	31	A	27
13	111142038	G	125	GagggAAgaGAaGGggGggAagggaAGGGGAgGaAAaAGaAGGAagAGAGGGggGGAgAAAGGGaaaAagGAaGggaGGAaaGGGGAGAaagAGGggAgaAAAagAAgaaGGagaGaAGAggGgg	>ABCDFFCFBHEC8FFAFFHFFFFFHCACCDFCFGHCHCEHCAHGGHCHCCCGGCCHGHGHCCCGGFHGGCGFCGGGBBGEG>ABABAGEGGDBAG<GGEGEGGGGGGGGBBGGGBGFBGBA?AA	G	68	A	57
13	111144321	G	26	GTAgAAAGGAAGGAGGGAAAGAaaGG	=<DFF?ECDDEDD=DDDE<D>A>=?C	A	13	G	12
13	111298392	A	110	AggGGagAgGAaaGGaGAgagGGgagAaGGAaGgGaagGaaaGGGGggAAAAgGagGgagaAgGgggagggAaaaaaggggAgAgAggAggGggAAagagaAAggagaga	?>=BFFFEFEEBFFFFGFFFFGGFFFFFGGFFGFGFFFGFFF?BHH=FEFFFFFFFGFFFEFDGCGDEGGGFFF8FGG=GGECEGEBFEGGFGG>EGGDGDEEGFFFAC@	G	62	A	48
13	113681243	C	92	CACCCCAACCCCAcCAAAAAAACCCCAACCACCAAAACaCCAACCaCCAAcAcCCCAAAaAcCAaccCCACCaAAcCAAAacAaCAaCCAca	9<FGGFFFFFBG9BE;EFFEFFGCF@E>GF=FFFFFFFGFD=DBEEDEADCECFFFCEEGECFEECCBFEFFGDECEDDDGAFFDCCBAC:C	A	46	C	46
13	113728578	G	27	AAAAAAAAAGGAGGGAGGAAAGGAgGA	CHGCBGGGGBBGB<BGBBFFFABGD>C	A	16	G	11
13	113735608	G	78	aAAgGgGGgAaaagaaaggaaggggaggggggagaaggaaGgaAgagagGaggggggagggaaagggaagAggggaag	CBC8<B??CGFEF?EFFCCEFCCCCFCCCCCCFCFFCCFFCCBH@FCFBCGDDCDDDGDDDGGG9DCGGDEDDDBD>D	G	46	A	32
13	113793849	G	64	GgAGAgAAAGAAaagGgGgAggAGgGGggGAaaAaaGaaAggggaagAgaaGaaaagagaagGa	@EECFFFFFEBF@DFEFFF8FF@CFDEDFEEDEEEEEEEDGEG?EDGEFEEDECEDGEGDEDB=	A	33	G	31
13	114174889	T	66	TTTGTTTGTTGTTTTTTTTTTtGGtTGtGTGtttTttTTGtGTtGGgGTTGtTGGTGGGtgtGtgt	EEEHDFEGEE=EEEEEEEEEDH8GHEHHGDGHHGDHHDCGFGDHGDDGDDGHDFHEGEFB>AAEAB	T	43	G	23
13	114323997	T	115	TTCCtTTtCTTCCCCTCtCTTcCTTTTtTTTCCcTcCTtTTTCCtCCCcttCtTTCCtttCTtttcttTcTctcCCtTctcCtctTCCTcCTtCtCCtccTTttTCTtTtCTCcc	@C=GEDDEGEEGGEGEGEEDDFGEEEDEAEDAEGEFCEFDEEFGFGGGBFFGFEEGGFFFFDFFFGFFDGDGFGFFFDGF<FFGEDFFDGDCF>EFFAGGDDF9DFDFDDDCC??	T	65	C	50
13	114514771	C	35	cCAaCcCcAaaCAaaCccaCcAaCACCCCACCccC	CCHEDDDDHDFDGEFDDEFDEHFCGCCCCECCEED	C	22	A	13
14	20345346	A	93	aaAaaaAaaAaAAaATAaTaaAaaAaATTaaatataaAtttaaaaatAtaaaataaaaaaTtaaataataaataaaaaaaaataaaaataaaa	A?AAAA@BC@BBBGFFFFGFEFFEFFFGAFFFEEEFEFEEEFFFEFEEEFECFFFFFF6EGFBGFFEGFGGGEFGGGFGGGGFGGGGGCGGGG	A	74	T	19
14	20403909	T	280	CCCcctccCCCTCcTCCCCCCCTcCTCTTCCCTcCCCCCccTCCcCCCCtTtCCCTccCTTCCCCTCcCTTtCcTCCCTCCCCCCCCCCCccccCccccccctCTccCcccCccTcCCcCccCCtCcccCctccCcCTcccccCtcTtcccTCtccCCCcccCTtttccTCccctTccTcTctctTCTccCcCTtctcCCccCCcccccCCCtCCcCCccTcTTcccTCTtcctCTTCtccCCCcCCttcCCtcCcTctctctcccTccTtCtTTCTCCc	ABAAAAAC@@B=?<?BB=CDDCA?EC@DCFGGEBFFGGGBAEEFAGGGEGEGGGGCBBGEEGGDGCFBGCDGGBEGGGEGGHGGGGGEEGBBBBGBCBBB=BGGEBBEBBBGABDBG?CGCCBFGGCCBGCHCCACFECCCCCGCCEHCC@EGHBBGGGBACGEHHGCCEGCABHDCCDBDCF<HDFDCCFCFDHCHBFFC<FFACC@CFFFHAFAFFCCDCDDCCCDFDHCC>FDDFHCBDFFCFBHHCFFGBCCDCHCGCHBBCDBADDCBBAB9AA@	C	207	T	73
14	20404874	C	39	TCtttCttttttttttctctttttcctcttttttttttc	?CAA?<BB?DFCDEEEFEFFEFFEGAFGFFFFFEEFFFG	T	31	C	8
14	20850014	G	42	AaAaagAgGAGGAAaAgAAAAgAGAAGGAAAAGGAGAAGGGG	C@FFFCHDCHCBHHGHDHGGHDGBGGBBGGGF@BFAGE@A>>	A	25	G	17
14	21215692	C	55	CCCTTTCTTCCCCCTTTCCCcCtCtCTTTCCTtTCCccTTCCTCCCTCCTccTtt	GGEFFFGFFGDFGCFDFFFFGFFEFFEEDFEDFEDFGGEEFFEFEFAFEEFEC=>	C	31	T	24
14	21469151	T	26	TCtcTcTtCCTCCCCtccTTCtCtTt	EGEFEFEEGGEGGGGFGGCDFFFFEB	C	13	T	13
14	21511458	G	223	GCCGCCccgCgGGgccCCCGgGcgcgcGGCgcggcgcgCcggGCGGccgggcggcgGccCgGgcccGCggccCGccCCccCGCCggGccGgggCCcGGgcggcCgggccCGCcGGccCCcgccgGCGGGggGgCCCgcGGGgCGcCcgcgGCGgCcgCCCCcggGcgCGGgGgGGCCcGggcCCccggGCCcCgcCCCcCCccccgGGGcccGGccCcgGcgG	B>B<B;A9B@CAACDBDE;EFECFDDDEEFFDEEAFDEFDFEEGEADDFFFDFDDFEDDEEE<D9DEFGGDD?EDDGGDDFEGGGEEEDDFFEGGDEDGDFGEFGFFEEFEFEEE@EFEEFEDEEFEEEFFEDGGFGEEEEFEEEEEGEGCFEFFDGFGEFEGGDEGFCDEAGC<F@EDFFEFEDEFFDE<EFBEFFEEFFEEDEEDDDB@ABB?<9@>A=>C	C	116	G	107
14	21571208	G	28	TGTGGgTGTtTGtGgtGtgtGGTGtgTg	@FGGGFGFGEFF?GFEEEGDEFFDEGDC	G	15	T	13
14	21899631	C	77	ttCCcttcCCTTttTttCctcttCCTTttTCCTtcctTTcCtCTTttttcTCtCctttctctcTCCTtCTTTTTCTT	C@AAECCG?CFFDDGDDGGDGDDGEGG6EGDGEEHH;GGHGEGFFE@EEGFFEFIEFEHC=>HFFFF>FEGDBABCA	T	48	C	29
14	21930398	T	42	TCTCCCTCCTCTTTTTtTCTTTCTTCTCTCTTCTTTTCcCTt	=DFCC=ECCFCFFFFFFFCFFFCFFCFCFCEGDDFFDAA@9C	T	26	C	16
14	21967133	C	116	ACCACcCcCAcCCAcCAACAACAaaCcCACCCCCCcAAccACACaCACCCAcAaCCAAaaacAACCaCCCAAaCCCCCAcCcACcaCAAcAAcaaccaCAAcaAaACCACaACacA	CDB@ADGDFEDFGFDFFFFEFGFDEGDFFDFDGFGEFFEEFGFAEGFGBFFEF@FEEEEBFDEEGFFFEDEEGEFFFFEFFEDEEEEEEEEE9FFEDDDDDDDDC>CBAAAAB?=C	C	63	A	53
14	21994154	T	74	CCtttttCtttCtttttttttttttttttttttCtttTttTttttttCttttttttttttTtTtTtTtttTTtT	=<7B=EE6EEEAEEEEDDECAEEEEEEEEEB=E8FEEBFE=FFFE8F8@CEDF9FED:FF<F6FFEF=?D?D>?	T	68	C	6
14	22038162	A	49	accAcAACCcAAaCACAaCACACaAAAcaAaCACcaAcccaCAaaAACA	E=BFBFEGG?FFFGFGFFABGFGGFFECGEGFEFCGDCC;GFEFEDBBC	A	29	C	20
14	22237127	C	98	CTTccCCCcCTCTtCCccCtCtCCcCCcCCTtCCTTcCCcccccCTCccTCtCCcTTCCCccctCTcCTtCCCCCctTCCCcCtCTcccCCcctTCCc	AB@AC@DDCD@CGEBC@DDCCEDDDD7DDDGBDDFGE8DE@EEEDGDEEGDBDDEFFCCDEEEFCGECFFCCCCCFEFC@CECDCFDEABCDB:CACB	C	72	T	26
14	22251325	A	88	TTttTATttAATTaTttaTaTaTAatttaAATtttAaAtttataaAatatTttatttttattAtaaataTaAtTaAAATAtatAaAat	ABA?BDBEBBFCEFAEEFBFE>FFFE<EEBECEEEFE:EEE7FBGEFFGE@FFGFFFFFGFEDFGFFFGBGEFCGDEEEEF=FECA?>	T	48	A	40
14	22321269	T	25	cctttTcCTtcttcttttccctcct	CCC@FEAFEGBGGBGGGHCCCH=CE	T	14	C	11
14	22392283	G	42	GGAGGGGgGAGgGgGagGGGgAggggAAGgAAGAGgGGAGgA	EGFGGGGEFFGGFGEFEFFFGEEEEGEDFGEDEFG?DCAB@C	G	31	A	11
14	22392304	G	63	GGGgGAGgGgGagGGGgAggggAAGgAAGAGgGGAGgAggGAaAAAGGAaAaAGGAGAaAGGG	GEGBFFBDGDGGDGGGCEDDDDFD6DFEEEF@EFEEDEDDFEFEECFFEFDGDFFFCBB?B?@	G	39	A	24
14	22458695	A	62	AGaAAggGAAGAGGAAaGAAAGAAAagAaGaGGGAgGAgGAGAGAGaAAAaggggaaAaagA	C=EFFDBEGFEFEDFFFDFEFEFFFFGFB=EDDDEFDEFDEDEDEDFEEDFGGFGFDCAB?C	A	36	G	26
14	22466017	T	109	ctTTTTCCtTcTCcCCCctTttCCtCCtTTctCCTtTctcTttttcTCTCctTTtcttCccctccttcCcccCcccTtcTcccttcttCtTcCttctttctccctctTc	CC;BDCEGDFEGGEGGGFEGEEGGEGGE>EFEGGGEGFEFGEEDFFGFGGFFGFFGFFGGGGFGFFFGGGGGGEGGGFGFBGGFEGFFFFEGFGGGFFDBFGGGFF@AD	T	55	C	54
14	22636784	A	95	CcCCAaCAcccACaAacaccCCaAAcCcCACaCccaacaccaaCcCcacACCacACCaacaCaacccACCAaCcCcaCAacaAcCCCccCcccCC	DB@DDEDFGGGEGDFDGDGGGFDFFGGGGFGDGHHEEHEHHEDGHGHEHFGGEHFGGEEHEGEEHHHEFFEEFHFHEFEEHDEHFFFGGFFC?AB	C	60	A	35
14	22749189	T	90	CtCcttCcTTttttcctTCtttCTCTttcCCTcttttttcTctTCtcTCtcctTCcctccttTTtcctctttcTctCttcCcctCccCTt	BCFFBDGGCEDDDDGGDEGDDDGEGDDDGFGFGDDDDDDGDGEEEDHDGEHHEEGHHBHHDEECDHHEGCAEIDHEFCEGFHDEGHDC<;	T	50	C	40
14	22891794	G	82	AGAgGAAAAGGAGGAAAGAGAGGaGAAGGGAAGGGGGAGagAAGAgaGGAGGGAAGGGAGagAGgaAAAaaAagAaaaGGaA	AADFEFA<FEDEEDFEB@FCBDDGEEEEEEFEDEEDDDDGCEECEFFDDCDDDE?CDDE:AGEDGGDEDEECDDBBBA<A;C	A	43	G	39
14	22930038	C	69	CtCtCttttCTctCctcCCcTCCCtccCtccccTCTccccTCcTtttCttctccCctccccctttcttc	?BCEDBED?DGDEDDEDEEDGDDDFCDDEDDDBGCGEDEEGCEGFFCDEDAFEECEF@EEEEFFEEFEC	C	41	T	28
14	22972844	A	67	agagaaAaaGaaaagAagaaagAagagGaggaaggaaagaAggaagggagggggagaagagaggggg	A?BBAB?BD?DFEFFGFFFFFFHFFDFCFFFFFFGFGFFGHGGGGGGGGGGGGG>GGFG?HFGGGD?	A	35	G	32
14	22975700	T	131	GTttgtTTGgtgtgtGtttgTGGtggtTGTtGgtGgttgGGttTTtggtggtTGTtttgggttGttggTgtGtTGgttttggtTggttggttGggTgtgtggggtGttGgttTGtggttttgtgtttgtgt	ABCBCDCCGEDDDEE6DDEEEHHEFFEEHCEGFCHFEEFH7EEEEEFFCFFEEHEEEEFFFBEHEDFFEFEHEEHFEEEEGBEEFGFFGGFFHEGEGFGFGGGGFHFFHGFFEHF?GFFFA=F@FFFFAB;	T	71	G	60
14	23244542	T	80	TCCTTTTCCCCcCcTTCTctTCCTTtCTTTtTCtTcTCCTCCCCCtCCcCtccTcTTtTCcCTCTTCTTCTttTTtTtcc	?>DF;FFFH5FFFFEFGDGFFGFBDFFEEEFFFFEGEEEDEEDFFFEEGFFFGEADDFDEGEEEEEEEEFC@@>5:?ABB	T	42	C	38
14	23306048	C	80	CTTTTCTCCCTCCTCCTTCTCCTtCTTTCTTtTtCCcCTCCTcTcCTCTCcTccCTCtCCtcCTTctTCCTCCcctTTTC	ABEDHDGDDDHCD<8BGED7CCE:DAFGDCE@G:DDE@F=DFDDECFDDCEFDECFCECCFECFFEEFBBFCBDABDCA?	C	42	T	38
14	23426182	C	66	cCAaaccaAaAaaACaAACacCaAAAcaAaCaCAcAAcaCccccacacccaCaaaCcccaacaacc	@B@DB@CGFFDEF?DF?FFFBFFGGF?F?FGGGFBFFCGGBC>CGCGCCCGEGGECCCCGFBEGCB	A	36	C	30
14	23549380	G	64	gGgAagAAgGGGaGggGggaGgAagaGgaAagagAGgggAgaAaGaAAggAGAGggGgAGagGG	A>BDFBE=CECEFECCECCFEC:FCFEDFEGDGCFCDDDEDG?GDGE=DDEDECDDDDECE@@B	G	39	A	25
14	23550887	C	117	AACACCAACAACAACaCcCCAACAACCACCAAaAAAAAACCAAAACCCAACCCCCcCAAAacAAAaCCCCCAcACCAAAAccACaaCCCaccCCaCCaacaACaCCaaCCCAAcCca	9CGFGGFFGFFEFFGE?GGGEFGFFGGFEFFFEFFFFFFGGFFFEFGGFFG6DDFHGEDEEAEEEEFFDFFEHEFFEEEEHHEFEEFFFEDGFFEFE:EGEEEEBCAAABB>B@?BA	A	59	C	58
14	23821361	G	53	GGagGaggGgGagGaaggAgGaaAgggggggggagggGAagAgaaAgAgGgga	BBCA@DBCECEFCEFFCCFCECFGCCCCCCCCDGDDDEFGDFDGFFCEADDCB	G	35	A	18
14	23830048	T	35	GtTGttttTttGGttTTtttgTtgttggttgtttg	CC@GGGFFFGGHGGGEFGEGCEGCHEDDEHDHHGB	T	25	G	10
14	23842017	C	29	CtTTTTTTTCCCCCtCTTCcctcTcCCTT	GEDGGGFGGFGFFDB<FFFF@FDFDFED>	T	15	C	14
14	23855426	C	107	TCctTTtTcCctcTccCtcTCcctTtctcccttctccctctctttttcCttttctctctctttccttcctctcctcttttctTtcttttcctcctcccTctcCcCct	C@?C??6AD@>EDFGGDBGGDGGDGDGD@G?DDGDGGGDGDGCDAADGDDDCDGDGEHDHEEDHHECHGEH?HHEHEEEEHDDDGEC;@HHEGG<GHHFHEHCGBHB	T	55	C	52
14	23855849	C	41	TTtcttCCCCTcCcCctTCCCcCctccTctccTtgctCccc	>BGAGGF;FGEA<BGBGCGGF@FACC=B>C5CD98B=F:==	C	26	T	14
14	23861882	T	25	TtTTTTTTTTTTtTttggggggggg	>C<DEDCFFFFA>E::D???D?BCD	T	16	G	9
14	23994867	G	64	GGaGGGAaAaggagAagGGgGgGGgGggGAAAgGaggGaGGgAAgggGGgAaGaGgGaAaAGgg	>;A@BBHFHFCCFCEDCCACCCBCCBDDCHHHDBGDDBGAADFHDDDB>ACGCHBDB=GGFA??	G	42	A	22
14	24529209	C	104	TCTCcCCCtCttCTcTTCcccTtcccTtccTTCTTcTtTcccCCCTctCcttCtCctTttCcCCCCCtCTTtCTCcCCCccCCcCTTTCtCCcCCtCtCcCTcT	D>A:ADDDFCGGDGBEGDBBAGGBBBGHCCGGDGFCGFGACCDDDG@HDCHBCHBCGFHHCCCC?CCH@;FHCF?ACCCCCCCCCFFFCACCACBHBGA@8C<?	C	63	T	41
14	24531641	G	69	CCGCCCCCCGCGCGGGGGCCGCGCCGGCCGGgGGcgCGGGGcCGCGCGCccCCGcGggGGcCcgggCCc	A?BDDDDEECDCDCCCCCDCCDCDDCCCDCBD@BCDCBCBBACBCBCBCCCCCBCBCDBBCBC???AC@	C	35	G	34
14	24545835	C	111	TCccTtTtctTTCTcccTttTCTTCcTCCcCctTTTTCTctCCcttcTctttcTtcttTtCCctcCCtcTttctcttTCCttCCTttttcCTTtCCcctctCTttTtccct	B;CBEEEEEEGGFGFFFGDEGGGGGF@DGFGFAGGGGG@7EGGFEEFGFFFEGGFFFEGFGGFFGGGFGGFEGFFFDFFFFFFFF?FDECFFEEBFGGFGFFFFFFFFE=<	T	62	C	49
14	24545984	G	30	cggCGgcccggcgCGgCGGgGCCCgGGGGc	ACA>GBBBBCCBDGGCGGFDFEFC@DCAC:	G	18	C	12
14	24600631	T	108	ttttttttTttttttCtttCtttTttttttttttCtttTttttttTCttttttttCtttCTttttttttttttTttTtTttttTTtTTtTTtTtTTTTTTTttTTtTT	AACBCA>ADCCBFEE@EDE8EEE>ECEEECEEED>EEEGE@FEEFG7DFEFDFFF?DBF@FDDFAFABF<DGFFFFDEE9FBEEFFF@DFEFEEFGDCDDEF8CD>?C	T	102	C	6
14	24647957	C	188	ttTTCCctTTCCCCCCcTcTcTTcCcCTTTCtCCtcCTcCTcctTCtCCCttttttCCctccCCcCtCTttcCCCTtTTTCCTtcctTTcCTCCCCTccTtCTTTcCTTtCTcTTCtTcTcttCcTCtctCTctCCCTTCtcCCTTcCCcTccTCtctcTttcTcTtcCTttCtcTttttcccccctC	A@BA?CBGFGD?DCDDBFBGBGEBD7C=GGDDDDGBDHBDBBBFGDHDDDGGGG:GDDCHCBDCCDGDGHHBDAAGHFGGDDGHCCHFFCDGDBDDGCCGHDGGGBDGGHDFCFGCDGCFCHDCCGCHC;CFCH@CCFEBHBCCFFACCCFCCFCHCHCFHH:FCFHCCFGHCH=FGFGG@??>>;@?	C	98	T	90
14	24740347	G	38	gAaggaagggGAGAGGagAGggggGAaaggggaaAaaa	>FFCCFBC?CEFEEEEDDECDDCCEFGGDCEDGGDGGG	G	21	A	17
14	24771137	G	28	GGAAAAGgGaAaAAGGaGAAAGggGGaG	AE@EFB:DEFFFFEDBGDCAEDDDCDB>	A	14	G	14
14	24799287	A	59	TatatTTtTTAATtatAttaaAatTataTAAtATataaTaTATATtATaattttTaaaT	E?@DEFGGGGHHGGFGHGGFFHFGGDFEGHHEHGGHGGGGGHFHGHGFCBHHGHFGGFD	T	32	A	27
14	24806229	G	145	gaaggaagggGaagggaGGAagagAagAgaaggGAagaaggGAagAagaaaagGAGGAgaaagggaggagGgaaAgaaaagaGagGAGgagagaGaGgagaGAAagaggaggagaAAGAaaggggGGAagGAgaggGaAGGGgAA	CA=BACCCCDAFEFFDDCCGEFEEHEFHFEEEFCHEE>5EECHEEGEFECDFECHCCHFEDEFEF?GEEECFEFHFFEBEFFCFG?HC>FGFFECECFFEECHGFGBFGFGEFFCGGBGFEFGF8BBGFFBGGFGG>FEABBA@A	G	75	A	70
14	24839083	G	68	GCgGCGcccCgccCGccGgCGcGGccgcGCcGCcGCGCgGcGgcgGCCGGGCggcGGGCCCCCGgGCg	?@EEGED9DFEDCGDCDEFFDE5EED7DE9EEGEDEDDGEEDC:GDEEADDEFFE@DDDDDDBB>B>>	C	34	G	34
14	24846961	G	46	TgtttgtttTttgggttGtggtggGtgtggtgggtgtgtgttGggg	:FEEDEEEEEEDFFE7EA8FEDFECFGFEFEFGGFFEF>>FGGGGF	G	24	T	22
14	24878485	G	122	aAGAGGaaAgAgaAAaAAaAgggAAaAGaAGGAAgGGaAAaGaaAgaAgggGgAaGGgggGAGgGaaaaaAGgGGGaaaAGgAaAaAaaGgggagaGgaGGaagAaAaGagggaaaAAAgag	?A<@>>ECFDHCEGHFEHFHCCCHGFECFHC?IIBCCCHHF@FD=CFHCCCCCHGCCDDDCGCDCGGGGGH;DCCCGGFGBDGGFGGGGBDCDGDGBDGBBHGDGGGGBGD@DGECECC??A	A	69	G	53
14	25043802	C	51	AcaaCCcaAcaAaAaCcCaCACACCAAacaaACccCAACAcACAcAacAAA	@BBA?>DDHDDHDHEDCDFDHCGDDHHEEFEHBDBCGGCGEGCGEFEACB?	A	29	C	22
14	25044712	C	60	ttcctcTtTttcTcccttctTccctccttcttttcttccccctccccctcttccCctttt	AC=?D<CFEGFAG@BBGG@GGBB@GBBGABGGGGBGGBBBB@HCCCCCHCH;CBFCHHCG	C	30	T	30
14	31344039	A	39	GGGGGGAAAGAGGAGAGaGAAgGGAGGAGAAAAAGAgAA	8BEEEE@FE?EDDEDEDF?=EGDDEDDDDDECBBA<AAA	G	20	A	19
14	31359024	A	25	aatttaataaattttaattattatt	BCAEDDDD;DDDDDDDDDEEEEDEE	T	14	A	11
14	31425457	A	60	tAAAttTtttAAAAaaaaaaTAaatAaAtttAAaaTattaaaAaTaTaaaaaaaatttat	?<??EECEDDDCDDFFF>>FEEFFEEEEEEEEDFFEGFFGEGEGEFEGGGFFGGEFFFG=	A	39	T	21
14	31549745	T	52	GTtGGTGGTGgGGTgtTTgGTtGTTGttgTTtTGTTgGgGGgtGTGtgggTg	FEEHDEHHEHGHHEGFEDGGEFHEDHFFGDCFDGCDGGGGGGFGDGFB?<?A	G	28	T	24
14	31765126	T	74	cTcCCCTCCTTTCCTTCCCCTCCCCTCCCtCCCCTCTCTTttctTcTCcccTtCtTTccctTccCTCcCCCtTt	FEEEGGEFGFEEGGEEGAGFEGGGGEEGEFEGGFDDCFDDFFGFDGDFEGCDFFFDDGGGEDGGFCEGEEDB>C	C	44	T	30
14	32438484	G	56	GGggAAAgAgaAAGGGaAgaaGAgGggGAAaaaaAGaGaAGAAAGGGGAAGgGggG	;9CC<HHFHF<FHCCCDFFCDCHFCG?BGHEEEEEBEBEGBGGGBBBAGGA>>B:?	G	29	A	27
14	33068608	C	86	CCTTCCCcTCTTTTCTTTTCCTTTtCTCCCTTTTCCCCCTtCTcCTTTCCCCtCttcttcttTTTcCTTTtCcttcccccctTttt	??CEGGGDDGEEEEGEDEEGGEEEFFEGEGECEEEGFGFDFGEEFDDDFFFFEFFFEEFEFFDDDCFD:DFFEFFDDCBA=>A>CC	T	47	C	39
14	33165182	C	29	CCCCTTTCTCCTTCTTCTCCTTtCtCTTC	FHGEFFFGFDFEEEEEFBFFEEHFHFEAA	T	15	C	14
14	33292743	A	187	ACCAACCAACAAACCCCaAAAAaACAACCCCAaACcACaACCaAcACACAAaCCAcACCAAACCCaCAAAcccaCCCAccAAAaAcAcACcaCACCAaAaCCccaAAcaAACaCCaccCcaaaaCcCcCCcaaCAaaCCaacccCcaccAaaaccacACcCCcaCAcacaAaccaCCacAAacAaaC	B<BA<>>;@>>ABFDEEEDEFFCFFFFEFGFECFFGFED?FFDFGFFFGFFDGGGGFFGFFFGFFDBFEFGGGDEEGFFHDFF>EHFHEFHDFFFGEEFEGFGGEFFHEEEFEAFEGHFHEEEEFFEHFEHBEFEEDFEEEIHHFHEHHD;EEHHDHEEHFFHEFEHEHCEEGHBFDACA@?AB>=C	A	94	C	93
14	35222732	C	118	CTCcCTTCTTCCCTTTcTCttCTCCCCtTCtttTCCTtTcCTCcCTTtCtTCTTCTCTttctCTTtTTTttcCCTCtCTCTTCTTTCTCTTcttCTTCCtCccTttcCtccCcttTTT	EC?B;EDEEEGCGEEEBEGHHDEEGGEHE<HHHDFGE>ECGEGCGEEHFHDEDEFDEDHHCHFCDGEDDHHAFFDFFFDFDDFDDDFDFDDBHHDDDCFHFCCDHGBC@@?C=?BA@A	T	67	C	51
14	35230980	C	47	TCTCCCCTCCTTTTCCTTTTCTCTCTCTCCCCtTTcTCTCCCCCtcC	>FEHG5EEGGEDEEGEEEDD>DEDFCCDDFFFFDDGDECECBA>>@?	C	26	T	21
14	35546373	T	216	TCTtCTTTttTTTCTTCCcTTtTCTCCcttCTCCCTCTtcCTCCCtCTcCcCTTttTCTCTTTTTtTTTTTTTtCTtTTTCTCttcTCTtTtTCtttCCTCCtcctTTCtTCCttCTtcctttTctcTctTTCcTTtTttcTcttcTTCTttCttCCtttcTccTCCttttTcttccttCctttttctccttTTTCtCccttctTtttcCtTcctc	>CEE6FEFEEFEFFF>8BDFFEFGFE?DEEGEGGGFGFEDGBFFGEGFDFDGFFEAFBFAEFF:F<@FFFFFFEFDFEEBFFEBFEEGFAFFFFEFFGGFFFF@EFFFFEFGFFEDFFEEFFFBEE?DEFEEFEEEFEFDEEEFECEEDEFFF<AEFFFFCEEFEEEEFFFEEFFEEFFFDFFEFFEFEEFFEEEFFFEEFEEFDEDCBBAA?=?>	T	136	C	80
14	35871960	G	101	GAGAaGGgAaaaAaagGGggaGagggaAgGGaGgGGaaGgGAGgAgaaaGaGaGgAAgaAagggGgAgaAaggGGaAAaAaggaaaagagaGggaaGaggg	B?=>DBD@EEEFFFFCEECCFD@CC@FFCFEFE@EEFFECEFDCFDGGGEGEFE@EFDDEGDDDDD9DGFFDDEDGFFFCGDDGEHADGDFDD:GGDF>=:	G	53	A	48
14	37131993	G	25	GGGCCCGGGcGCGGGcCCCGGCCGG	GFGFGGGAGCFDFFFCFFFFEECB?	G	14	C	11
14	38060646	C	124	TTTtTCCTCTcCCTCTtTCTTTTCcccTCtTCTTCTTTccCtCCCTTCTTTCTtTCcTctCttccCCCtTCCTttTCTTttCCcTcTtcctTctTTtttCTTCTTtTCCtCtCCCCtTTtccCc	?ABDDEGFFFFF9DFFAFFFDFFFEFFCGEFEEFFFFFGFEDGFEAAFD@FGFDFGFEGFEEFGGFFEEEEFDF9EFEDEAEEFEGEDFGFDGEEEFFFFEEFEEEBFDFFDDDDFECD@@AAB	T	69	C	55
14	38205231	G	76	GGGGaagggGAAagGAGAAGagAggAGaAgaaaAaagagagaGgaGagggAGAgaagggaaaggagaaaaaagggg	CBABBDEEFA>EFFHEH@EHEFEFFEBFEGGFGEGGGGGGGGHFGDGGG;EHDGGGGGCGGFGGGGGGGFGGFE??	A	38	G	38
14	50065444	G	186	GAaGaAagAGAAgaAAaagaAGGaAaGaaagaaAGagAaAgGGggaAAagAGggggggggAgggagAGGaGagAAAGaggagaaaGggaGAGGaagGaaaaagagaggAaaAggAAagggaGAaGggaaaaAAgaagaagaggAgagaaaaaagaGGgGagaAGggGaGGagAGagAaaAaAGGga	B@>>A@DEDCD8FEDECDFDCCCC:DEDDDFDDFCDFFD<FECFFDFDDFFAFFFFFFFFFFFFDDFEFCEDFFFFEDFFDFDDDEFFCEFDEEDFEDDDEEGEGDGGFEEFEGEFEGGGEECEEGEEEECEE9EDGE<EEEGEGEGEEEEEBHE@DGDEGEEDEG;EDDEGDADEBBAC<>>A?B	A	101	G	85
14	50196373	T	44	ggGgtgGtggTttGggTggtgggttgttgtgtttgggggtgttt	C9?FEECCEEGEECFFGFFE@FFFBGFFGFGFFE?GGGGFEFFB	G	25	T	19
14	50808965	A	40	caAaaacccCccaaAcAaacAcaacaCaacacaaaacaAc	=EFEEEDDDGDDEEFDFEEDFEDFEFGFFEEEFFBEEFED	A	24	C	16
14	51223789	C	193	CTtCcctcTctCTTtctTTcTttTCtctCCttTcCTCTCtcTttCCTcCcctCTCctCTCCTTTtcCcTtCCcCcCcTCTTCCTcttCCttCTttTttTCCCtTTTcccCcCCCCCTTCTCccctcTCCttTCCTTccTtCttCCCTTcTtCcttttCCtTtTCttTTttCcCCTtTTcTcTtCCCcCccTct	A5C>CBFCGDEDGGEDEGGDGEDGDDDECDDDG=EHEG7EDFBEDDE9DDD6DGCDEDCDDFC?FCCDGFDDECEDEFDFFDDFEFFD>F@DEFFEFEGDD:FGGGEEECE:CCDDFFCFCEEEFEF=CFFECCFFEEFFCFFCBCEFEFFDEFFFCCCFFFFCFEFFDFCBCCDFEECFECAA==@A@?C<A	T	97	C	96
14	51224374	T	113	TGTttgtggtGTtgGGGTggttggGGgttGGgGtttTggGTTgggtTtgtTtttgtGtGGtGTTtTTGGtTGttTtTgtGgtTGtgTGTTtTTgGgGTTGTTTgTttGTTgGG	@=ADGBGBBF@GGCACCGCCG@CCCCC=GCCCBHGFGCDCGGCDDHFHDCFHHCDHCGCCHCGGHGGBBHFCHHFHFDHBCHFBHDFBFFHFFDBDBFFBEEFDD@<>D??CC	T	62	G	51
14	51225097	T	97	ctcCtctttCCCTtTCCtCCTCCCTtCtcCTCccTtCtCTcccCCCcCCTTCtccccCCCtCTCCcTcTCcTcCcCTCcCccTcTCtCCCcCtcttt	CCCACEEDDEFGDEEGEEGG@FFFEEEEFAEEFFEAGFGEFGGGGGGEGEDGEFFGGEFFFFDFFGDGDFEDGFGFDFFFGGDGDFFCFFGDCCA??	C	63	T	34
14	52186966	G	183	AAgAaAaAAGAGgaGaagGGAAAgAAGgAAGGGggGAgGGgaAgAGGGaAaaAgaAgGGAagAGaGGGaAgAaGaGGAAaGAGgAaGaGGGAGaAGgagAAGGgGaGGAAGAAAGaaaAAGgggaggGAAGAGGaGAgGGAAGGAagAaGGGGgGGGAGAGAGaagAgaGgAGgAGAaggGAA	?@ACCC5EGCHBCFCFFCACDCHCFHCCEHCCCCCCHCCBCFGCAABCFHFFHCGH8CCGFCHCGCBCDHDHEC8CCCHGC@BDHGCEACCH@GFBDGDGGCBDBGBBGFBGGG@GGGDDBDDDHEDBGG@GBBGBGDBBGGBBGFDCGBBBBDBA=FBFBFBGDDFBFA?C>9@>B=8?C?C	G	95	A	88
14	52481917	C	118	TCTCCCtccctCTctcTcccCccctctCttcccctTccTtCTTTcTcTCcCttccTCCcttcccccctcccttctTCttCcCttccctcTcTtttCTCtCcCTtcCTCCTcCTTTcCc	CA==<8?>>BB?BDDCFDCDDDDDEDEDDEDDDDDGDDGEEGD=DGDGDDDFEDCG??DBEDD?EEEFEEDFFECGDFFDEDCDEDEFEFBFDFFCFCFCECF:ECFCBEEBEDC@@>	C	69	T	49
14	52755385	C	56	CTTCCcCTCCtCcctTCTccCTTTTCcctTcccccTtctcTtctCtcTtCcCCCtt	?EFGFDGFFFEFDDDEGFDEGFFFFFEEFEEDCEDEEE@DEFDFFFEEFFCDBBA=	C	32	T	24
14	53101581	A	53	GAGAAGAGGAAGGAAGAAGGGAAGAGAAGGGGGGGAgAAAGaAaGGAagGAGA	BB@BFGEGGFEEGFEGEFFGGEFGFGFFGFFCFEFEGEEEFFEGFFDFGDCDB	G	27	A	26
14	55154053	C	80	TCTCCCtCTcCCCCCCcTTccTCTcTccTcCttTTctTCCctCCTctTTTtCctTTcCCCTTcTTtTtTcctTtcCttcC	=@=BBGF9EBFGGEGHBEEBBBGEBEBB=CEHHEE@HEGGBHGGECHCEEHFCHDDCFFFD9CDDHDHD6CHDFCEHD>A	C	41	T	39
14	55221543	T	70	TtCCTCCtTtCtCtTCTtTtCCccTtCcctCTtCttCTCcCTtTCctctCcCTcCcTTCcTctctctCTt	?DBCGDDEDEDEDEGDGEGFDDGCGFDGFFDGEDFECGCGC>FFC<FGFCGCFGCGFFAGFGFGFFEAAC	C	35	T	35
14	56145312	A	53	agaaGaagaGaggaaggagaaggaaggaaaaaggaaggggaaagagagagaga	A@:C:BD=GBFFFFFFFDFFFFFEFFFFFFFF;FFFGGGGFGGFGGGGGGGGF	A	29	G	24
14	57046829	C	30	cCcaaaAaccaACCcCAACcaAcaCaaAca	@ADDEEEBDDE>DGEF;EDE=EEFFFDDEA	A	16	C	14
14	57196766	C	33	TCCTCTTCTTCCTTCCCTtTCCTCTtCCTTCTC	CGGGGGFGEEGGEGGGFFFFFFFFFBFFFCCA@	T	17	C	16
14	58063689	G	31	ggcgcgggggcgCcggCgcgGcgcccgccgg	C?=@?BBCACBC?BCCFCB@EB@CCCD@CCD	G	18	C	13
14	58831142	A	36	GgGggAaaGaggAggAAaaaGAGgGaGAGGgAgGgg	?BGEFFEDGBFFFEGFCFFFFFGGFFF>FFFEFE:<	G	22	A	14
14	60519920	C	49	CtcTTcttccttccctccttCCTccctCTttCccttttctttctccccc	?CBA>FEEEFEEFEFEFEEEGGGGFFEGGFFGGGFFFFGEFFGFGFFB:	C	26	T	23
14	60574539	A	153	GaAAAGgaaGAaAAaaAAgAGGgAgGGaGaAGaAAGaaggAAAAaaaGaAaaGGGGgAGGAAaaGGGaaGGgAGaGAAaAagggaAgaggaAgGAgGgGAAGGgGgAAgGaGGggGGaagaggggAAGAaaGaAgGaaAgGAgGGgagaAGga	@C@BADDFDGEEEDEEEEDEHHFEFH9FHFEIF9FHFFEFEEEADFFDFEED:HHHFEBHEEBGHHHFFFEGEGGGEEGEFGGGGEGGGFEDDHDGFGHCDGGGHDDDGGGGFGGGGCEGGGBGGDDGDFEGGDGGGGDEGDGF>FFGEAFA@	A	78	G	75
14	60581863	G	210	agGaAAaaaGGgGGaagagaaaGAagggagAAgGgaGAAAgaaggggaagAAggggaaGAgGgaaAagGAGaGgaaaaaGAAGGGgagggAGgagagaGAGAaGAaaaggGgaaggaGggGgagGGAGaaAAggAAAAGGGAaGGGaggGAggGgggGaAGGgGGGgGaAgaaaAAgagaGGgaaggAGaggaGaaGGaaGGaGggGAgg	C@;D>BCE9BACABFDCECEFFCHFCCCBCHHCCCFCHHHCFFCCCCFFCHHCCCCFFCICAAFFHFCCHCFCCFFFGBCHHCCCCFDDDHBDGDGDGCHCGGBHGGGDACDGGDDGCDCCAGDCCHBFGHHDCGGGECBBHG>BBGDDBGCD@@DBBGGBBE=BBCBGGDGGGGGDFDGBBDGGDDGBGDDGAGGABGE?AC>?<ACAA	G	115	A	95
14	60585131	A	205	AAGAGAAGGAAAGAAGGGAAGaAAAGGgGGAGAAAGAaGGGGAAAGGGaaAGGAAgAAgGGGAaaaGAAagGAAgAaAgGgAggGGAGgggaGgGAaAAGGAagGgaGGAGgAggaAggGaaAAAgAGggGAaaAggGGgGaaGGgGaGGaGagaGgaaaaaGaAAGGGaaGAGagAgaGGGGggGagGGGAGgAgagAAaGAaa	;9>>@@@ADDE?EFFDE?FEEDCFFEEFEEFEFFFEFDCEEEDFFEFFDDFEEGFEFFFEDE:DDDEFFDGEFFFFCFFEGFGGEEAEG9GEEGEFEFFEEFDGEGCEEFEFFGG@EGGDEEEBDGDDGGEDEEEGGDDGDEEDDGDEDDEDEFDDGEFEEDDEEEDDDEEDEDEGEGEDDDDGGDAGDDEFDEDB@=AC@C?BB	G	107	A	98
14	60591829	T	88	tCttttttTTtTtTCccTCCTCcTTccCTCCTCcTcCCTCCTTtcTTtCCCTCccttCcTTcCCCTTCCTtCTTCTCcTttcTTCCcT	CA??BACDEEDEDEGGGEGGEGGEEHHGEGGEGHEHG=EFGEEEBECEDDFDFHHEEFHDDHFEFDDFFDEFDDFDFHCEEGCDGDAA	T	45	C	43
14	60600477	T	96	aTTtatAAtAaaATaaATtTAttaTAtTTttTaAtatttTaatttttatattAatattaaaattTtTTttatTtTtttttaaattaatatatatta	C>@DEDCDEEFEEEEFEEEEEEEFBEEEEEEEEDEFEEEEFFEEEEDGFGFEEGFGFFGGFGEFEFEEFFGEDFEFFFFEFEGDEGGFGFFFGFFC	T	58	A	38
14	60900113	C	40	cCCttCctccttctcttCccTcttctccCTctTCCtttct	C<>CEBBGBBBGBGAGG:BBGBGHBFBCDGCHG@DHGHBG	C	21	T	19
14	60935281	C	41	cCCCCTctCtCtCcCccccCtccTtcccctcccCccctccc	C@FEGGGDGAHCGGEGHGHGEHHGEHHBHEHHHFHHHDDCA	C	32	T	9
14	61447662	A	204	AAaCCCcCCaAAAAAcCCccaaaCACACAaAaaaACcAaAcAACACCAACccCCCAaacCACaaCcAaACCAACcaAacaCaaACAccAAcaccCCCcaCCcCacAcCAcaaaACcCAAccCaaaccaAaCaaAccaCaaaccaCCAAACCcAAAaAAccCCCccAAaAacAAcaAccAcCCccAAccaAaCCaCAAaCAAcca	B@@A:?ECECD>>DEFEEFGCDCGEGEGEDCDDCEGGEDEFEEGEGGEE6GEHHHEDDGEEGDDGGDDEGGD=G?D?AHEDDEBGEHHEBHEHHFFGHEEGFGEHDGADBEE@EEECEEHH@EEEHH<8EGDEDHH9EEDEHGEFFDDDFFHDDD@DDGHFEFIDDDFDEHDDG=AHHDHFFHHDDHHCDEEADFBB?A@@BEA	A	106	C	98
14	61916081	G	44	gaaaagggaagagggagggaggggggaaaaaaggggaagggagg	?CDDCFFFEFFEF<FCFFFDFAFFFFFG6GGGGGGGGDGGGCGD	G	26	A	18
14	65544367	C	33	AaccaaCaaAaaaaaAccaccaaaacaAcaccA	:B6BDEFEEFEEEEEADDEEEFDFDEEE@FEEA	A	22	C	11
14	65568215	G	37	GgGAGGGGAGAaGgGGGAgGggagagGggggaggagg	E<EFDEEEFDEEDGEEEEECEGEGBGDDGGGEGGEFE	G	28	A	9
14	68036753	G	36	GgggAGaaggGaAgaAAgGGgaaaGGGgggaaGGgg	:A8CEEFFCCEFFCFFFCEDDGGGEEDDDDGGCEDB	G	23	A	13
14	68042496	A	27	AAAGAAGGGAAGGAAAAAAAGAAGGGa	FHHCBHCC?HGBBG?GGGGGBGF@:C@	A	17	G	10
14	68191368	G	32	GggggggagggagAaGagggagGaagggaggg	BBEFFFEEFBEEE6EEEEEFEEEEEFGFEGF>	G	23	A	9
14	69376623	G	33	AGGGAGAAAAAAAGaAgGGAAGGAaAAaaGGgG	HBCCDBGGGHGHGBGGEBBGGBBGGGFGG@???	A	19	G	14
14	69376775	T	25	ccctTCtttttccCttccccctttc	?<AFGGGGFD>ABGHCBB:CAH:HA	C	13	T	12
14	69445057	G	42	CGgccGccgcCcggCgcgcgcgggggcccgggccccccgCcc	A@=?@ACACBF=CBGCB?BCBC@CCCBBBCCCBBBCCCDCCB	C	24	G	18
14	69792569	A	70	AAAGAAGAGGAGGAAAAGAGGAAGGAGAGAGAAgAAAGGGGAAGAGAGagagGaAGAGGAaAAAaGGGAA	>@EAHHCHCCHBBHDHHCHC=HHCAHCHBGBGGGGFGBBB@GGBGBGBGGEG@GGBA@<FDCC>;<AA??	A	39	G	31
14	70478175	A	95	ttTTTtTTATAAaAAAAAaaAaAAAaAAaAaaaAAaATaaaAAaAAaaaAaaaAAAAAAaaaAaaaAaaaaAAAaaaaAaaAAAaAaaAAaAAAa	B>D@FEGG@GG:FHHHIEBFHCFHH=HHFHFFEHGGH:GDGHHGHH?=FHGG;HC@HHHGGFGGGFFFGGGG=GHDFGGGGEGGGGGGFGFGACB	A	85	T	10
14	70478176	C	96	ccCCCcCCTTCTTtTTTTTTttTtTTTtTTtTttTTtTtttTTtTTtttTttTTTTTTtttTttttTtttttTTTttttTttTTTtTttTTtTTTt	BADEEEGG@>GFGD8GG>GBE>GEGGG>GGEG?EGGEGFFFDGFGFF>FGEEG:GGGGFEFE>EDFGABDFBFFFEFFFEF<AFFDFE=CFEFEC>	T	87	C	9
14	70478183	C	109	CCCACaAAACACcaAaAAAcAAaAAacaAAaAacaAAcAAccAcaaACCAAAaacAcccAaaaacaACAaacAccCAAaAacACACCaACACCAcaacCCcCCaACAAC	CBDGCDHHDD>DGDHDHHHFHFDFADGDHHDHCFE7HGHHEHGHEDGDCAHHE=HHH?HHEE=EHEFCGEEHGHGCGEEGDHGCGAC@F?GCCG;9EGCCDAA@C@B@@	A	67	C	42
14	70522484	A	104	AAAGAGAAGAGgGAGGAGAGAAgaggAAGagAgGGAAAaGGGaaAgaagAGaGGggGAgAAAggaGggAaaagAAgAaagagGaagaGaaaAAAAaGAAaaGGg	@DFFFGEFGEGCGFGGFGFGFFCFCCFFGEDFDGFFEDGBGGGGFDGGDFGGGGDDGADFFFDCGGDDEGGGDE:DEGEDGDEGGDGFGEGEEEEGFDDDCB?;	A	58	G	46
14	70522684	A	34	caCaCccACCaacaaccacccccccaaccccccc	CABEFFFFGFDDGDCGGDGGGGHGHAEHHGHGG?	C	24	A	10
14	71199452	G	148	AGAAGGGGgGAgAGAGAgaAGgAGAAAaAGGGAGaaGgGgGggaaaAaGAAgaaAAaAGGaaGaGAGAAGgAGGAGAAggaAaaAAaggGaaAAGGAaaGGgaGGGGaagGgGAgagagaGaggaAAagGgAAgggggaGggagggga	>>?A@ACEFEFFFEFBFFFFDCFEFFFDFEFEFEFFEFEFEFAFFEFFEFFGFEFAFFEEFGEEEFD:F;GFEEFEEFGGFFGGFEGGGDGFEFDAEGFDDG@DDDDGGGDGD=FGGGEGDCGGGBDGFDGEDGDGGGEEFFC<AA@B	G	76	A	72
14	73404795	G	44	AgGAAAggGAAGAGaagaaagggaggggggaggAgaggggAaaa	AC@??=@BFBDG>FEFCFFFBCCFCCDCDDGADDCGDDDDDGGG	G	24	A	20
14	73728957	G	31	GGGAGaGGGAGAGAAAGGGAGAAAGgGAAAG	EGGFFFFGGFGFE>DEFFFEFEEEEGEEBA>	G	17	A	14
14	73958375	T	100	tTCcTCCCTCTCCccCCcTTTtCTcTTCTCCCtCTCcTTTTCCTTCTCCcTTCcTTtcTtcTCCCCTTCtCCtttCccCCCCcCtCTTCTttTTcTTTcC	?=AEEGGBDEEGGBFGGF;EDEGEEEEGEGGEEGCEGEEEEGGEEGEGGGEDFGEDEGAF8DFFDFCDFFFFFFFFGEFFFFGBFEDCFADEDDEDB6?>	C	53	T	47
14	74206658	G	111	AGGaaaAAggGgAGaaAAggaGaAGgaGGGAgagaGAAaagGaagGGgGAGaGAAGAgaAAAGGGGGAGggaGGaAGaggaGgggAGAgaaaGAAAGGaGAAgaGggaGGg	=8<AAAGHFFCFH5DCHHFFCBDH7F5ACCHFDFDCHHDD9CEEGCCGBGCECH7CHGEGGGBBBB>GBFGEBBEGBDGGE5EFGGBGGCFFBGGFA;EBFGFD@@?==CA	G	59	A	52
14	74404756	T	205	CTccTTCcTtcCTTCctTTCtTCTcCCCCtCCtCTCtTTtttccTtTtTCTctCTtCTttTTCcCccCtctCCTCccTCttCccctCTtctCTTttcctctTTTTTTttcttCTCTTtcctTtCtTCCtctcCcCctcCTttTccCccCctctTTcttctctTTTCtcTctCTTcctTccCccCcTcctctCccctcTttccttt	AB??@=?B=CCCAEEFEEDEEEGEFGEGGEGGEFEGEEEEEEFFEEEEEGCFEGEEGDEEEEGFGFFGEEEGGDEFFEGFEGFGFFAEFGDFDDFFGGEGFEEEDEEEFGEEGEGEEFGFFDEGEEEGEFEGFFFGFGEEFEDFGFGGFGFGFDDGFFGFGFDDDFFGCFEFDDGB@DGGFFGDGCGGFFEGEEFC@@A>:ACCC	T	106	C	99
14	74425056	C	33	ccccCcaAcaAcaaaccaCcccacacccaccca	CCC>C@FEAFEBDFDBBFGABBEBGCCCG@<AG	C	21	A	12
14	74439495	G	25	GAAGGGGGGAAAGAGAAAAAGGAAG	=HHCCBBBBGGEBGBGGGGGBBED>	A	13	G	12
14	75356541	G	72	GGGTggGttTTTGGGGGTGTtGTtGtGTGGgGGtTTGTTgTGGTGgGtTttgGgTTgGgtTtgGGGGtTTtg	AH>FFFHEDEFEHHCGHEFEFGDDHFHCH@CHHFEDGDDGEGADGGGFCG;FDGCDGGDFDFGGGGE>>A<A	G	39	T	33
14	76149830	T	72	tTCCTCCTTCCTtTcTTCTCCcCCTTcCCcTCCCTTTcCCCCTCtCCccTCTTTccCTCctTTTccCCTCcC	A@BD>DDDGDDEEGFGGDGDDGDDGDGDDGGDDDGGGGDCDDGCFCCGGECFFFGFCFCGEEFEFFB@DA?C	C	43	T	29
14	76156609	C	237	CTTTCccctCTTCCCCCCTCtcTTTTCcctTtcTTtcCTTTCTCCcCTTcCTcCTTTttCTTccCTcTTTTctTCcccttcCCTCTtcctcTTTCctttcttCtCTCCtCcTTctttCTTCCCtcCTctTCcttccCCTTTTCttTCTCTctttcTctCCTtctccctcctcTCcttCCCccCTttCcTtcctttcCtTCcttCtcCCCcctCtctcctTtttcCtcccTcttCTct	:BC=>CCCB@AEEEFGFEFEEFFEEEFEFEEEF@;EFEFEEFEFFFGFDFFEFBFFEEEEFCFFGBF;>>FFEFFGGGFFGFFFFFFGFFGFF>FGFFFGFEFF@EEEFFGFCGCFFGDEEEBFGGFFEFGFFFFGGGFFFEFFB;G?FBGFFFG:GFGDEFGFBGGEGGFDDEGFFFFFGBFDFFEGEFHDFFFGEFEFGFFEFGFFFEGEEFGFGGFBEFF8FFGEECCC@<:DB	C	119	T	118
14	76200523	A	27	gagGGaaggaGgggGaggggagaaggg	BCFHHFFFFFHFFFIFGEGGGGGGGGB	G	19	A	8
14	76238203	G	58	GcccggccgggcggcgGcccgggggGggggcGGgggggGggcggcGgggcgggggcCg	>>BDFGEDFEEDEFDFEDDCFFEEEEFEEEDEEE>FGFEGGEEGEEEEECEGFAGEEF	G	42	C	16
14	76525553	A	57	GGAGGAAAGGGAGaAAAGGGAGGGAGGGGGGAGGgAGAGGAAAAaAGAaAAGggAGG	GGEGGFFFGGFFGEFFFGGGFGGGEFFFFFFEFFFEFEFFEEEEEEEDDEFDB@B?B	G	32	A	25
14	77245800	T	75	ttTtTTTTTTTTTTTTTTTTTTTTTTTTTTTTTTTTTTTtTTTTTTTTTTTTTgTTTTgTTtgggtTtTTTTTgg	B>?E7FB;FGB@CB:@ACFDFECFEFF==FECE;D;EA?;D;DEDE>EE>EDE?EDDD9CE9@:9HD5C@8A?:A	T	68	G	7
14	77737088	G	45	AGAGGGAGAGAGaAGGAGGAGAgAGGAGAAgGGAGAAGgAAAAGa	HBGC;BFAHCGCFGBCGACGBGDGBBGBGGB@BGBHH@@DB???@	G	23	A	22
14	77745376	G	43	ggaggaaAAGaaagggaAAGggAgagaagAaagaaAaaaagAG	?BBBEDDFFEEEEFEFEEFCEF>EFFFFGFFFFFEEDEFEGD?	A	26	G	17
14	77746112	T	119	CttTTtcttcttcttCtcTTTttcttcccTtcttcttCTctccttctCctCcctTttcCcCTTttcctTTcctCTTTtTTCttTtcttTTTCCCTtCTCtCCCcCcCCTCCTCTTtTCC	:A?A?C@EECGGA>GGGBF=FGGBGGBBBFCBGGBGGEFBGBBGGBGGBGECBGFGHBFAF=FHHC;H6ECBHGEFEH?EGCGFHCH5EEEDGEEBFDEHFFFCECFFEE;DDDEGBCC	T	68	C	51
14	77790872	T	130	AATTTAATTATTATAaTATATtTTTTaTATTAAaaTAaTAAaTATAAAtTAtTTTAtaTATATTTtTTTATtTTTTAATAtAATtTatAAtATtTAattTaaTtATTATTTttAtATaTTTAAAatAAAA	EC?BGGHGGHGAHGGCDHGHDEDGGGFFHGECHGGEEFGHCGDHGH:FEEGFF>FGFGGHDGFFFFFFCGFFFF:F=GFGFGGFFFGFGEFGFFFGGFFF>GDFECFGFFFFFFDCECDEEDECBACBBB	T	73	A	57
14	77793237	G	89	AGGaAgAaGGAgagAagGAgaAAGAgAaaaaagaAAgggagaaGGgAagggGGgaaagGaagaaaGgggGagGGaggaagAagggaagg	BA<C@AAFFDDCFBEFCHECFEEHECEFFFFFCFEECCCFCFFHHCAGCCCHHCGGGDHGGDGGGHDD8GGDGGFDDGFDDFDCB@B??	G	45	A	44
14	77844869	A	96	GGGgGAagAggGAAgAAAAGAaGGggAAAaAGAAGGaaGGAAAagGAGGGgGGGaGaggaaagaAagAAGagaGGGGagagGaaAAgGagAGAggA	B;>GEFDFFD:EFFFEC?FEFDEEFFFEFEFEEFBBEE95EFFEFEFEEEGDDEEDEGGEEEEEDEGEEDDFFDDCDEGEGDEEDEFDEEEDCCA>	G	49	A	47
14	77934587	T	46	ttctttttCcCTTCtctcTtctctCtttCtctttcccTcctcctcc	?B<CCCDDDDDGFDEDEDGED?DEDDEF9FEFFFEEEFDDFEEFD=	T	25	C	21
14	78188937	A	29	attattaAtaaaaATTaaTtttAtTTaAA	C<BEDDDFDCDDDFGGE9GEEEEEDFDEE	A	15	T	14
14	78198786	T	31	TTCTCtTCCTTTtcTTCTCCTTTCCcTCTtt	ED@EFFAAGEDDFGD@FDFFDDBFEECEDE?	T	19	C	12
14	78325675	C	48	TtttccttttcTTCTttTttCttttCtTCtttcttccttcttccttcC	=ACCACDEEEDFEFDEEGEEGFFFBAEFFFFA:FFEEFFDFFDEEA@@	T	33	C	15
14	78374292	C	181	tTCcTCtcCcttctcccccCcCTtTtTcCTtTTTCTcCTCCCTCCCCccctTTTCTTTccctcCctctTTccCCcctTTTTCcTTCctctttTcttCCTtCCtcCtCctttTcttcttcttctttcccccttctccCttttTctcccctctCtctcttttccttccctctttctcttcccc	A@<>B<D@CBFFAGAAABBDBDEGGGGBDGGGFGDGBDGDDDGDDDA@BBCGGGDGGGBBBGBDBGAFGG@BDDBBGGGGGDBGGDAHCHFGGAGH7DGHDAHCDHDCHHHGCHHCHC=GG6HCG;CACCHHBFC<CFHH>FCHCCCCF;HCHCHCHHHHCCHHCA<G@GGF=F@D@@@@9	C	92	T	89
14	81025522	C	60	ACCAACCCACCCCCAAACACAaACCAcAAAcCCACcAAAACCCCACCCAtaAAAAaACAa	DG=EEAGGEEGEGGEEEC??EGEGGECEDDCGFD<DDCDDFFFFDF;FD<GDDCDFBB@?	A	31	C	28
14	88448525	A	31	GGGAAGGAAAGGAAGagGAGGAGAGGgAGAG	@GGFFGGEFBGGFFFEGFEFFCCEFECCC>A	G	18	A	13
14	88453278	T	61	GTTTtGTTgTTGTGGGGTgGGgtGTGTTtGGgGgTGTGgGGtTtTgtGgTgttGtTGgttg	CCEEEGECEEEDEHHHHBFHHFFHEHEEFCHFGFEGDGFHDFDFDGFGFDGFFGD@GEC>?	G	32	T	29
14	88459656	A	67	gagAGAAGgaGaGAAagAGgAGGGGGAAAgGGAaGaAggGGGAAGAAGGGGAgGGAAGAGAGgagGa	ECFFEFFEFDEDEF:DFFEGEEEDEEFBDAEDFEBEEBGDDEEDDEEDDDDEGDDEECEDDED?A@>	G	38	A	29
14	88792709	C	45	CCCCTCTccCTTCTCTcTtccTTCTttTCTTTtccCtccctCCcT	BDDD?DGFFDGGAG?GGGFDGGGDEFFFCFFFGGGCFGGG@CCFC	C	24	T	21
14	89336352	T	30	TTCTTCTTTTTTCTCCTTTTCTCCCTCTTT	EEFEDGDDDDDDFDFFDDDDFDEFEDFDCB	T	20	C	10
14	90740588	G	103	cGGCCCCCCGgGGCcCGGcggCCGgGccCGgGcGGGGggGgcgCGcCgCCgggCccGgCGCgCCccGGggcgGgccGGgcgcGCGcCgcggcGcggcGgCcgc	A<@@E?EEEEEEEGEFEEFFFGFEFEFFFEFEFEDEEFAEFFFFEFGGGGFFGGFGEGEDGAFFFGEDGGCGCG:GDDGGGFDDDGFDGGGGDGEEGCFDFE>	G	56	C	47
14	90756760	A	76	AAAatAATaTTTTaTATAaTAtAtAaTAtTtTTTAtttaTttaaaatTAtATTtaaattTtTataAAaTaAAATaT	@CABCBFEFCEGGFCFGFFEDGFEFFFFG=FGGGFHHHG8HH@DGGCGEHEFFHGGGIHFHFGHGEEEFGBAACAB	T	39	A	37
14	91773494	G	64	GGAgagGgGAGgGGGaGAAaAggAGAgaaGGGAGgGagAGGAgaAaggGagagggGgGgGGggg	>B>FDDCFCHDECCBECGHFHEFGBHFDFBCCHCFCFFHBBG?FGFGG8FFFEGFBGBFBAEDC	G	43	A	21
14	91792320	G	67	GAGGGGAAAGAgAGAGAAGGAAggAGgaaAaaaAAGGGAagAaAAAGaaagGGaggGaAGGaggGgg	9D?CCCHGICHGHCHBHHCBHHFFGCFFFH<F;GHBBBGFGGFEGGBFFFFBBCFGAFFAAC:>?DB	A	34	G	33
14	92185731	G	38	GAAAGAAGGAAAgGAGAGAGagGggGggaaGAAaagaa	AB<E8FFEEFEFDEE@FDEDFDDD@DDDGGC<EFE?B?	A	20	G	18
14	92280037	T	53	CTTCTTTtCtTcTttTCTTCCTTTtTTcCCCttTCtCctTcTTCTTcCCttTt	D?GGEHFDGDGGGEEGGGGGGGGEBGGHFFFEEFFEFHEEHFFEEEHFGA@>A	T	34	C	19
14	92981606	C	61	GcgccGGCCcGgGGcCCcgcgggggcgcGCggcGgcgccGGgcCcggcgcgCggcccgcgg	AC@>ACCFFDEEEADGFDADFFEEFDGCEFFFEDGEGEBEDGDFECEEFEEEGG>EEFEGF	G	33	C	28
14	93118668	C	110	tTctcctTTTctTtcTTCtttctcTTCTcTccttCcTCTcttcCctcTTCcTCCTCctTtCccttctTTtCcttCtCCttTCcCttTcTTTTCtTCcTCtcTCCTcTtcc	??>D;>CEFFCEEFBGGGGGGBGBGGFGBGBBGGGB@FGBFHBGBHC9FGBAGFGFBHGHGC8HHCHG?HFCHHGHFFHHFF@BBHFCFFFFFHFEBF=GADCCB>AA;9	T	61	C	49
14	93125415	G	31	AGCcCcGCgCCCCCCGGGCGGGGCGGGCGGG	FE=GGCEGGFFFFEEDDDEDDDDFCD?B@CC	G	16	C	14
14	93172903	C	69	cTtcTCtttccttCCttTtTccCttCTcCcTTTCTCCTTCctccCtTTTTttTTTcTCcTTTtttCCCC	CBECEFGGGBBGGGEGBFGEBBFGHFFCGCFEFFFFF=FFCHB5FHDE;>FHEBDCDFCEDDHHHEFC>	T	40	C	29
14	93408256	G	99	gAgAgaggGaggaAaGAaAGAggaAAgaGggAAggAaagGAAgaaaAGGaagaGAaagGAAAgagaGggGagaaagGaaagAGGaaGgGaaAaGgaaaa	A:BDFGEFCEEFFDFEEFBEEFFF@FFF@FDDEFFCDFFEFCFFFEAEEGEFGEFGGGDFE@GBGGEGGEG<GDFGDBEGGCDEGGDGDF=DGDGGGC?	A	55	G	44
14	94732107	T	55	TCCcCCTCCTCTcCCTtTCtCcTtCTcCTcTtTCctttcctTTctTtTtccTCct	@>BDFGCGGEFEDGGEEEGEGEEFGEDFDEEFEGEEFEEEEDDEEDECFDEDF9A	T	28	C	27
14	95033595	A	64	TatTatatTttttATTAaaTAaaatttAAAttaattTaAAataTaAAtataTaatAttatatAt	>BC=ADEDDDEDEEEEEFF;>FFFEFEEEEEEF7FF=GDDG>GEEEDFGFGDGCEDFFGFGEDE	A	32	T	32
14	96157187	G	164	GAggGAagaaAAgGaaaaagaaagGaGgaaaaaaaaagaaAGAaaAGAaGgGAgGaGGgagGAGAGAgGgAaaaGagGgagAGAaAAGGagGGAAGgaaAGgAaggGAGaaGGgggAAAAaAgggGGGGaaggAgagGgggaAAaagAagGagaaAAggGggga	@EAA6C<<CEEDCBFFF=FCFFFCBFCCFFF<DFFFFC@FFCHEEHCHCBCCHDCFCCDFCBHCHCHCCDHFGGCGDCDGCHCH<HHBCFDCCH?CDGFG:BGGDDBGBGGBBDDDEGEGGGDDDBBBBGGADGDFC=DDCFGGGGCGGDBFBFEEEAA>><<=	A	85	G	79
14	96157331	G	48	TggtgtTgtgTtggggtgttttttgggtttgGtgGgtggTttgttttG	BC?AAH>BGBEGCCCCGCGGGGCGCCCHGGDHHDGDHDDDHHCHHEHD	T	26	G	22
14	100119238	G	43	GGtTgGgtttggtggtggttgTggttgtGttggtgggGtgggg	@CDCDGCFGGCCGCCGCCGECECCHGCHEHHCDHDDDGHEC@D	G	26	T	17
14	100166489	G	30	ccgGcgcGcGcggcggcggggcgcCcgGcg	CCDDBCBDBEBCCBCDBDDD@BDCDADDCC	G	17	C	13
14	100380948	T	54	TttTtcTCcCCtccttTCTcttcTtcTctTCtTtTttTCCCttTtTcCCCccTc	BCCFDCGGDFGDDDEEGGGDEEEBFEGEDGGFF@DDFFFFFFFFFFEFFEEDD=	T	31	C	23
14	100795663	G	47	GAGAGAGAAaGaAGgGGAaGAAAAGAGAgaGAGGAAGAAAAAAGGGA	>HCGCHCHHECEHCG>CHE=FGGGBGBGGEBEB@GFBGGGFFF>>C?	A	27	G	20
14	101200645	T	298	CCCcccccTctcttTCctTctcTTTtccctttccCctTCCCCCttCTCCcttcccttCCCTCcttCcctcctcCTCcccCctCCtTCcTTCctccctctttcCCctcTTCcccttcTcTCcctTCtctTttCTctcTCCTttttctttcctttTcTttctcttcTCTCtctcccccTcCctTTtCTtctcCTCccTttTcccccctctcTctcTcccctccctttccCtTCcTCTtttccttTcttTcccttctTctTcTTtTCCCCttCCTtcctcccTtcttTCtTccCCtccctt	D>DAAC?C><@:BB?A>CB@BACCDGCCCGGGAAGAFADGEGGGFG>F5BGGBBBGGGGG>GBGGFB@GBBGBGEGBB==BGGGGEGBEEG<GBBBGBGFGBGGBGBEEFBBBG@BEBEEBBGA?G?GEGGG=BG>EGG=GGGGBGGEB@GGGBBEHHBGBHHBEGEEFCHBCBCC9C<C@DEHFDHCGCG;GCCEHHE?CCBBCGCGBECGCACCACHCCCHHHC6FHDGCDFDBHHCCEHDC@HDC>@FHCHDCHDCDDHDFF@FGGFFDEBBHCCBD:CFHECDB>>BBB9>>@@	C	159	T	139
14	102675350	G	173	CcGgcCccgcGgCCCGgGgcggCGCcGGCGCgGgCCcggggGGcgCGCGGgccgcgCCcgcgGcgggCGGggCCCGCGGCcCCCCgccCcCCcgGcccgGGgccCCCGcCgcccCCCGGCCgCgGGGCcCCCGGGccCccCCCcgggccCgGcgcCcGgcgGGCggcGcgGCg	BC>?=B?:B?AC5EECBECBCBGEGBEEFEGCECGFBCCCCEEBCGEGEECBBCBCFFBCBCEBCC8GDEDDGFFEFBEECFGEF>CCF8FFCDEC=CD?DD6CFFEDCEDCCCEEFEDE<ADDDDCFCEFEDDD@AFCCDFFCDCDCCFEDCDCECDD=DDCFC@?A5<CCA	C	93	G	80
14	102718052	G	26	ggGAaGggGggggaagAaGagagggG	BCAFEGFEGFDFEFEEFFAFFFGGGE	G	18	A	8
14	103389003	G	63	CCCGgggGGGGCGccgGCcCGGgccgcgcgCGgGggcgggGGgGggGCCcgggGCccGgcGcC	ACEACCCGGHH<HBBCHGBGEHCB>CBCBCGHCHCBCDDDHGDHCDHG?CDDDGFCCGDCG@G	G	39	C	24
14	103576775	C	59	cCtcctccTcctctcctctttcctttctcccccttttcTctcttcTctTtcCtttcctt	?;D?>EA?FBBG@GBBGBGGGBBBGGBFBBCB;HFAFC5CHCHHCGAAFCCCIDHC:;E	T	30	C	29
14	103987305	C	55	ACcAcaaAcaACAaAcaAAaaCaaCCCAAcaaCaCCCCCCCCcAacaAcaAaacA	=DAEBFFEBFEG8FEBF:6GGGG;GGGDE8GCGGFGGE:GED;CGC?DCGDBGCC	A	31	C	24
14	104001517	G	99	gaagggGgaAaGaggaGgGaaaagAagGgAGGAGAAGAaGGGagaAGgAaGGaAaAAAGAAAgAgGgagAgAGAGGaggGGgGgGaaAGggGaagAaGa	@DEBCDEBEFFEFCCFECEFEFFCFFCACFEEF?FEEFGEEE@CGEEDEGEEF=FFFFEEFFDFDEDEDEDEDEDDGCDDDDDDDGGDCDCEEFAC@CC	G	52	A	47
14	104193099	C	119	GCCCgGGCCGCCCgCccCgGcCCCCGGCGgGGGCCcccgGgcCCcgcgCCGCGgGGGggGgCCcGccCCGCcCgcCgccGGCcCgccgGCcCCCCgcCcCGcGGcccgGgGCcgcCCcg	@@BEBDEGAEFGGBGCBECEBFGEFEEEEDDEEGGCBCDECB=FCCBDGFDFACDDCDDADEFCDACGFDEC?D<FDDADDECFDCCDDEBF@FFD>EBFDCCDC??:DABB>>=AB;A	C	70	G	49
14	104212685	C	58	gCGCGGGGCGGCGCCGCCGCGCGCGGCcCCCCCcCCCCCGGCGGgcCGgccgGGGGGg	ADCD>CCCDBCDCCCCCCBCBCB7BBCDCCCCCFCCCCCBBCBBGHCBEC?;AACC?D	C	29	G	29
14	104251276	T	51	CtctTccCCccCTttcTTCtTttTtcCCctCtcCccttTcctCccctctcc	?AE?CFFGGFGGFDDGEEGDEDDEDGGFFEGDHGGGDEEFHBGGHHEHEHE	C	29	T	22
14	104381502	T	75	cttCtTtttctttctTTCtTcCctTCtccTttTTcCTttcttTccTCcTccCTttcctcCcTtccttttttcttc	CC??@;BAC>DDDBFGGGGGBGBGGGGBBDGGGGBGEGGCGGG6AGGCGACGGH5@BHCFCEH9BGHIGGHCB=7	T	45	C	30
14	104641612	T	220	CcCttCcCctcTcTTCTTTCCCCttTTTcTTttCCCcTCCCTCTTccCTCctCTcTCTTTTCtcTctTtccCcCTTccctccttctttcTCTCtcCtctCTcctTTTTcccCTtTCtCCCTtcCTTtctttcCttttcCCCtttcctTctCCCTTTcctcttTCTCtTccccCCTTTcCCctctTttTCtttCTTCTCcttccTtcctcCTCctTTtcTT	AC>?B?CCDDC>EDEF?EFAFDFDEEAEDFFEEGGDDEFFF=GEBDDFFFDEFFDEBF:FFEEDFDEFEDDFDF7FDD<DCE<FEFFFEEGEEFDEFEFGEEEFFFFFEEEGE@ED@ECFFFEGFFFEDEFEDAFFEE?EEFFFDD8EEBFFFEBEAFE:GEEEEEFEEEEEEEEEEEFEBCEDDEFEFFF<FEEEEEEF=EDEEEEFEDDDA@A@A=?@	T	113	C	107
14	105057948	C	29	cTTttTctttccTccCtTtttttttcttc	A?ADGGBGGGBAGBBDGGFGHHFHHCH;C	T	20	C	9
14	105060029	T	29	ccctcctctccTctTTcCtcttccctcct	ACBCEEDEEFFFFAEEGFFGFEGGGFGGC	C	17	T	12
14	105258892	C	165	CCCTTCCTCttCTTtCCCcTTCTTtTTCTCCCCCTCTtTTCCTTCCTTCCCCTTTTTTCTTTCTTTcCtCCcTCcTCTTTcCccCTCCtcCTTCTTcTCTTTCCtTTcccTCTCtttcCCTTCCtttTCTCtCTTCCccTCTtTTtCCCTctctTtcCcccCcCC	?<BEGDDEDGGDGGGDDDBGGDGGEGGDGDDDDDG9FHFGCCFGDDGFDDDDGGFGGGCEEFDGFFBDGDDCFCCFCFF=?CCCCFCCF>DFFCFF:ECFFFCCHFFBCCFCECFHCBC<FFCCHHHFCFCHCFFCCCBFCFHEBEDDCFBFA?FD>B>>=@<AA	C	83	T	82
14	105344347	C	148	ggCGgGCgCGGgCcgcGGgGgGggcGcgCgCgggggCcgcggCgggcgcCCcGcgcGgcgGgcgcgggggGgGCGGggggCggggcgggCgCGgCccgcCcgcggcccggCgggcGCcgCCccGcggccGCGCgcGgcCcGcgccgcc	AA=<B8?DDCBE?DEDC7F@BCFFDADEDF?EFEEEDD?DFF:FFFDEDDDD>DFD>FDECDBGEFFFFFBGADBCFCGGDGFGFEGGFDGDCEDEEADDEEED7EEEGFCGGFE9CEFDCEBB7FFDEBC>CFEBFDCDBEEA@B>>	G	87	C	61
14	105349886	C	25	CttCtctctcctcttttccttttct	;A@<BGDGDGF?GDDEBHHEEEEB@	T	15	C	10
14	105612885	G	117	gGaggagaGgAGAaGGGAaagAAgAAAGgGgGAaGgaAGAAAggGGAaaagAAaagAaAGAagAGGGGAAgggGGAaaaGaaGGaAaGAgaggGaAAggGAggGGAaaAgAAGaaAG	C8D@AECE<BH<HF:C7BEFCHHCHHHCCCCCHF5CEHB7GBDDACHGGGDHHGGDHFHCHFDGBBCCGGDDD@BGGDG<HH<AGGG;GDGDCBGGGDDBGDDBAGEFGBDD8A<BC	A	61	G	56
14	105617891	C	130	CCtTttCcCttccCTTTcCCCTCtCTCTcCtcCtttcCtttcCcCTTTCtTTTCCTCTCcccTTTtcTCCTCCCcCTcTTTctCTTcCTTtttTccCtcCTtCtTtcTTcttccCtCtcTTTcttTTttc	:8ABABCFCDDGGDGFDGDCDG>DDGDGGDDFDEEEHDCCBHDHCFGFDEGGGDDEDFDEHGG@GEGGCBFCCDHDFHFFFEECFF@CFF:EEFIHC?HCFEC?FEGFFHEEGGCECDGGFCC@<AA@@E	T	69	C	61
14	105932775	G	39	gCgCCgggggggCgggggggCgGCgggggCgggGGgGGG	C5F@DFEF=GGG?ECFGGFF:G9CHGDFFCGGE?;9=C?	G	32	C	7
14	106320418	C	82	CTCTCTTCTCCTCTCCCCCTTCCCTCTCTCTTTTtTTCTTCCTCCTCCTCCTTTcCTCcTcTTTTCTCCCtctCTTCcTCtt	DGDGDFFDGDDGDGDDDDDEGDDDGCGDG7FGDFGGFCFFCCFCCFCCFCCEFFCCCCCECBEFFBECCBFCEBEDB>BAB@	C	41	T	41
14	106347371	T	168	AATAAaaAAAtaTtttATTtaTATTTAttAtaAAAAtATAttATtaattaaTTAAtATAAaattTTAatTAAtaTtAATaAAattaAaaATtttTtTAatAAAataaAAaaaAAtTTAATaTTTAtAAaAATaAaaAATTTAatATAAaatAAAAtatAaAaTAttaa	B:=@@BBEEFEFEDEEFECEC6FFFFDEEFEEFFEEEFFFFEFFEFFEE5FFEFFFF;FF:GFFF:DFF9F>FGEFFF>GCFGFFG;DG:=FFFCFDFGFEEEGFFGFEEGCEEFDDEE;F;E>EFBE>DEEGEDF=E>CEEGFEBEEGGFEEE@FGEDFFCCCA?B;	A	99	T	69
14	106354343	A	58	GGGGgAAGAGAGAGGAAGAAAAgAGAAAaAAAAAAAgGGaGAAGgGaaaaAgGGagAG	C@DCCAHCDCH=HCCHHCHHGGDFBGCGGGGGGDGGDBBGBGGADBEEFGF@?>>8?@	A	33	G	25
14	106354353	C	62	CCCCcTTCTCTTCCTTCTTTTcTCTTtTTTTTTTcCCtCTTCcCttTcCCttcTCCCcCTct	FGFG>BFFEFBFGGFFFFFFFEDGEE6EFFFEEDEFBFDFBEEFBEDEFFFF9EFDFCCC>C	T	33	C	29
14	106354450	A	115	AgaGGGGGAGGGGaGGAGGGGGAAAgAAAAAaaGgGGAGGAGaAaAAAAAGGAGGgGAAAAaAAaAAaAaAAaAAAAAaaaAAAAAAAaAaAAAaAAaaAaAAAaAAaAaAAAaA	CBBAAGDGFGFGBEGFEGGGGGGFEFEFFEFEEFFGGFF:FBBEDFFFEFGGFG@GGEFFDFFFFFFFE7DEFE8EEEDDEBBEEEEEFEFEEEFEEECEEEEEFEEFDD:CB<A	A	84	G	31
14	106356922	G	82	AAAGGAgGAGGGGAaAGAGAAgGGGGaAAaggGGaGGGgAGGggAAAaAaagaGgaaGgaGgGAAAGgGAAGGaggGagAGG	CB@CCDFCHCCCCEFHCDCHEFBCCCGGGGGGCCFCCCGH;BGGGGFGGGGGGBG?GBF6BGBGGGBGAGGABEFDAC@?C?	G	46	A	36
14	106357527	G	223	GCGGGgGGCCGGGCCCcCGCGCcCGGGcGCGGGCcCCGCGGGcGGCCCCgCGCGCcGGGGcCGCGGCcCGGGGCCcgGGGCcggCGGGCCCGcCGCgCGGCGCCCGCGcCcGGCCggCCggCGCCCCCggcCcGGCCCgCGCGGGGccGgcCgccGCgcGCCGGCGCGggGGccGCCGCCCGCCCGGCCcgCCCCCGGgggGgcgcCCGGgCgcgGcGCGCCG	;>;AADCBDD>=BDDABDCDCEBDC5BC?DCB<@BDDBCCCCCCCDDDDDDCDCD;CBBCCDADCCDCDCBCCDDCACCBDCDDDBB=<DDCBDBBDCBBCBCCCBCB?C@BBCCDDCCDDCBCCCCCDECCC=@CCCDCBCBBBBCCBDCCDCCBCECBCCBBCBCADDBBCC@BBACBCABCBABBBBC@CCDCC@BBB@A?A@AA@>?@?><:;A?????	C	113	G	110
14	106357644	T	353	TCTTTTTTCCctcctTTctcCTCTCTTCcCtttTccCTtcccCctcttCtCTcCtttCTCttctttTctCcttTCTCCCtctTccCCcctCcttttCTTtctcccCCcctctCCtccTTTCCTTTTCccccttcTttcccttCTtccttTCTTTtctTccCtTTCtcTttctcTCTCcttctccCTtccTctcCcCTttcTcccCTctccccttCCTtcTcttccTctttcCttTctcttctttcTtTcctcccTtctttttcccCccTcCccttCcCtccttccctCcctTccCccccttTtttcctccccTtcCtcTCctccTttccttCctcccttccTtctCtTcttct	CD@CBCBAABCC?C???<C>A@B@>?<A=<EEFBAAEFFABAFBFBFGFFGFBGGGGGFDGGBGGGFBGGBGGFGEFFEGBGFBBFFBBGFBGGGGGFGE@GBBBEHBBFBG7GGBBBAFGGFFFFEB=BBFGBDGGBCCGGGFGBAGGFFDFFCBGDBCGGFFFHCFHGCHBFFEFCHGBGCCGEHBCFB@CFCFFH?CEC=CGECHCCCCHHGGFHC;CHHCCFCHHHBGGHEBHBHHCGH=CFHF@CE=CCFHBGHHHHCCBGCCFCFBCHGGCFHCCHHCCCHGCCHECCECCCCHHEHHCCAHCAABEFCEHCDECHCACHHCCHHFCHCCCHHCCECBGGCB>BC>C	C	180	T	173
14	106369433	T	238	TCtTcCtTTTTCctcCCCCCCCCCTTTTCCCCTCTTCCCCCcTtTTTCcCcTTTtttCcttcTTCCtTTTTTCtcCCCCCCCttCcCTTCttCCcctCCtccTttCTCccTCTCTtTTCcCcctcctTCtcTctcCtTCTccCCTcTccTTtcCcCCTccTTttcTtctCTcTTCcccTtTTctTctTTctccCTcCTcctCtTtTCTTctCTCtcCtTTtctCCtttcTTctTctcC	B>BB>@AFFACCBGBCDDDDDDDD<FDHD9DDGDFGDDDEDBGF6GEDBDBFBGGHGDCGGBGGDDEFFFDDDHBDCCDDDCHGDCDGFDHHDDCCHDDGDCGHHDGDBBGDGDDGFGDCCACHCCEGDGCFCHCDHFCFCCDBFCFCCFFFCACACF;CFFHHCEGDHCFCFFCCBCFHFF?DFCFFFAHCCAFCCFCCHCEFHECEFCHBECCCBHFFG?EBBCBB>DC>AD>@;C	C	122	T	116
14	106373208	T	103	tTGgTtttgtTtgTgGttGGTtggttTgggttgtGtttGggGgGGtgttggtttgggtgttGgggtggTGttTggTTggTGttgtttggtgtgtgtgttgtgt	?:=<?DDE>E;DBDFEEEEEFEFFEEBFFFEEFEEEEDEFFEFEEEGEEFFFFEFFFFGEFEGDGFGGFEEFFEGEAGG?DFFGFFFGGFGFGFGFEAA:><>	T	53	G	50
14	106511848	G	74	GCGCCgCGGGCGGCCGCCCCgCCCGGgCccCcGcGgCggcgGCGgcCccgCgGGCGGgcGGCcCGGcCCgCcGg	HGHGFC<HFHAGGGGGEFEGDGEGHHCGCCGCH>CDEDDCDGCGDCFC@DFCGGFGGDCGGFCFFFCFC>><@:	C	38	G	36
14	106725145	T	42	TtTTtTTGTTTTTGTGTttTtTTTtttGTTTtTTTGGGGTGG	<DE5DGGGFGFEGFGFGFCFEGFEEDFFFFFFFF9E@ACBA?	T	32	G	10
14	107169846	C	48	CCCCCAAACCCCCCCAAAAACCAAACCaAACACACACCACCCCCCAAA	AFGGEFFEGGGGGGGEEEEEFFEEEFFBEEAEFEFEFFDEEEB==AAA	C	27	A	21
15	22928537	G	54	CcccgCgCcggcccCgcgcccgccggcgGcgGcgccCGGcggcggccgggcccg	CCB>=BGGEECFFF6FEFFFFFFFFF?@EFDDFFGGFEDGD@EBG8GGEGGGGA	C	30	G	24
15	22955211	C	100	tcCtTcCCtCCtCtcttttCTTcTtcTtttTCctCcctcctctcctTcctcttcttctccttttctttctcctTCtcctcTCttcCcctcTtcCcctTct	C?>EEBGGFFFGEGBGGGGGBFBFGBFGGGDGBGABBGBBGBGBBGECCHCHHCH>CHCCHHHHBGHG>HCCCFGECCH=FDFECDD?HC;HBFACHD?B	T	52	C	48
15	22960700	A	26	GGAAAgGGAAaGGAGGGaGGGAAGGa	BEFFEFE>EFEDDEDDCEDCDEDDCA	G	15	A	11
15	25321029	C	108	cCCTtCTCCtTTtTCccCcCCTCctCCcTCcTTCTCTCtTCCctCTtCctcCTTtTCccTcccccTcTcTccCTccctttTttTtttctctTtTCCTCCtcctTTtCc	BCECEFEGFE7EECGDDFDHGBGDEGGEEDEDCAEFECFEGGEFGEFG9FEGECFEGEDECEEEA9EDEDEEFDEFDEFFDFFCFFDEFDEDEDFFDFEFEECDE>CB	C	57	T	51
15	25328715	T	58	cttCtttTttccTTtCcTcCccTTcttCcctTCCTTTtCcCTTTCTtcCTCTCTCcCc	CCEEGGGEGGBBECGGCACGCBEECHHGCCFEF6DDDHFCFDDDFDHAFCGDGCC@B=	T	30	C	28
15	25925094	C	63	cccCCcCCggccgGgCggGcgccgcccgccgGcggcGCcccccgCgCcccccgcgcggGcCCG	C@@==>@@DCDCDCFDDFCDDDDEDDDDDDEADFEECDEE9EEFD>DEEEEEGEGEBGBECA<	C	39	G	24
15	25958797	G	116	AGGGAGAAAAGAGAAAAGAGGGGAAGAGAGGGGGGGAGGAAAAAAGAGGGGAAAGAGGAAAAGGGGGAGGaGGGAGAAAAGAAAAGGGAAAGGGAGAGgGAaGAGAAaGAAGgAGa	9DHHEHDEECHEH:DC=FDCEHHE9HEHEHHHHGGHEHGEEADDD=EHGGGDDDDDGGDD;CGGGGGDGDFGGG>GA=BDGD?DDGGGADDGFGCGDFFFDEGDGEDDEA7D>>A>	A	58	G	58
15	25969090	G	66	GGGTGGGTGGtgGGTggGGTTgGtggtTTGTtGGTGTgGGtGgGGGtGTGtTgTtTgGtgtGTGTt	?>AEEECFEEDEEEFFFAEDF?DDGGEFFAFEDCEE>GDDEDEBADFDEDEDGEDEGDEGDC@?9>	G	39	T	27
15	27216746	C	39	CTTTCctTCcTCtCcCTTccTTccTtcttctctTTtcCt	C95AECGFFBFFGGCFBFBCBFCCFHCH;CGCGEEH>EH	T	21	C	18
15	28228644	G	69	AgAGggGaGgaagAagaaaaaaagaGgagaGagAaaaGAaagaaagAgaaGGaaggggAaGggggagAa	>BBFDBGFFCFFCFFCFFFFFFFCFFCFCFGFDFFGFGFGGDGGGDFDGGFFGG7@DDEGEDDDDGDDC	A	38	G	31
15	33446311	G	138	CcCcGgcCcCccgGCGGCCGgcCgGggggGCgccCccCCgccgcCgccGcggccccCCCgcCCccGGggcgCcccccGgccgGGCGgGcCGcgGcGCgGgGggcGccCCgggcCccGccCGggCCcGCGcgCgGGcgG	CC>=>@?FCEA@BE:DEGFECBDCECCCCEGCBBGBBFFCBBCBGCBBDBCC@CBAFFFBBGFC?EEDDCDFCCC6CEDCCCEEFCD;CEEBDECDFCDDDDDCDCCCFDDC;FCCDC=FDDAFECDFDCDFDD9>?A	C	76	G	62
15	34649631	G	236	AAgaGGGAAGggGGGGGggAGAGAgaAAAgAGAggggGaaAAAgGgagAAggAAaaGGGaAaggggAAGAaagAGAgaaaGgaaAgaggaGGagagGGGAGggaAAGAaGGaagGGGAGGggaGAAggAGAgGAAgGGAAaAGAAGAgggggaAGAGAggGgagGAgggggAGGAGgaGGagaGGGGGaaAGGGAAGAaAgGAGGaaGagaaAGGAaGAgaAAGGaaAagGGaaaa	ECC@>>=EDBFFCAACCFEHCHCCFFFHHF=CFFFFFCFFFHBFDCFFHHFFHHFF>CCEHFFFFFFFBHGDGHC>GGGGCGGGFEGGGGBBBGGGCCCHCFGGHHCEGCBDGGC9BHCCGGFCEHGGC>GEBGFGCBGGGGBGGBGGGGCGECCGBGGGBDEGBGGGGHGGBBGBGGB?GEGBBBBBEGC?BBGGBGGGFBFBBGGBGEGGFABFGBFFGGGAAFEB?A?@BD=C	G	127	A	109
15	40324837	C	64	CCCTTTCTTTTCTCTCtCCCtcTTtCCtTCcCTCCCTTttccCCCCcCTTCTcCcTttCTcCCT	CFEFGGHGFGFFFGGGEGGGDHGEEGFEEFGFFFFFFFEE;GFFFFAFEDCFHFGF>CFFHECA	C	35	T	29
15	40589830	G	101	ggAGagaaGgAaaggGaAaaAAaGgGgggGggAAGGAgAaAaaagGGaagaGaagAgggAaaggggGAGggagaGGGAAGAAGgaaaggaggaggaagaAa	A?>ADACF<B>FECCHFEFFEEFHCFBCCHCCDEHGECEF@FGEDGCGFDGHFG?CDDDCGDDDCDGEHDDGDGGGFDDGDDGDGGGCDGDDGDDEG==?C	G	52	A	49
15	40595565	C	104	tTCtttCTcCCccCccccccccccccCtTccCCtttTctTtTtTtTctTTTcTccctttctcctctttTtccttctcctTCtccctCcctTccttttTTttTcT	C9ABBBBEGFFGGFGGGGGGBGGGGGFDFFGGF9BDFGCFDBDCDFGDFFBGB:HG=CE;EHBEH<EEEEHHEE;C<AEEFE:HGEF6IEEHGECE8EBCEEGD	T	54	C	50
15	40655845	C	129	CGCCGCCgcCGCGcgGCGggCCgGCCGGCcGCGCGCGgGGcccccCGCccgCgCCCgccGccGcgCcGCgccgcgcgCgGcgcGgggcGCCcgGcgCgcgcgCggCGCGggcCcggcGcgccgcgcgcG	B:7@ABEEDFEAEDEEGEFEGFFDGGCEGDEBEFEEEEEBDDDDDGEFDDFAEBGFEEEEEEEEDFEDCGEEFEFEFGG@EFEDGFGEDEFEFDEFFDEGEFEFFECEDFFEFE@GECEFEEEAB=>?@	C	68	G	61
15	40675329	A	31	ggaGgGGGGAAAGGAAGAAGGAGAGAGGAGG	?=EHFGGFFFFFGGEEFEEFFEFEEEFECCC	G	19	A	12
15	40675493	C	129	CCtctTCTCCcCtctTTcctCCcttCcTtTCccTttcctCCcCcTCCTctccCTCCctCCtttCccTtCCCcCCccTcccTcTtcccctcTCttTTcctctttctcccccccCttcccccctcccctcc	<8BBB@?B?@CBF<FFACCEDCCEEDDBEGDCDGEEDDEDDDDDGDDGDEDADGDDDDDCEEEDDDCEDDDEDDEDFE>CDEGFEEEEEDFD@FGGEEEEF>FEFD;DEEDCC:FEEEDDECEEECEDD	C	82	T	47
15	40855210	T	61	AaattaTatAtAtTAAataatattataTaAaTtaaAaattattTttaattaTttaaaataa	BA?=DDDFDEEEECEDFEFFEFE@EEFEFEFEEF@EGGFFG@FEEFGGFFFCFFGGGEFB@	A	33	T	28
15	40861522	G	62	GTGgGGGTGTGGGTTGTGTTGGTGgGTTTTGTTGTGTGTGTGGgTgGGGTTtGgGTtgGTGg	C8ECGEHEEE;HGECGEHEEHGEGDGDDDDGCDGDG<GDGCGGDADGGGCDHGDGAD@E>CA	G	36	T	26
15	41030865	C	31	gggcgcgcgggggcgggcggggggcgggcgc	?BBDDEEDECEFFDEFEDFEEFGGDGGFEGB	G	23	C	8
15	41165739	A	79	cccaaCcacCCAaacacAaccAaCCacaaaCcaccaccaCCaacaacacAacAaAcaAcaCcaCcCacaCaaAAaAaAa	AC?CDFDDCEFFEEDEDFEDDFEGGDDEEBGDEDDFDEEGFFFEFFEFEFFEFEFEFEEFFE@FEFFCAFF5EB>?>?B	A	43	C	36
15	41785690	G	109	GGGGGgaGAGAAggAgaAgAAaGggGgaaaGgAGGGGGgagaagGgagGgGGGAGAaGaaaGAGGgAagGAGGGaGGggAGgAAAgagGGgaggAgAagAgGGggaaaa	;<=<>AEBHCHHCCHC9GCHGFBCCDBFFFCC;BCCCCDEDFFCC9FDCDC=AD<HGCGGGCHCCDHGDC@BBBGBBDDGBDGGGCGDBBDGDDGB?GDGDBBDDGGDA	G	66	A	43
15	42114414	C	57	TtCTTcCCcTTCTCtCCTtcTCTTctTCCCCcctCCttTTCTTCCccTTCTCtcCTc	GDDGGDDDGGGDGDCDDGEHGD=GHE>CCDCBHECC8EFFCAF@CHHFF@FDCB?C@	C	30	T	27
15	42128568	C	105	CCGCGCCgCCCGGCCCGGGggGGGCCGGcGCGCCCGGCGGGCGGgcCGCcCCgCCgGCGGCCGCCggggCCCCCgggGGCgcGCCcCGCGGCcCGCGGCCgGGGg	>;CEDFFE@FGEEFFFEEE=FEEEGFEEBEFCF6AEECEAEGDAEDEDEE?EFFCFDFADEEDFEGGGFFFEFFGGFDDEFDDEF;FDECDDDECDCDEFBBA>D	G	54	C	51
15	42137773	G	39	GgaGGGGAAAAGAGGGgAGAAAAAAGAAGAGGAaGGGGG	7CFCCBBGGFHCHCBBDG>GGGGGEBCGBFAAGGB??@C	G	21	A	18
15	42143227	T	208	ctttTcctCCctctTctCcTCcCttCCCcCttCTCctCCCtccttcCTCCCTctcccttccTTttCCTtcttCctttCtcCcCtctTCCTTTctttcTctcCtccCcCcCtcttTccccttTccctTctcccTcCCtCTctCCCTttcttttCTCCCcTTCTCCTctCCcctTttctTTttTCTcCTCttTcTctCtTTcCtctctTc	A@CCCA7GFE?GAGCAGFBFFBGGGGFFBFGGFFGBGFFEGBBFGBG?FGGFBG9@BGGBBFCDGGFFGCGGFBGAGGGBGBEGBGFGFFFA:GHHCB?HCGHCCGCGCGHCGGCBCCCHHFCBCHFCHCCCFCDDHDECCFEEEHACHHGHGEFEECEEEEEEEC;E?AC?DHHCHEEHHEEECDEEH>ECECH=FEECFF?B;;?@	C	109	T	99
15	42145586	G	107	GggAGaGGGAGAAgaGGGGgGAGgAGgAaGaagGAAggaagaGgAAgaGgGGAGGgAggggAggggAGggagaaaAAagaGaaAgaAaGgaagAgaggAaAaaagGG	>@BC=BA<CHCEHF6?CCCFCHBFHCFHECEEE8HHFFEE?BCFHEEFCA;CHBCGHGF>BH6DGGHC9GEGB@EGHDABAEDGGEGFBB=EFGFFGFECD<@A>AC	G	59	A	48
15	42153893	G	28	aaGaGAaggGaaAAAAGGaGgAGAgGAG	AC7GAHFCDBGGHHGG?BCBAGBGB=DC	A	15	G	13
15	42433382	A	108	TaAATTTATATATAaTATATAAatATATTtaAtTTAaTTATAAAaAATTaATATTaATTTTaTTAtTAtaTTTATTtAATTaaaaTTatTAAAaatAtTATatTtaAT	CDEBEECEE<FBEEEEBEEDEEFEEBEEEFFEFEEEFEEDEDEEEDE>EFDDDC6EDADDDEDDDFDD@FDDDDDDDDDDCFFFDDDFECCCDFFFCEECBA?@>>CC	T	55	A	53
15	42710219	G	33	gccgGgcggccgggcggcggggggcggggcgcg	>A@9CDCDDDDFEECEFDFFFFFEDCEFFDGEG	G	23	C	10
15	42976706	C	115	tCTTttTtCTTCTTtTTTtCCccCcCCtCCcCtcCtCtTCTcTTtcTccCtccCtTcCcTttcctcTTcCCCcCCtCtCtcTtttCtttTTtTtTCTTTcTCCcCTtcCTctTtt	@>?EGG9GGFFFFEGEFAGBFBBGBFGGDFB5GAFDFGFGFBFEGC@BBGHCCFHDCFC=HHCCH@FFCFED=F@HDHEHADD<;EHIHEEHAHEFDDE?EFECEEHCFDB>CC@	T	62	C	53
15	43398108	A	66	gAaAaAaGaGgGgAagGggAaAAAAgAaAGAGaAgaGaaaAAgGaAAagGAAAaAGgAGGAgAGgg	?BEFFFFDGECEBFGDEDDFDBFBEDEFFEDDGEBGDGGGEEDCEEEGDBEDEGEDDDDDDBDA>@	A	39	G	27
15	45706739	A	25	AGAGAAAAAGAaGAaAgaAGaAAaG	FGFFFFFFFGF@F=EEG=EFEED@C	A	18	G	7
15	45779810	G	46	GGGAAagGaAaggaggAGAGagAGaAaaGAGAGAaggggAgAgagg	=>CFFFFEFEFFGGGGCDEEGGFDGFGGDEDFDBGGDFGEGEGGGB	G	24	A	22
15	48054538	G	70	cgCGggcccCgcCCGgGGCcggCcgcCCgcgcgggCCCGcGcCcgCGcccGGccCcgCcGccgccCgcgc	?B?=CBEFFEFFDDCFCBDFFFCFEFDBGGGGGFGAA7CGBG@GGDCFGFCBGGCGFCGACDGFGCGFED	C	42	G	28
15	48547976	T	80	CCTCTTCCCTTtCTTCTccCctTCCCTtttCTTCCcCCTcTcCcccCCTTTTCTtCTTcccCCCcCccctTtTTTTCTtc	>EEAEFGFGFFEDEFGFFBGGEFEFDBFEEFFFFFGEFEGE6EGGGEFEEDEEEFFDEGGGEEFFEFGFFDEDECD==A?	C	44	T	36
15	48813107	G	28	tgtGGtgGGgttggtttggggtgggtgG	AA?A@DCGGCGGC<EHHDDDD:DDDHAH	G	18	T	10
15	49017656	T	147	gGgtTtgTTtTGTtGGTGTtGtTGggGTTGGGGGtTTtTGGTTgGGGTtGGGGGGTTggTTGTgGtTGGTGTTTGTgggGGtgTTTTgttTGGGTtggggGGTTgTGgGTTGtgtggtgggGtGgtGtTGgggtTGgTGGGttTtGg	B=CCEDEGGEG;DECBGCFECEGCEECGGCCCCBEFGDGCCGEF?CCGFBBCB==FGGFGGCGGCFGBCGCGGGAGFFFBCFFGFGFFFFFBBBFFFBEGCBFFFEBGBFF@>FFFGFGFGBFBEFBFEAFGFFEAFECC@DED??D	G	81	T	66
15	49044538	C	44	CGcggCCccGCCCccCCGcccccCGcgcCcgCgGccGgCcGgGC	?HDEFGGDDGGGGDDG?HEDEAEGHEEBGEFFGGFEGFFEGDFB	C	29	G	15
15	49148356	C	35	AAcAaccaaaacaAcacaCAcaaCcaacaccaaac	AABFFABFFFFCF?BFCGFFCGGECGGBGACFG@7	A	21	C	14
15	49325289	A	78	acaccccaaccccacaacaaaaaacccaacAcaccaccaaacccaacaacccaaaaaccaaacacacacaaaacaaac	ACA;?AD>CEFFEDHDCGCDDDDDGGGDDGFDDGG@GG:DDGGGDCG>AGGG9DDDD<FDD?GCFEHEGEEEBHAEDG	A	43	C	35
15	50158695	C	180	CAACACcaaAaCCAcACaAcCCCcCAccacAcACCCcacaaaaCAAcaaCcAcACaacCcAcacAACcCcACAcaCAaaCCACaCCaaacAcccaCCaAcaaCcCcaCCaAcCaccaCaccacccCacccaAacaCCCccaCCaacaccacAcAaACcccaACCaaaCaAaacCCccAcc	B===?BDADCDGGEGEGCEGAGGGGEGGDGEGEGEGGDGCDCDGEEGDAGGEGEGDDGGGEG9GEEGGGGEGEHEEECDGGEGEGGEEDG:HHHCGGEEHEEGHGFDGGEEHGEHHEGAHHEHAHFEGBHCEEH<FFGHHEFFEEHEHGDIDHDEDFGH<EDFFEEDFDDDDGDEEDAAE	C	100	A	80
15	51503897	G	60	AGGGAAgaaggGAggaGagaggaAAAAAAGGAGGgggAAaAgaaGgAagaaaAgagggag	>=EDFECFFCCEGCCDEFDFDDGEFFFEDD>FCEDDDEEGEDFGDDDGDFGGDDGCCB@>	A	31	G	29
15	51510868	A	84	CCACcaCACAcAACCCaCAACACAACaAcacCCCcaaCCAaaCcAACacACCcCAAAcaCccAaCCcAAaaCCacaaAcccAac	GGBDDEGEGEDFFGGACGFCGFGFFGFEEFCGDDEFFGG>FDGCFFGFDFDGEFEEEEEFEEEDCFEEEFFFFEEFFEEDEF@B	C	44	A	40
15	51529265	T	38	TcctttcTCtTCcctCttcCtttTccctcCctctctcc	=CB>FFEFEEEGFFEGFEFGEDFDEGFFFGGFGFGFFG	C	20	T	18
15	51634255	T	120	GGGgGggGgGTgtTTGggGtTttttGTGGTGTGtggggTTtTgTGgGTGtgtGGtTtggTtttTgtgTtTTTgggtgtggtTtttGGgtgtgGttTttgtgttggggtttGgttgtggtt	B9?CBCFAEEFFB<B;FEEEFEEEEE@DD?EFEDF9EEDDE?FFFFEBEDFEEDF6EEFBEFFFG<FFEFEFFGGEDFGFFFBE@EEFFGFFDFDFFFFFFFF@GEGFFECFFFD>C@=:	T	61	G	59
15	51675625	C	45	ttcctCcTtCCtccttctCCtcCTttccttCcTTcctttccctCT	?DBAGDBGGEEGBBGGBGDDHCDGGFCC=;DCFFCCHHHCBBHBE	C	23	T	22
15	51914662	G	66	GGGGGGAGaGGGgGaGAAGAGgAGgggAgAggGAAAGgAGGGGGAAagGAgGGAGGaGAAAAGGAa	CD5FGGFEFCEBCGFGFFGFDDFGDDDFDFDDFEEEFDEFEFFFEEEDEEDFFEFFFEDEEEEC@C	G	41	A	25
15	52820904	C	28	TCTTcCTCTTCCCtTTCCcTtTCCCtTt	GDF=D@GDEGCDCFFFCCEFFECCCA?<	T	15	C	13
15	53081800	G	64	gccgCCgCCcccgcCGGgCGcGGGcCccCgGGGcGggcGggcCGcGCccCgcggccGgcgggCc	??>CGFBGGBBBCBFEFCGE<EEDBG;CEDBEC@DDD?EDCCG>AEFBCEDAD:@@D@BC>?A8	C	33	G	31
15	54792428	A	26	gGaaaGaagaagaaaagggaagaggg	AHEEEHEEEEEEEDFFGF@EEFFFEB	A	14	G	12
15	54804450	C	28	CCtTTCTTCTCTCTCCTCTCTCTTCCTC	GGDFEGEDGEGEFDFCDFDFDFDDBAAB	C	14	T	14
15	55625984	A	38	GAGGAAAGGAGGAGAAGAAGGGGGGGGAAAAGGAAAAA	BF@C:FFD@F8?FDEEB;EADDDDDDDEEEEDDEECCA	A	19	G	19
15	56126450	T	73	TCTTctcTTttTCTTCCCTctCTcTCccCtCTCCTCcCtctCCCcTCtcCtTTttTTtTTtTCcTcCcCCCTT	B>BEFEFCEEEEFEDHGGEFEGEGDEFFEFGEG>EGG>EGFF?FGDDF?FFDDECCDFDD@DDGEEC7BC>CC	T	37	C	36
15	56130692	T	70	TTTTTtTtTTTCCTTtTCCtCCTcTtCTCTTCCCCCTtCtCctTctttTTccccCTtttCttcCCtTctc	?EEGGEGEEGEHA@GEG=EDA::EEDG=FGFGGCFFGFFDGEF>DFFFEFEEEEFFFFFFEFEACEEDA9	T	41	C	29
15	57524857	T	40	TtTCCCCTTCTCCCCTCCCTCTTTCctTCctCCTcCTCTC	EGGGGGFGGGGGGFFFFFFFFFFFFCGFFCHFCC@BB9?A	C	23	T	17
15	58724371	C	105	CCtCtctCCcTtctttcctctctttccccCcCCcttcCCTctCCtcCTCtCCTtttctccCccttcTtcctcctTccctcctcttcTCCtCcctCCctcCCcCct	A?BAC?FEEBGGAFGGBBFBGBGGGBBBBGBGGBGGBGGEBGGFGBGGHEGCGGGGBGBBGC@HABGHC;HCCHGCCCHCCHCHHBFEFHFCCHFFCHCFF=C>A	C	64	T	41
15	59453384	T	42	tTtccTtttCCtcttcTccctTTtCcTTttCTcttctTtccC	DEFBB;GGGDDG:GGBG@BBHGFGDBCGHHDFCHHCCFHBC@	T	25	C	17
15	59974566	C	26	GgGCCCGCggGCCCcCGGCCCGGGCg	;FGDAGFFGGFFFFGFFEEEEDB?CD	C	13	G	13
15	60771289	A	138	AGAgagAGGGAaaAGaaAgGaagAGgaaaaAgAagggagaGAGAaaggaagggAaaaaAaaagaggaAAgaGGaaGgaaagGgaGaagggaggGaagAGGagAggaGgaaaaaggaGgaAaaagAagAaGggAGgggg	>>>CCFEG=GFCDF;DDEFGDDFEGFDDDDADFDFFFDDDGGHFDCFFDDFFFFDDDDFCDDFCGGEFFGDGGDEGEDEEGGGEGEEGGGEF=?EECFGFEGAG?EFGECEEEHGEFAEEEDEAE9GDEFFCECBBDD	A	74	G	64
15	63548787	G	103	AGagGGggaAaaagagggAgGaaGagaAaGAGagGgGaAgaggaaaaaaaGgGAagGggGgagggggaGaaggggaaagaaaAagagaaagggggaaagaaag	>>C?8?BACBDFFCFCBCFCEFFEF8FDFEFEFCDC?FFCFCCGFGFFFGE8EF?CE8DEDGCDDDDGEGGDDDDGGGDGGGEGDG=GGGDDEEDGGGBGGGA	G	52	A	51
15	63837058	G	31	AGagGaAaggaaaagagggggggaaaagggg	>?FCEFFFC:FFFFCFC?CCDBD?GGGDDDD	G	17	A	14
15	63918307	G	100	CcccGGGgcGccggCggcgGGcgGgcggcggcgccCggcccCgccgggccggGcggcggcgggcggccccccggggCcggggGggccggggcccgcggcg	?CA?;:9B@DBB5CFBBBCEEBCDCBCCBCCBCBBGCCBBBFCBBCCCBB9CEB?CBCCCCDDADDAACBCADDD?GADADDEDDCCDDDDC>CCBDDB?	G	57	C	43
15	64011104	T	46	CcttTcCTCtcccctTctttccccCctttctcctccctccctcttt	DC>?BAFFGDGGGGDGGDDDGGGGDGDDDGEGHEHHHEGGHCHEEE	C	26	T	20
15	64418397	G	68	GaGaGaAGaaaGGGgagAGGgAaGagAggaAgaAGgGGaaGAGgaaaAgGaAgAAaAAggAgagaAgg	;A6AAEHCEDCCCCEEEACCEHE>DFHGF=HGCHCFBCFBBGCFBFFEGBFGGBGFEGFGGFDDDEBB	A	35	G	33
15	64428657	G	174	aGGaaAaAGGAgAAGgAGagaAGgAGGGAgAgAagAggGaaGGagaggaGGgGGAGGGaAaAagGAAAGgGgggAGAAAgGAGaaggGaaaAgggggGGAgagGGAgggGGagAgggaAGgaaagaaggaaAGaAgagggagaaagagggaGggggGggggAggggaaaagGaa	AC?AD;B@CEABADFCEFFCADHBEHHFECECEFCECCGF@GHFCFCCFGBC@HEFAHF6F;FCIEEECC6?CCEFEEECHEHF<CCFFGFDCDCDDFGEDG@BHDDDDGHGCE6DDGE;DGGGDFFDDGGDGFDDG@DDGDGGGDGDDDHGDDDEGDDDDDADDDGGGGDFBC	G	99	A	75
15	64496926	T	38	tttctctCcctccTcCCTCtTCCTTTTCTTTCTTCCCT	CCBAGBGGBBGBBGAGEFFHFFGE?E;DEEEDEDDDA?	T	20	C	18
15	64962630	A	150	AcacCCcAACacaCaaACaCCaaCAAAAaAcaCacaaccAAccAAaaccaAccAaaaAaAAACacACcAACacacccACcAcaaCccccccaccCAaaaacaCAcaAAaccaacAcCACaaaCaaAcaacaaCaaccccacacaaaaaac	E??C=?EGFCDFBDDCHDDDDDDDHHHHDHGDDDGDDGGHHBG8FDC?GABGGHDDDHEHHBDDGGDHHHDDGE<GGHDGHHEEDHHHHHGDHHDHEEEEGDD@HEHHEHHEEHGHDFCEEECEEHHFFHDFCEDHHGGEH9GDBAA==A	A	85	C	65
15	65499101	T	36	TTTTTTTTTTTTTTTTTTTTTTtTTTTTTgTggggg	>;FEFDFCFFFFDBFFFEEEEBFBEEDBD@BD:9:?	T	30	G	6
15	65684453	T	37	tCtttttttCCtCtCttCtCCtCtCtCCtttttttTt	C<C?DEECE9;E7DDECDE9?C?F>F=@AEC9BBDE8	T	25	C	12
15	66679819	G	36	gGCGgggCGCGcGcGCGCggggccGgGcgcgcgggc	AADCCCCDBCCBABDD:DCDDDCCCDBCDCDCDDDC	G	23	C	13
15	66841033	G	28	aAAggaaGagaggaagGaagggggaaga	C>BFEDDDCF<FFDDFEDDGGGGGEEBE	A	14	G	14
15	67501782	T	120	CCTCTTTCTCcTCTcTTCtcCCTCtCTCCtCtCTCCCCTTcCTtTcCcCTTTTTtccTtCcCttTTcTctccTtctTCCttTccCTtTCCCttCCCCTttTctcTctTCtTTCctCCctc	BAABAGGGGGDGGGDGG@EDGGGFEEHGEEGDGG:GGEGGEFFEGEGBGFFDGFEEBGFFEB;FEFEFEFEEFFEFFFFEEFCCFFFFDFFFFF@FFEEFEEFEEEDEFAC>B@<>?BBA	C	60	T	60
15	68126126	C	159	ttCtcCCTcctCTTTAtcttTctcTTTttCcCCCccCCTTCCtTCCcTtTtttttTttTtCttcttcCTTTcccCctcCCTCTTtcttTctccTCccTCtccTTTTCCcccttCTCTCcttttctCcCCtTctcTtccTCCCCctTccctCcctcTtct	CC<?><?BCBEBGFF:ECEDFDEDGGHEECDDEDDDDDEFCDEGDDDEDGEEEEEDEEGECEFDEDDDGFGEEDDEFEAAFDGF?EFEGEFEEGDEEGDCECGEGEDDE:EFE@FCG7DF:FADACECCEFEEEFEEEFCCCCEFFEEEFCEDEAD@@<	T	80	C	78
15	74284406	C	30	CGGCGGGCCGCgCGCGCCCGCCCGgCCCgg	FEEFEE@F@BFGDCFDFFE@F=EDGC@?A7	C	16	G	14
15	74560831	T	32	GGtgGttgtGGTttttTTttTTTtTtTttttt	?=EBDEFCBECCGGGGFFGBEBEC:GCDFE>B	T	25	G	7
15	74659609	G	101	TTTTTTTTGTGTTTGGTGGGTGGGGgTGGGTTTTGTGGGGGGGtTTTGTTgTTTggTTGGTGTTTGGGTgTGGGTTTTTGTGTTTtGtGtttGGGtTTTgT	FFEFFCGGEFEF;FEEFEEEFEEDEGFEEDFFFFEFEEEEEEEFEEDDFEGEED>GEEDDEDEEEDDDEGEDDDEEEEEDEDEEEFDECA=EDDEDDBB@B	T	56	G	45
15	74749015	A	75	agaGAgAaGaGggAAAgaAAgAaaAAAggaaGAgagGAaagaaGaggGAaGggaaGgAGgGAGGAGgggaggAGg	CBA?@EEDHDGFFEEEFD9EF@DDEEDFFEEHEGEEHEEEGDEHE<GGEDGGGEEGGDDGGDGGDGGG?C>FDF@	G	38	A	37
15	75129594	G	74	AAGGGaaGGAAGgGAAGaGGAGAgGAaAAAAaGGagaAGGaAAgGAGgAAAAAGGaAAGGAAGAGGAGAaGAAa	:BDEEFDEEF;EDEDFEFDEEEBCEFGE@FFB;E<8FBDDGE?GDEDGEE>DDDDFEEDCCDCDBA6A=;ACC@	A	42	G	32
15	75685175	A	62	AcaccAaaaaaacccCcaAcAcaCaccCccCcAcAaccCaaaCcCCAcACaccCcaCaaACC	=CDGG>DDDDDDGGGAGDHGIGCDDGGAGGD@HHHEHHDEDEDHCCGHGCEHHCH<CEDG@D	C	35	A	27
15	76031200	C	25	TCTCCTTCTTCTTTTTTTTTCCTCT	CFCGGFEGADFEEEECEDDCEFC@A	T	17	C	8
15	76183191	T	38	AtTTTTTAAATtTTtTATtATAatTatTTatAAtAtat	B?CAEEEEE;DEE9FACEEDCCGEEEFCDGFDDFCFBA	T	24	A	14
15	77324880	A	126	AAgGGGAAGaAGGaAAAGGGAAGGgGaAAgaAAGAAGGaAGGAaaAAgGGAaGGaGGagAaAAAAaAGaaggAAGgGAaagGgaAAAaGAAAgAGGAGGaggAAagagaaGgAgAgaAaAAAaaaa	@ABBEEDCEF9EEFFFF8EEFFEEC@F9DCFE:EFEEDGEEE=GGFDDEDFFEEGD?GDEGEEDEGEDGEDADEDDAEHHDDDGEEEGDEDDDEDDADDGDDDDGCEDFFDCC@C>?BB?CCCC@C	A	75	G	51
15	77407114	C	87	CGCCCccCgccGcccccGgccgcGgGgGggGcCcGccccgccggGcGGCGcCGCGgCggggcggCCCgcccGCGcCgcggGcgCcgc	DBB>?DAGDFFEF=FFEEBFFAFEFECEC<EBFFEFGFFEGGGGDGEEGEGFEFD5D787GGGGFEEGGGGDEDGED<GGDG:CA:B	C	47	G	40
15	78557092	C	145	CCCCCTCTCCTTTTTTCCCCCTTTtTTCTTTCCCCtcTCCCTTTtcCCTTTCCCCcCTCTttCTCTCCCCTcTTCCTcCTttCcTCCTCTtTtcTCTTcCCCCTTCcCcCTCTTCTCCCCctctTCTTTTtCctTCcTCcCCCTC	D>DC@GCDD>DGHG>GDDDDDGGGE?FDGG:DCBDFAFDDCFEGFEDDFGG8DDDEDFBGBEC>DGDDBCFDGFCCFECFF@CEGCCFCFFFFCFC=FBCCCCEF?E=DCFCFFCFCCCCDDAFF>EEEFFCECED@CA@@<ACC	C	79	T	66
15	78567853	G	137	GtTTTgGgGGGGTTgtGGgGGTgTGtTGGtTGTGTTTGTGGTtTTTTGGgGtGTgGTTGgTTTtGTGtgttGTtGGTGGTTGGGGTtGTGTtgGTgTGGGGGgGGGgGgGgtGGGGtTTTgTTTTtTtgtTtTgtGG	=BA>?B@D>EE=FFFEEEFEE8FF>DFEEEFEFEFEFEEEEFFEFEFDEFBFEFGEFFEGFFDDCDEEFFBD;FDEDEDEDDDEDEFDDDEGGAEGDDDDDDEDDDDDGCGF@DCDFEDDFEEE?DA?BAB:B>9C@	G	72	T	65
15	78841220	T	40	cTtCCtCctCcccTCtctcCctCccccCtcTcccttcTtt	?=FAGGGBG6BBBGGGBGCGCGGBCCCGHCGCCCFHCFHH	C	25	T	15
15	78909480	G	50	aaAGaGGgAGaGagAAAaAGgGgGGgGGGGaAGaaaggGGGGGggAgggg	EFBEFFCCFEFBFCF>DGFDDEDEEDEEEEGFEGGGDDDDDDBB7ECDDC	G	32	A	18
15	79755583	C	199	TCtccccCtcctTctCTCTTTttccTTTcCTtcTTTccctctTCctCcttCTtccCTtTCtcccTCCtCTccTTccCCcCCtTctccCTtTCtcttttccTTCtTcCcCtCccTtttctcCTCCtTctcctttCcCtcctCttcTcctcTtTccTcTtCttttTTTctcTCTtttcctTcttctttctTTttTTctCTc	BDAAC<<<D@AGEBGFFFAFFFFB@FFFBBCGBFFFBBBGBGEGBGFB@GAFGBBFFGFFGBBB@HGGGFBBFFBBGFBGGGEBHBBGFF;GGBGGHHCCEEFHDCFB>HFCCFFHHCHCGFEGEECDCCHGHGCFDBCHGHGBFCCHCECE;BE@DCFFCGHEEEC9CEEEEHFCCG6CHHCHHHCEEEHHDECE>?@	T	106	C	93
15	80263345	A	201	CCcCAaAcaaacccAcaaCACaaAaaaaAcAAccaaCaCacAcCCcccacCaCCaAAcACAACaCCAcaAAAcACaCCcacacCcaccCcaaaacaacaAaaAAACacCaaaaACaacaCCCacAcCAccACACaCCaaCaaaacAaAacccCaaacaccAaccaaAccAAcaACCACAaaCcaaaccCAaAaCcAcccCc	AA@=ACBC=BDFFFGEF<EHDFFHFFEEHFHHEFFFDECFFHFDDFFFECDFEDFHHFHDHHCFDDBFFHBHFHDFDDGFFGGDFFFFDFG?DDBGFEGHFGHFHDGGCGAGGHDGGGE@DDGGHFDHGGCDHDDCDGGDBGGGGGGGGFFG@GGGGFGGGH6F>8G:BEGGEGCCGCGGGCGFGFGFCGGGGCFEB9?AC	A	107	C	94
15	80452075	T	209	TTCttTCCCCCTCTTTCTTTTCCCTCCTTCTCTCcTTTcCTTCCCTTcCCCCCTCTTTCCTTtCTTCCCCTCCCcCTTCCCccTcctTCCTCTCtccCtTctctttCccCCCTCTCCCCtCccctttcTttTCttCCTttCCtCctCCTTcTCcTCcccTCCcccTTCCTCTCTCTTtcTTCcCTtCCTcccTTTcttcttCTCTcCcc	B@BBCCGGGGFEGEEEGDEEEEGGEGBEEGEGDHEEDEFG:E@GGEAGF>GGGDBE@EEGEEEGE=GFG>DEFEGGEEGGEGGEGGEEGGECEGFGGGFEG@@EFFGGGGGFDFDFDGFFFFGGFFEGDGGDFFFFFDFFFDFFGFFFDCGDFGDFFFFDDCGGEDDDFCECECFDDFFCCEGECDFDDCCABBCBAAA@?@>@A@@DA	C	116	T	93
15	80672260	C	28	CACCCCCCAAAAAAACCACCAAAACCCC	CFEFFHGFEEFDEEDFFEFFEEEEEF9?	C	15	A	13
15	80867480	G	183	GgGgggGgcgCCcgGCGgCgcgcgggGGGgCGgCCGgGGcCgCGccggGggGcccGCGgggGCgCCCccgGCCcCcgGcCCccgGGCCcCccgCGCcGGGCGggccGgCgGGcgcCGggCggCCccCGcCCccccgcggcGCccCggcgCGcGcggcGggCcccccGgcgCgCccggcgccgc	CC?BBCACHGFFGFFGHFEEFFGFFFHGHFGHFGGEFHHGEFFGGGFFHFFHGGGHBGEEFHGFGGGGGGHEGGGGFHGGGHFGHGEGGGHHG@HGHHCHGGGGHHHGEGHHG<HEHFGGGGFGGHFGHGGGGHHGHGGHGFHHFGGFGFGGGHFGHGGGF>HHHGGG>GFEEFGDCB?EBAD	G	92	C	91
15	81578139	C	161	CCCCctTtCCCCCTCcCTCTTtCTCcCtCTCtttCTtCCccCTccTTcccCcTcCCTcTCCCCCcccCCcTTTTCCCcCCccTTtTcTTCTcCccTtCCctcTttctTCctCcCTTTctCcTctcTTTctttCctcctcCctCttcTtctctCccTtctTc	AA<@BDDFDC@DDG@DCDDGGEDDDDDEAG;EED7HE@DDDDFDDGGEDDDDGDD@GDCDDDDDDEEDDEFFGEDCCECCEEDCEF@GEDGEDE9GFCCEEE9FFDFECEFCECGFFEFCEFCFEFFF=FEFCEFEDFECEFCFFEFFEFEFCC?CA@>D=	C	94	T	67
15	81637284	G	69	gagAGagGaAGaGAgGGaGGggaGgGggGggggGaGGGAgaggGGGaaAGAGGggGGGAggAGaAgGAg	?CBEDECEFGECEF<EEFECC?GEDDD@DDDDDEGEEEEDGDDDDDGGEDDDDDDDDDEDDEDGEDBD?	G	48	A	21
15	86311695	G	260	AgGagAAAgaaGgGaggagaaagagaaaagAAaGAGagAAAGaaaaaAGgAAGAgaAgGGggGAGGggaGgagAaagggagAGggGGGaAaaaAAGagaAaAgggaGggAGAGagaggaGGAggAGAAgGGagaGAGaAgaGagGGGAaggaAgAGgaaaaGAAaAaaGgaaaaGaGggAAAaaGAgAGGGGggAAgagaaaAaGGggAAgGagGgggAaggGggGaaGAagAaAAGggaAGaAGaggggAGaggGGGAg	BC;@@B>AB<<@EADFEDFDDDFDFDDDDFFHDCHCDFHHGCDDDDDFCF;HBEFDHFBCFF@HCCEFCDFCFG8CFFFDF@CFFCBCCDDDBHHCDFDHDHFGCECFFCCH>=>DEGECBDGGEA;GGCBEGECHCEGG9BDECCCHEGGDHGHC@EEEE5HHBHEBB@5EEECECGCGGGEDBGGGBBBBGGGGGEDDBE=EBBGGGGGACGBGGGG;GGB5FBEEBFEGGCFBBDG=CBDF@@?BA?C==;?CCC@@	G	131	A	129
15	89385151	T	78	ggggttggttttgttgggggttgttttttgggttgtGgtgggttgggttgggtgtgtggttttgggtgggtgttggtt	?>>ABBCC=FCCEDDDEFFECEFEEEEEEEFEEEEDHFEDEGE=FGGFDFGGFGEFEGGDFADFGF?GGFEGD=GGD?	G	41	T	37
15	89398407	C	156	TtctccTTTccCTtCCTTcCTtcTcCTCccTCCCtcCtTCcTTCCCCTtTcTtcCCCttCccCTCCttcCTTTTTTcCtTcCCCTTCTCCcCcCTtCtCtcttCCcTTCCCTTCttTCctCcCTTtcttTCcCTCctTTCttCtCctCTtCTCctt	DCCBCB@CEFEDGED@EFFDGDFGFDGCFFH>DDEFDECDFGGCDDDGEGFGEFDA@FFDGFDGDDFFFDGGGGGGFDFFGCBCFFCGCCGCGDFFCFCFEFFCCGFFCCCFFCFFFCGFCFCFFEFFFFCGCFCGFEFCFDCDCB@@D@=CAD@D	C	82	T	74
15	90281045	C	28	cCgcccgCcgccGGcccgggcgcCGcgg	B?FFFFFDFFDFCDFFFCFFFGGCBFG?	C	16	G	12
15	90293701	G	63	AAAAGGGAAAAGAAAGAAAAGAGAAgGGaaGAaGAgggAgAGAAAaaGgaagGGGGgGAaAGg	F?FBDEEFFF?EFAFEBFEFEFDEFDCE>GDECBFDD?E@EDEEE?6DD<E@DDDD@CD<BA<	A	35	G	28
15	90627616	T	94	TtctCtctCccTTTTtcCctcttCTCcCCCCtCCTCtCTcTtccTCCcCCttCcCcTcTctttCttccCtCCcctTTcCcCtccttCtccctcT	C>@DDFCGFBB=FFFGBGBGBGGEFGBGEHGGGEFGGFFAFHCBFG>CGGHGFBFCFCECHFHFHH@CFHDECCHEECECFHD?HGEHC?CHCC	C	54	T	40
15	90771704	G	76	GgaaGaAagagagggaaaGagaGAAGGGaggGAAaAagagagagaaGAGaaggggAGGAGgAgGaGAaaggggGAG	8BCA<DHDFDFAFFFEEECEFECG5CAC;FFCGHFHFGFFBCEA6FCG5EFFGGFEBB;BGGABD@GCFFGFGBEC	G	40	A	36
15	90771750	T	79	gGgtgtgtgtggTGTggttttGTTGTtGtTgTGggtttTGTgGTttGggtGgTTTtggttGgTTGttTGTTTGTGGGtG	C>BCBBCEFDDEFDCFFEEDEE>EEFFEEFGBEFFF@FBEFEEB9FDGGFDFEEEFFGFFDDEEDFFED7EDCFEDBAC	T	42	G	37
15	90772831	C	47	tttcccTCcCccCcccttcTTccCccttTtTtCCCtctctctcccct	CAEGGGGFDFGGGGGGDDGHGGGEGH;EGEFEGGGDHEHEHEGHHHE	C	28	T	19
15	90775397	G	40	gGAgAGGGGGAAAAAAGAGAGGGAAAAAGAAGGGAAGaGG	FEEFFEEEEEEFFFFBDDDEEDDEEEEE=EECDDDEDGDD	A	20	G	20
15	91430617	G	25	gaagaagaaGAGaaaAAaggaaaga	CCDFFFFFEB9CGGGHHGGCEG<G?	A	17	G	8
15	91475274	G	130	GgGGAGgAaAAAGGaagGGaagAAaAAAGGgaAgAggagAAaAagaGagaaGGaGGgAAagaaAAaaggGgaagGAagGAgggAaaaGAaAgGgAgagGAaAgAagggAgaaaagaAaGgaaGaggaaag	B@@?BDDEEBFFEEFFCEEFFCFEFF6FEECFECECCFCFFFFFDFEGBGFDEGEEDFFGDGGFFAGDDEDGGDEF<CEECCCEGGGDEGDDDDFDGDDECDD@FDDDEDGGGGDGDGDDFGDGCBECB=	A	72	G	58
15	91479054	T	25	TCtcTCTCCCCCTcCTcTTTTCtcc	AFEECGFDGGGAEGFDGDDDDEB>@	C	14	T	11
15	91492877	C	42	CCTCCCTTtCTTTCtCTTTttcCcCcTTcTTCCCTcTctttt	AA>BCDFGEDFG<DFDGGGF;EDECEFGEFFCCCFDFBEBCF	T	23	C	19
15	91510282	G	25	AAGaGGGAGAAAGAGAGGAGAAAAg	EFGDGG9FFEFEEBFDFFEFDCDEC	A	14	G	11
15	91811749	G	169	agggaggAAagaaaagggggGggaaAagGAGggggaaGggagggggaaggGGgggagaaagAaGaggGgggGGGGaaGAagAaaaagGgGGgaAagAGggAGgagAAGGagGgaGGAggaAgaagggaaaGGgGGGAGAaaggaaAgAagGaAAaAggGAAaggggAag	?A@BDCCBBEDDFEEFFFFEFFFFFEFFHEHFFFFFFHFFECFFFFFFFFIIFFFGE:FGFEFHFFEHGGGHGHGGF;BGGEGGGGGHGHHGGEGGEHFC>HDGGEDGFGGGAGGCDGGGDGGGGGEGEGGGGGFCDGDEGHGGGDGC@EGGDDGBG@GCDFCCCB@D;	G	97	A	72
15	92397670	C	71	AACACCCCAAcaAaCCAAaaaACaaaccaCaAACAcAacCCAcaCCCCcCcaAcaCacccaaacaccCccc	CBBAEEGFFFAFFDDGFEFFFFGFFGBCFGEFFGFB?GCGGFCGGGCFCEBGECGFGCCCGGGCGCBD?>@	C	37	A	34
15	93749883	G	52	GgaGaaaggagAaGgagAggaGaagaaaggagagGggaAggaaagaaagaaa	@?C>EGFCCFCHECBFCHCCFCFFCFFFCDGDFDCDDDCDDGGD>=GGDGFB	A	28	G	24
15	93844762	C	88	CCCTCtTCCcCCCCTTCTCCTcTTCCcTTTCTCTCCtCCTCTTCCCcCCCCTTTCTCTCcCtTttTCccTTCcCCtTTCCCTtTtcCc	A>8GDEGDDFEDB@GGDG?DGGGGDDGFGGDGDGDDFDDGDGGDBCGDCCCFFFCFCFDGCFFFFFCGGFFCFCCFFFCBCFEC@BA@	C	51	T	37
15	94304132	C	48	TCCCCTTTCTTTCTCCTCTTTCCTCCCCTCCTTCCTCTCcCTCCTtCT	G8FDGE;FFGFEFFFFFDFFFCFFFFFFFFFFEEEEDDFDBCB=?=AC	C	26	T	22
15	98512628	T	39	aaAaaAttttTtTtTTttttttTTttTtttttttttttt	CCEDDEDDDDEDEDED:DDBDCEDEEEEEEEEEEECEEA	T	33	A	6
15	100537494	C	45	TCTTTTtTCTTTTTTTTTTTTTCCCTCtCTctCTCTttCTtTCtT	?GEGFFGFFFFFF?F@EEEEEEFCDEEHFECHEEDDHGFEGBACB	T	33	C	12
15	100871329	G	39	gAggaaaGGaaAgAgaagaagggaaagggaaggGgaaag	?:@@CEECAEFFCFCFFCFGCCDGEGDDDGGDDDCHGHD	A	20	G	19
15	100881995	G	59	GCCGCGCCCGCgCCggcgCGCCGGCCgCccggCcCGggGGGcGCCCCccCCCGCggGcG	CFGEFEGEHFFBGEDCBCEEFF;EACDGACDDF6EDD>DDDCD5EFDACEEEDEDD@5?	C	33	G	26
15	101448571	T	58	ATTTTATAAATAATTTTAAATAATAAATTAtTTAAtTAAttAtataatatTTATAATt	DFFFEE>AFDFFFEF@EFFFEFFFEFFDEEFEEFEF?ECFEBFFFEF?FFEEDDCC9>	T	30	A	28
15	101448783	G	39	aaggAgggAgagggaggaagaagagggggagAaaaaagg	BBCCFFFFHFFDFCFFFFFF:FAGGGCAFGGHG9EDG:C	G	21	A	18
15	101910511	A	95	CACaAAAAacaCCAAaCaAcCaCcCCaCcAAcCAAAaAACACaACaCAaAcaCAAccaAAacAacaCAccAAaCcaACCCaccaaAaCccaccAC	8?BFDFF=EDEGEEFEFCFDAFFDGFEFDFEEGFFD;<FFDGFFFFGFFF8EGFF@EFEFDEEEEDEEEFEEDEEFEEFFFEEFFEFEEEEDDCA	A	53	C	42
16	718296	G	32	AAGGAAaaAGAGAAAAAgAgaGgAAaGAgAAG	HGCCHEG?GC:CHGGGF?GEEBBGGG>>?C@C	A	21	G	11
16	745230	G	49	tTgggggGtttGttGgttGggtGttTtgtGttggTggtggttggtgggt	C:CFFFFEEEDBEEECEE@FFEEEEFFFFEEBGGF9AFGGFFGEFF;FC	G	26	T	23
16	780339	A	51	AAGAGGGGAAAAAAAGGAGGGgggGaaGGgAAGAaAAaGagAGAGaGAAAA	A;EFDBEDEFFEEFEED?EEEGGGDEAEBGFFEEEEDEDEEEDDDEDDC@;	A	28	G	23
16	813650	G	58	AGAGaGggGgggggagaGAGaaaggggagGAaggaaGgagAAGaaaaaAGgAggagGg	E<@;B@FEBEEEFFDEECGBEEEFEEFFECHF6GFFCFEFEGCFFFDBGBFGFFFG@G	G	33	A	25
16	814494	A	26	AGAGAGGGGaGAgGAgaGAggAAAGG	HCGC8CCCCGBGD8GDGBGDDGHF:>	G	15	A	11
16	814683	G	83	GaagGgGGaagAaAAaAgagAgaaAAaaGagaGGggaagAGaaAgaggAggaaGaagGaaggAGaaGGgggggggagGagaag	>?A99=?7DDFHDF;DGFDBHFDDBHADCDGC<B>D=EECBEEBGEGGEGGE=CEEGCBECAFBEEBBGGGGGEHEGBEGDDE	G	42	A	41
16	816294	T	171	tgttttgggGGTtGGGggGTgttGTTggGgTgGGtGTttttggTTggtGgGtGGtTTGGTGggTGTTtGTTTttgGGtTggTgTTGgGGgttgtTGttGTtGggTggtGGGTTTGggTTTTtTTTtgTggttGTgtgtgTgtTgtGTTgTGtgtgTtGtttTGTtTtGtGG	CCA?CCDDFABFDCCCDDCGFEECGFFECEGECCDCGEEEEE8GGCEE>ECECCEGFCC?>FDGCGG<CGGGEEFCCFGFGGFGDCCCCGFFGFFA<@BFDBFGFFFABBBFFFBGGFGFFFFFFEFFFFDE6<GFGFFFGFFEFBFFFFBEGDGFFBEFEEAFE@=<>??	T	89	G	82
16	840307	C	92	AcaCacccACaCCAacaAaCAACcaCaAAAaaaaaCAcccAAaacAaaCaCCaCcaCCCAACaAaacacAAaACCAACAACACcCAACAAAc	B>BBCDDCFFEF@FEDEEDEFFFD9GEFFFEDDFEGFCEEEFE@EFE9FEFFF=DFEFEDEDFEDFEFEEEFEEFEEEEEFDEEDDDCA?B;	A	54	C	38
16	846084	C	60	cctCTttcccctCtctCCcttccCccCttcTcttctttTcCccCcctcctctccctcccc	?CA??CEDDDDEGAD@GDDEEDDGDDGFEDEAFE:FDEEDEEC<EEFEEEE>EEEFDEEE	C	38	T	22
16	855342	A	41	GaAGAAGGAGGAGAGGAGGAAGGAAAAGGAAaAAAAAAAGA	EFDEAFDEEEEED@EEFEEFFDDEEEDDDEEEEEDEEEDC7	A	25	G	16
16	943107	A	137	AAgGgGgGaGaGGaAAAGgAAggaagaAGAGGAAGAGAGaagaAAGGgAGGGAggAggggAgAgaGAGAGGaGgaaaGgGAaagAaagGaAGaaaaagggGAgaGgggaGaaGaAgaaaagaAgAgGGgaaAGgGGa	CCA;@6A?EBFABFHFH9C@HCCFFCFHCBCCHHAHCHBBFC:FFCCCHACCHCCHDDDDDD6DCCHCECCFC?DGGCDCGGFDGGGDBFHBGFGGGDDDBGDGBBDDGBGGBGGDGGHGDFFDFDBBDGFC=:C?D	G	70	A	67
16	943130	C	136	GCGCGccgcCCGGgCGGGCggCggggCgCgcGCGCGGcGgcccGgGCccgCccgGcCGcccccggggGCgcGgggcGccGcCgccccgcCgCgGGgccCGgGGcgGcgGccgcCGgggcgGCgCCGGGGgCgggCg	>@ACBBBBBDDCCBD>CCDCCDCC>CDCDC<CDCDCCBC7BCB>DCDBBCDCCCCCDBCCCCCDD?DBDDCC?DDCBCC:CDDCC>CDCCDCDBBDCC@BDBBBDBCDBACC>CBDDD;DBCDCCAABBB9>8=?A	G	75	C	61
16	1034930	C	95	AcaCAaaAcaaaaaccaccAaacccAcaCcaCcCcaaaccCacacaaaccaaccaaaccaaccacccaaacacaccCAcACccccccAcccaacA	@?B=CCBCCFFEEEDCEDDHBEDDDDDDDDEDDDDEDEDDDFDFDEEEDCEFEEFFDEEEEEEFDEEFEFDFEFEECHEGCECEECF8DEEFF9B	C	50	A	45
16	1034954	T	67	ttTtccCtctctttccttccttttcttcctcccttctctccCTcTCcctccccTcccttcTTTTCTt	BC;DABGGAGBGGGBBGGBBGGGGBGGBBGBBBGGBGBGCBFGCGGCBHCABCEABCHHCEFFFCF;	T	34	C	33
16	1115495	T	52	TCTcttTctccttCTcTCTCTcCCCccTtccTctctccCttTcTTTCCCTTT	8@?AHFEBG9BGG>EBEG>F@BGDGBB=HBCBCHBH>C5H<DDDDDFEEC>C	C	26	T	26
16	1116567	C	48	AcccAaaacAaaACcccaAaaaaaaaacccaacacaacaaacaaaaca	CBABCDDEDFEEDGDDDDFEEEEDEEED=EDFEBDFEEFF5DFFFEEF	A	32	C	16
16	1252441	T	103	CcCcccTTCctTtCTCtTCTcCttTCtTTtctCTCTCTTCtTctcttccttcTTCTcTtctcTtcCttcTtcccCCccCCcctcTcttTTttTCcccccttct	CC>BB<>?BDCDF@DFDEEFCGEEFGEFFEDEGFDFGFFGE6DE<EEDDEEDBFG@EFEEFEE9EE8EEFEEE?GFEEFFEE@EEEDFDDG<EEDEEDEFFEA	T	52	C	51
16	1257731	G	205	GGAAAAAAAAAGGGGaGGAAAGAAGAGGAGAAGAAAGGGAAAGAaGggAGgAGgAGGGGAGAAAGggGGaAAgaAAGgAagAGGAAggAGGaaGGgagAAGGgaGAAGAGaAgaGAGagGggggggaaAaGAAagAGAGGgggAAGGAAAgAAaGaAGGAagAGagaagGAaaaaGgGAgaAAGaGAgaaAGGGgGGaGGGaGAG	>@HG>GA?FHHC>C?FCCBFF:HGCHA?H7GHCHEH?C@HHACHFBCDGCDHBDH=8ACHCHHHBDDCCGHHCGHHCDHF@GACHHDDGCCEGBBDGDGHBBDGCFGBGBGGDGBGBGDAD>DCDEHGFGBGBDDGBGBBDACBGBBGGG@CGGBDGBAGGDGB=CDDEBGFGGGBD@FBGFGBD5GBDCD>@>???B<==@CAC	G	103	A	102
16	1260710	A	61	aCaaaaaCaaaaaaaaaaaaCaaaaaaAaaaaAaACaCaaaaaACaaaaaAaCaaaaaaAa	C@DEDEE?7EEECEEBDEEE7DEEEEBHDEDBH8DD?DBDAFEHDBDFEFGACFFBEEEB>	A	54	C	7
16	1261282	T	247	TCCTcttTCTCCTcTCTCCCTCCTtcTCTTtcCCTTtTTTcTTTTCTTTTcCtCTtTTCTcttCttTCCtctCCTccCtttCCCCTTcCCCcTtCCctctcccTtTCCCtCCcctTcCtccTcCctctcccccTCtcTCccTCccttctttcCTttCctttCCcTTctCtccTCtctCtcCTTctTcTtTccttcTctcttTtttTCtTctctcttcTcttcccTtctctccctcccTtctccctct	BB@BAA?9?=A:6CABABF@DFFCEF=GCEDEGGECEEEEFEEEFGDEECFGEEEEEEGEFEE@EEDEFEFDGGFEFGBEEBGGGEEFCGGFEEGGFFGFFFFEEECGGFG:FFFDBGFGGDGDGFGEGGGGFEGFGEGFFEGGGFFBFFEEGEFFGGFCFGGGEEE:GFGGEAFGFGBGFDCGFEGDFDGGEFGDCEGFDDFFEDFFD?EG<FEEGDGFF<GF<FG:G@GGGF;GGCFGEDECCCA	C	124	T	123
16	1268494	C	126	TCCcCCTCTTTCTTTCcCTTTCCTTctcCTCCTTcTccccCCTCCcTcttTCtCCCCCCTctTctTtCCTcccctcTTTTTccTtcTtcCtCCCccTtttctTTTCCctCCTccttttttTTcTTt	?AEB=GCGGFGGGE9EBGEEEHHFGBGBEFGGGFCGCCCC>:FGDCFBHHGGHGGFGGFCCHECHEHFFG>CBCHBFFEFE9@DECFHCFHFFFCCFHHHAHDFFFDCBFEECCDHHHHGDFBEDE	C	63	T	63
16	1323781	T	52	ccttccCtCccttcCccTcCttTtccccctttcccctTTcctTtctctcttC	CC;D@ACFDAAFFADBBFBDGGGGBBBBBCEGBBBBHC@CCHGHCH@HCH@C	C	29	T	23
16	1364281	T	97	CcCTCCCTTTTttCctTtccCCcTcCCCtCCCTTtCTtccCtCttCtccTctCCCccTCCCTttTCTTCcCCCCTcCccttcctTtttccCcCccTt	?ADA=EF@EDDD?FCEEEDDGFDACEGFEGGG9EFDEFEDGEGFFGFECEEFAGGE?EGGGEFFDFDDFFFFFCDBFEEFFEEFDDFFECGD@BABC	C	57	T	40
16	1374818	A	212	GGgGAAGAGGGGgGAaAAaAAaggaaGGaAAAgggGggAGAgGAAagaGAaAaGAaagagGGAGAgggaGAGAgaaAAgAGgaaAAGAgaaAGAAGaaGAgAgAaGAgAGgggAGGaaaAgaaggGGAagaaggGAagaggagAGaagaaaggGagggaaaAAGgaAaagAgggAAgaAaGagGggaaggaggagaaggaAAggaaggAaga	DDC?>A@@EGG=FGFDFFDFFDFF:CGGDCFBFFFGFFFGFFGFEDFCGFDFDGF<DFDFHH9GEFFFDGFDEFCDFFFFEFDDEFGFDDCFGFEFEECEGFGFEFBGF<GGGFGGEDEFGDEFGGGFDGEEGDGFEGEGGEGEGEEGEDEGGFEGGGEEEFEFGEEEEGDGGGEBGFEDFFGFGGEEGGBGGEGEEGGEEEEGECGFF:FA	A	111	G	101
16	1389153	C	41	cAAacaacACcaacCACccccCaaccacaCaaCacaccAaa	AC@DDDED?FDEEDFFGDDDEGEF7EEEFGFEFFEFFDEFF	C	21	A	20
16	1395169	C	41	TTCCTTtTTCCtTTTCTTTtCcCTTTTCTttCCTttcCCTC	CEGFGGGHGGGGGGGFFFEHFCF;FFFFFHH=FFHG@AAAC	T	26	C	15
16	1400693	C	32	tCCTTtcTCCTTTCCTTTTCCCTcCcTTCCCC	EGGEEFDCFFCDDFFD@DDFFFCEFCAEFCC?	C	17	T	15
16	1451627	C	54	CTcTcCcCccTcCCCcctcTCcTTcTCcCCcTTtCctCCCttccTTttCCCcTT	ACCFCDDDDDEDDBDDEEDEDDGFEDDEDDBEFCCEFCCCFDDEFFEFCCC@C?	C	34	T	20
16	1487975	A	99	GGgaGgGagAgGAGAggAGagAAAAAagGAAAAAAgAAAAGGAAAGGAAagggAGGAGGAAaAGAGGaAaaAAGaGAAaAAaAAAAaAGAgaggaAGAa	@>FE>ECDEDDCGBHEEHCFFHHHHGFFBCHHHHGFHHHHBCGGCC6GGFFFFGBA6BBGGFGBGBBF?FFEG?FBGGFGG;@DEFBD>>A;?B>CC?A	A	61	G	38
16	1488141	C	90	ctTcttcccccccctccccctcctctctcccccTcCcccTctCCttttTTcctTTCCCCCCcccCCTtTtctcCcCtttCttCttctctT	C:?CDEDCCCACCCEDDDDDED@EDBACDDD@DGD7CDDGDEDDDE@FGCEEFGGDDDDDDDCDDCGAFF>FECECFF?CF=BEEDDCAC	C	54	T	36
16	1493909	C	80	cttCCTcTCttTCcTTCccCCctttTTctctTTTcCCcCTCTcttcctTccCCCccTTtTTTTTttCtCtTtTtCtTTTT	CCDDCCBDGGGEGBEEGBBEGBG:FE=BGBFEEECGGC9BGABHHCCHDCCGFFCADCHDDACDCHFGFGCGCGBC9@@@	T	46	C	34
16	1498270	A	69	AAAaGAAGaGAGaGGGGAaAAAGAgAGGaAgAAgAAAaGAAAgGgAGaaaGAAAaGAAAGAgGAagGAG	BCHF>HH?GBACGACCCHDHHHCHGGCBDHGGGEGGGFBGGGHB=GBGFGBBGFGBGGGAFC?C?A??C	A	42	G	27
16	1498775	C	75	ccctTtcCCTttTctctctcccctTcTctcCTccCCtcccctccTcccctcttttctccttTcTctttttcccCt	C?CGEGBEFFGFEBGAG@GBBBBGBBFBGBFFBBFGG=CACGCBBBBCAGCHGHHBHAC@HECE:HHFFHCBCDC	C	41	T	34
16	1498777	G	76	ggaAagGGAaaAAgagagaggggaAgAgagGAggGGaggggaggAaggggagaaaagaggagaAgAgaaaaaggGa	@BDCECCCEFEFFCFCFCCCCCCFBCFCFCFFCCEEF:DCCFBCFFCCC@GDGDGGBGCD<6GFDEDGGGFGECCF	G	40	A	36
16	1509123	G	89	AAGAAGGGGGgAGAAgaAaGgGGaGGGGGaagGGgGGGGAGGAAggggAAAAAgAaaaGAGGAGGGAgAAggaAGgGgagAGAAGaGAG	>:9EDB;BCBFHCFFFFHECGBCECCCCCGGGCBGC=CBHCCGGFGGGHFGGGGGEGGBGBBGBBBGDGGGGGG7G<DEGEAGCBE@C?	G	51	A	38
16	1524850	A	25	AGAAaaagAgGGGAAAGGGAAAAAG	@BHHEGGDHDBBBGGGBBBFGGGC<	A	15	G	10
16	1537455	T	30	TccCCccCtTtCtcccTcctttTcttcctt	DC?DDBBDGGGEECBCDCCHDGGCHHC@HH	C	16	T	14
16	1538464	C	111	cTCTCtcCcCtccCCtccttcttTcctCCtcTCCCcCCCTcctCCCCtccctccccCTcCTCcCcCcCTtccccCCCtcttctcccTtcttttctcccctttccttctttc	@DAFCDDD9DEDDDDEDDEEDEEGDDE>DDEGDDDDDDDGDDEDDDDCCEDFEEEE@GEDGDEDEDEDGFECEDDDCFDFEBDEEBFF@FCGEEFEEEEFFEEEFFEF5DC	C	71	T	40
16	1706435	C	187	CCCTccCTtTTtccTCTcTCTtCCtcCtcTCcCcTTTtCTtCCCCcCCTTTTCcCTCccTtcCccCTCCTTtcCTctcTTtttcccctCTttCTtCCCTCtCCCcCCTtttcCTtTccttcCTCtctttTtccCCTCCcCtTtCctcctCccTCTTcCttTcTttctCccCCTccCCCcTccTcccT	B??EEEDGDFGEDDCGCDGGGCGGEDGEDGGDGCGDDEEGEGEGED@DGGGCGDGGGCCGEDFDEDGGGGFFEGGEFEFGFFFEEEEFGGFFGGFDGGGGFGGGEGGGFFEEFFEGBEEFEFEGFEFFFFEEDFCCFFDFFFFFEFEEFFEDFF>FEFCEFEFFFEFFEEFFFEEEEEEGCDDB@?C	C	105	T	82
16	1826302	G	34	gGtTtggGgTgTgtttTgGtgtgtttgggggggg	?CF:GCCHCDCDCGGGECHHDHDHHHDDDDCECA	G	20	T	14
16	1836796	C	109	aCAacAcccaaCCaAaCaAaaaAAAAcaCAAcaCaAacCAaCcCAAaacACccaaAacCacaCccCcaacAaCccaaACCaAcccCAaCCaCAAcCACCAAacACAccA	BB?EBCDCDDEDGE?EHEDEEEEE?CEEGDEDEGFEFEGDFGECDEF=EEGEDDFEC?GEEFFEAGEFBEDFFEEEFDFFDDEEDFDFFFFFDCCEBFDEBB??AA==C	A	59	C	50
16	1889189	A	44	GGAGGGGAAGGAGAAAAGAgAGGAgAgGAGAGgGAGAAGAAgaa	GHEHHHHEEGHEGDDDDG=GDGGDGDFFCGCGEFEHCDFABB>B	G	23	A	21
16	1912139	T	77	ctCttttcccTTcccTttttcttCCcccTcTtcCcttccTtttctCcccTccTTtcttctccccttcttctcctttt	CCCBABCFGGEDGGGCDDDDGDDGGGGFEGCDGGHDDGHEEDDHEGGHHEHHEEEECEHEHHHHEEHEEHDHGD@@B	T	40	C	37
16	1962132	G	162	GAGgAAaGAGAaagAGgaAgagGggggGggGGGAaaaaaaaAaGAAGAAagGAgGgaAGGaGAgGGaAGGagAGGgggAAAaGaggggagGAaaAaGGaggaaaaaggGagAAagaaaaAggGaaaaaggaGaagaaaAgGgaggaggagaGgAAagaagga	BBB?>>A??ABCCC=CED=EDEEFEFEEFFEEEEEAEEEEEFEEBBEFFEEEFEDFEED9FE?AEEEFE9FEFE@FGFF@FFDFFGEGFDEFFF9DEEAEFFEFBEF?EFFFEFGFFFF?FGDFDEFFGFADFFEFGBEGDGFGF<GFFFFDFDEFFDEBC>	A	84	G	78
16	2134574	C	91	ccctTctCCcctCcTCcCcTtCCCcctCTTTCtCCCCCtcTcTCTTCCcTCTCcCTTTTCCtTCCcccccccTcTCTcCtCcTCcCCTcTc	C?AFGAGDCBBEDBGDB@BGGDDDCCFDGFG;HDCDCDH?GCECGEDBBFCFCCCFFFFCCHFCCCCCBCBCFCFCF7CHBCEC8=CD>C;	C	59	T	32
16	2257105	C	115	GcGGCcgcGCCCGgCGGCCGGCCGGcGGgGGgGGCggccCCCgGCggGGCCgGgcCccgGcCCGCgcGCCGCgCCGCCcCCgGGGgCgCCGCCcGCGGcGCgCGccCGCGCgcGG	=CAA5FFGCDAD<FD?@ECBCDDCCGCCFCCFCBDGGGHDDDGCDGGCCDDGCGFDGEG;GDDBDGGBDCBDECCCCCHCCGBBBFCECCB<CHBCBBHBCECB;CC?@>?B@AA	G	58	C	57
16	2260567	C	54	tcCTtTcCTtCttCcTctTCCcCtccTctttCCttcctTTccTccttTTCCTTC	C@?CEGCDGEDEEGDGDEGGGEGFEEDEEE9GGEFEDEEGEEFEEB;GEBA:=B	T	28	C	26
16	2260921	C	26	cCCtctCttctCcttccccccctTCT	A?<CDEDDEDEDDEEEEEEEEEEFBE	C	16	T	10
16	2748063	C	51	CTtTccTCctTtCTcCtTTcTtTtcctcTctctTctcctttttttttTttc	DBABBCDGDEEEGEDGEEEDEEBEEDEDEEDDEEDFEEFEF>:EFFEDEEA	T	33	C	18
16	2891540	C	47	CgcgCGCCGGCCGGGCCCCGcCGGGGGCGGCCCGgGCGCccGCCGgC	FFFBBEEGEEECEEEFGEBEGFEDDDDFDDEFEBGAFDFFGDDDCDB	C	24	G	23
16	2903845	G	32	TGGTGTTGGGGGGTTGGGGGTTtTGTgTGTtg	DHHEHE<HCHDH@EE@GGDGDDC@FCCDE<CA	G	18	T	14
16	2903850	G	37	GCCCGCGGGCCCCGCGGCCCCCGGgGCGcGCcGgcgc	?9FFEEEEEFGGF9FDEFFFDFDDFDEDDDFCDBCB<	C	20	G	17
16	2973088	G	47	GGTGgTTTGTGTTGttgGtGggTtgGtGGggtGGGTGgtTTGtGGGG	CGEHF<ECGEHEEEEECEFGGGEF8GDGFAGEGGFDGGCDDGFG?GC	G	28	T	19
16	2987002	C	67	tcTtTctCcttcCccCCTcttcTtTCTTtTtcCTcCTcCTctttcTctTcTtTtctttcTCtttttt	CC?CB?FDBGGBBBBDDGBGGBBGG>GGG>FBDGCDGCDGBGAHC<CHFCFHFHBFGH@ECGDCCCB	T	41	C	26
16	3075633	G	32	cCGGGGgGGGGCGGGGGCCCGGCCGCGGGGGC	@FHHHHCHHHHFGGFGGFFFGGFFGFFFE;CC	G	22	C	10
16	3085375	G	83	aGaaAAGgAGgGaAAGAgggAgaaaGGaggggAaaaAAGaggAgaAgGggAagggaAGaagggaAggAagAAgggaagGaagg	C<CBAA?CBAFD=EEEFFEAFFBEDEEDFFDFDDEBFFEEEEEE:FFEDFE=GGE>FEDBFGG:F>GFEGEEGGD>EADCCF@	G	42	A	41
16	3086447	C	92	GgCCCgGGCCccGgCCcGcgGcgcCCgCGGGgcGcCGgCCcGcGCCcCGcGCCcCCGGccGGCCgccGCCCgcCGCGccCGggcccCcCgCc	<:FFFFEEEGFBEFGFFEFFEFFFFFFGEDDGGEG9EGEFGEGE=BGGE9CFFFFFDDGEDDFFHGGDFEFGEEDEDGGFDGDBGGEACD=E	C	56	G	36
16	3119167	T	55	TCTCCTcCTCTCTTCCTCTTCTTTTTTTCCTCTTCTTTTtTtTcTtTTcTTTttt	CFEFGEDCEEEGEEGEDGAEGDDEDDADEDDFDDFDDDDFDFDDCFDDEC@@A>>	T	38	C	17
16	3119304	A	84	AaAAaaAAaagAAaggGAaGaaAaaGagaaAaaaAAagAgaagagGgAgaaAaAgaaAAaAaAaAaaagggaaaagaaAaaaAa	AC=;FEB<EEF:FEFEBEEEEEEEEEEEEEAEEEDFEEFFFFGFFEGFEFEFFFGFFFDFFFA7EBFFFGGFFFDGFDEFCFB?	A	65	G	19
16	3168836	T	98	GGTgttGTGGGGGTGGGGtGggtgTttTtGGtTGGggTtgttGGgGGgGGgGTGTTTtTTgTTGTggTTGgTGgggTTGTTGgGGggGGggTgGtGTT	CFECGGHCGBHCGDHHHHGHCCGCEFGDFGHCEHG9DEHCHHDHDHHDHHDH>HDDDHCCDDDGDDDDDGDDGDDDDCGDDGDGGDDGBDDCCGFCBC	G	59	T	39
16	3254418	C	97	CccGGCgGGCcCGCCgCGgCCcccGCGCGgcgGGCgGGCCCCcCGCCCCgGGGCcCcgGCGCCCcCGGcCGGCGcGCCGGGCcGgGGCGGGGcCGGg	<ADCCDE=BDDDCDDFDCDDDDEC5DCDCGEFBCCGACDDDDEDACDCBGBBBCECEF?ABCCCECBBECBBCBEBCCBBBCEBGCC>??@>@@ACD	C	50	G	47
16	3526412	G	43	tgggtttgtgGggGgggttgTggtgtgtgtgtggtgtgtggtg	CAA=CFDEEFEFFEED7EEEFFFEEEEFEEEFGDFGFFF>EEA	G	26	T	17
16	3535540	G	87	AaAGaAaGaGaAgAggGaaGgAgAaaGGGAgAGagAAaGaaaaaaaaagggaAagAGaagAgggGaAaaaAGGAGGGAGGAAAGGaG	?CD=EGECDCFGFH;FCFFCF8FG=:BCCHGHBG>HHGC6GGBDE><FGFG<HGGGBGGGCGGGBHGDGFCBBGBBAGA@>DC>8@C	A	50	G	37
16	3544040	G	33	GTggggtgtggggtgtgtgggggtgggtgggTg	=ABBCBGCGCCBCG@GCEC8DDDHDDDHDDDED	G	24	T	9
16	4949137	G	131	agAAGGGAgAgGAAGGGGaaGAAGgagGAGGagGaGgGgaagagGgaagaagagAGaaaaaAAAaaagAAagGAggagagGAGGGaAgggAaggggAagaAgaGgagaAGaaaaggGAGAgGAgGgaAgAa	C9A=C:CACEFFFFBGGGFFGFFGFFFGFGFFFGFGFGFFFFE=GFFFFFFFFFFFFEGFDFFFGFFFFEGFFFGGFGGDFFGFFGFGFGAGGGGGEGGGEGGFGGGGB=FDGGGGFEFEGFEGEFE??CD	G	66	A	65
16	5009433	G	150	aagagAaagGagaGaaGGgAagaGGGgagAaaGGgAgAAagaAgaggaaaaaGAgaaggaGgaaaaGaaaGaagaaggGAgaagAaaagaaggAagagGggggGagAgaGggAgggGAagAgggAggaagaGaaggGaAaaGAAAAagag	CAAC6??CBADCEDEDDE<FDFDEEEFEFEEEEEFFEBDEEEFFDFFEEEEDEDEEEFFEEFEE?EDEEEEDEEFEEEEFFEFD>FFDEBFFEFFFFFEGFFGEFF?GEDGFEGEFDEFGDGFFEGFFFFBDFFGFDFEFEDEEDBFEB<	A	79	G	71
16	5050897	G	31	cCGggGccgcgCggcccccccCccgcgccgc	?@DGEDFGFFDGFFGGGCGFHFHHEAGHHGG	C	20	G	11
16	5075542	G	39	GGGGAGAAGGgAGGAGAAAaGggAgGGagGAGgaggaGg	?CCBH?FH;CGHCCCBGHGGB8EGFBBGGBGBEGE;@AD	G	25	A	14
16	5080523	C	86	tCTtTCcCCCttttTCTtccCttTTttcttTTCTTTcTTCCctCTTtcttcttCCccCCctttCtctcTtCTtcttctTcCCCctt	A=GEFDBDDDGBGGGDGGBBC:GHHGD?BEGGDGGGBEGDDBHCGGHCGGBHHDDC>DCBHHHCHCHCFHBFGCHHCHFCCCCCHE	T	49	C	37
16	5105365	C	56	TCCctCctttCctCTTcCttcctCttCTcttTTtCttctTtcttctcCcccctTcc	C?A@DFBFGGF@GGGE>EGGBBGGGGGGBGFGBAFHHBHGHAGHCHCFCCCCHFB?	T	29	C	27
16	8844389	C	39	TtTtttctcCttcTtTctCtctttcTcctcCtcctctCc	@CDEDDDDDGEDCDEEEFG<DFFEEEDEEEDEEEFEDB>	T	22	C	17
16	8992342	G	186	GAAgGgaAAGGGAGGaGAGGAAaGGGgAGGAAAGGAAAGggAAAgGAAgGAaaAAGaAAgAAAgAGagGGAgGAgAAGAgGaAAaGAGGgaAgGgGGAAGGGgaAGgGAgGGggAGgAAaGAAAaGGAAaAGGAgGAGaAgggGGAggaaggAGAagagGaagaAAaggGAaGgggAgagGaaAag	>EFFCFDHHBCCHC=DCGGBGHD<@DFHCCHHHCCHFHCFFHHGFBHHFCHDEHGBEHHGGHHGH@EGC?HF8H:HHCHFBEAGEBHCBGDHGBG@BHGBBBGED>DBGGBBGGGBGGGEBGGGE@BFG:GBBGFBGBEGG<GBBGGECEGGGBGEGDFBEE=EFG<GEAGEAE@EECBA5<<ABD	G	96	A	90
16	10788129	G	41	TTGtTTGGGTTTTTggGTTTGGGGGGGGTGTGTGGGGGGTt	FFGFGFGGBGFGGGCDFFEBFFFFFCFFFFFFEDFGDCCAC	G	23	T	18
16	10855739	G	111	gGAgggAgagggaaaAagagggaagaAaggaggaaggaggGaagGAagaGaggGggagagaaggggaggaaaagaaaggagagggggagaagggaaaagggggagggaagg	A=AA@@?B9ACBDEEFFDECBBEFCFHFCCFCCEFC?F8@BFFCCGFCFCFCCCCCFCFCFFCCCCFCDGGFGCGG=CDGCGDDDD?GDGCDDDEGGGD@EDDGD@BGE@A	G	63	A	48
16	10996682	G	27	aGaagAgaAaAaaGaggggagggggag	DCCDFHFDHDFADCDEGGGEGCGGE:B	G	14	A	13
16	11001743	G	117	gaaGAGGGaGaaAAGGagAggaggagaagagAaaAaAAaAAgGagGGGGGgAAAggaGgaagGgAaaAaGaAAGaAggAaaGaaaaGgaGaggAAGAAGgagagaaGGGAaAAAagg	ACC@ABAAACFEHG?CFCFCCFCCFCFFCFCBFF;FGDFGHCAGCCBCBCCHHGCDECDBGDCDFFFGACGHHCFH=D=GGCGDGGCDGBGDDGGBGGB>GDGDGGA@AECCBCC:@	A	65	G	52
16	11555016	C	43	CCgCggCgcCGCgcGgggcgccCCcGggccgccgGccGccccg	?=B@EEDFGDCDFGCFGGHGHHDDHBGGHHGHHFBHDBFHCCB	C	24	G	19
16	11773662	C	38	GcCgcccGCccGccCCGCgGGgGCgCgcCcCcccccgc	D?:<@BBDGBBGBBEGGGD>GDGFDGD@GCE?BCCCD;	C	25	G	13
16	12008749	G	114	GGAGGGGAAGAGGGAGAAAGGAAGGAAGGGGAGgGGGGGAGGGaAAGGAGaGAGAAGggAGGAGGAGAGgGgAagAAGAgGAggGGGgAgAAGGAGGAgaAAGgGAgggaAAgg	DCDGGBGCFGEDG8FGF@EGBFFGGFFGGGGFGGGGGGFEFGGEEFFF>FEFEFEED>GEFEEFF@FEFGFGEEGEEEEGFEGGFFFGDGDDFEDEEDGEEEGCC:ABB=C?BD	G	70	A	44
16	12449925	C	77	GCgCGCCCGGGCCgcGcGgCGGCgGCGcgCcGGCCGGGGgGGgCGCGCCcGGcGCggGGCgcCCCcgCGGcCCCCCC	BAA@AGFGEEFGGFFEGDG?EEGEEFEGDFGEDEECDDDD8DGEDFDFFGDDFDEFGDDDEFGGFE6CBBA>@@BAA	G	39	C	38
16	15703361	T	28	CCCTCCTTTCCTCCTCCCTTTCTtTtCT	GGDGGGEEGFFFFFEFFFFFFFFFEBBA	C	14	T	14
16	16208941	G	82	AggaggGaggaagggagaggagAGAaGAggAGaAAgAAGGgGggaagagGagaaAAaGAGGaaGgGAgGgGGgaaaagaaga	AA?CCDEFFFFFFFDFFBFFFFEEFFEEFFFEFBEGFEE9GDGGGFEFGDGGF<EDGDDCDGGDGDEBDFDDGGGEFCBA??	G	44	A	38
16	19041595	G	74	GAGggAgGGAAaagGAGGaAgaGAGGGGgAAGGaAaaGGGAgGGAgGGAGGAaAaaAgAgagaggAgGgGGAGG	>FDCCFCEFFFCFCEFEEEFDFE<EEDDDFADEGEGGDEED>DDECDCEDDEFEGGEDEC?EGDDDDCBDB>>A	G	43	A	31
16	19056769	G	57	agaagggaaggaaagaaaGgaagggAagaaGggAaAgAGaGgaaagaaagaaaggag	A?AABB@DDDFCDCFCDCCCDDFFFHDED@CFFHDDFHCEC8EC9GDEEFDEDFGD6	A	32	G	25
16	19548116	G	229	aAAAAGGAGGGAgAAAAAGGaaGAgAAGGGAGaGGAgGAaAAGGgaGGggGGggAGgGGGGAAGgaaGGggAaaagGgaAGGgggGaAGGaGaaaAGgaaGGAggGgaaaAaaAgagGagaGAggAaGAAaagagaaAGAAgggaagaGAagggggGgggGGaagaaGGaaAaggaAAgGgaggaaaAGaggaAAGggagGaAaaaGaagaaaAAgggaaaagAagggg	?9?BADGDFFHEFEEEEECHE:HEEEEHHHEGEFHDFHEBFEHHEEIIDEGHFEDHEHHHHEEHDEBHHAFEFEE=HFEEHHEEEHEEHHEHE@EEG=FDGHEGECGFEEEFFEGF>HEFFHEFEEFGEEEEGBDFF;HEEFBFFFFBGDEAGEGGHGGGHGF:GFFGGFEDFGFFDDFGGFGFGGFDG5G9FDDGFFEDGFDDDFGFFFFEECCE:FEED9=<<@B@>	G	116	A	113
16	24105669	G	122	AaggagggAgGaaggAagaggGGGagaaGGGgaagagaGgggAAggaagaaAGGgggaggaaAgagggaaGagaAagaagagagGgagaGGggagaagGaaaggGGgaagggggaaagagga	EC@>ABBA5B;BDDDGFFDFEACCEFEDCCCFDEEEEECEEEHHFFDEEEEHCCEFFEECEDGDEFFGEDBE7EHEFDEEEEEEBGFGFBBGFFGFFGCEFFG>BBFEFF@@FEFFF@FGEA	G	69	A	53
16	24835214	C	26	ccCcttcttttttCccccctccctct	>>BBFGBGGGGGGDBCCCCGBC?HCH	C	15	T	11
16	27357927	C	123	TCTtTtttCCTTTCCTTttttTttccctcCCTctTTcCCCcTctCctTCtCCctTTtttCtCTccCcCCCcCCtTCcTCcctcTcTCcCCctccTTctttctccctttTttcctccttttctc	BFEHFGFGGFGGGGGEGGGGGGGFBBBG@EGGBE=GBGHHBGAGGB@FGGGECHGGGGHGHGGC>FCGG9CBGHGFCEGBCHCGCEF?FFCHCCFEBIIGAHCCCHHHFHH9CHCCFHGG?>@	T	62	C	61
16	27441283	A	48	AaAGGAaaGaGaGAaGGggagAGAAaGAGaAGGGggAGGAAGagAaaG	FFHCCIFBCFCFB@G@CDDGDGAHGGBH;GGB@BDDGBBEGB>DGCCA	A	25	G	23
16	28835900	G	100	gGAgGaaAAAAgAAGgGAGAAGGaGgAAAaaAAGAaGAagagAGAAaGaaGgAaGGgGAGagaaaaaaGgaaaaggagaagAaggaAaaaagAaaGgGgg	A<:>?BED?EFEBEEFEFEFFEDDDFFFFCCGFEDDEFEFDFFEFADEDEEEFEEEGE?EEG?D@DE>EGEEEDGGEFEFHEDGGEEBEEEGE>A=@B@D	A	59	G	41
16	28844068	T	26	AATaAaAATTTTTTttTaTaTAAtat	EE=ECFEEEEECEABFDGDGDDDECC	T	14	A	12
16	30376691	G	71	GGGAaAGAAGAAGGGGaAGAAagAAAAGGGAGAGAAGGGAAAGAAAAGGAgAGAAAAAAGGAGGAGGAAAG	@?CFEHCHHCHGBCBCFHBHG7GGGGGB=BG;G>GGBBBFGGAGGGGBBGFGAGGFFDF@;E;?C=CC?CC	A	40	G	31
16	30376959	T	139	CCCCtttTTtctccccctctctcctTCCttctttCttcctTCTcctTttcCTctcTctcttCCcTtCctTcccctccCTTtctCtctTccctccctTTTcCTcCtcCTttTttctccCCctcttttctccccctccttc	DEA?7@A@?@HDGGGFFCFCFBGGDFFFBDCDDDGDDEGDAFFGGDFDDGFFGDGFFDGDEGFGFEGHCEHGFGCGGBFEEHBFEHEFFHGEHHHEFFFHFFEFEHFDEDEEEHEHHFFGDH@EEEHEHHGHF=HF@;@	C	72	T	67
16	30536918	C	99	GCCgcCCGCCCcgcCgGgCcGcCgcGgcgCggcgcCCcgGgggCcCCCCgccGGCCcGcCggcGgGgcCGGGGCGGGCgGCcgccgGGCggcggGcGCg	@A=BC?CBBDCEFFDFCFDFAFDFFDFGEDFFFFFDAFECG8GDGDDCDGGGCCCDGBADDGGBGBGGC?BBBCBBBCGB>GGFGGBBCFGGBB>:=?D	G	50	C	49
16	30744826	C	70	cttTtCccTctTCCccctCttcctTTtcttCCTccTCTcTCCtcCTttCcCTTTcTTCCCCCTTCtCcCt	CBBBBCDCGCEFDD?DDA>DBCDEGGDEFFDDFEEGDBEDDDEECFFEDCCFFFBFF9CC@CEEBDA?@?	C	37	T	33
16	31138445	G	112	gGaaaGaGGAgGGggAAaggagGagaAgGaaggggaAgagaaAgaagaaaggaaaAAagggaaggggaAgaagGggAaAagaagaAaAaAGGggAggaAGAgGgggAGGgAG	?;AAA=C?AGFBCEFHHFCEFFBFFFHFCFFFFFFFH@CCCFHFFFFFDFFFFFFHHFFFFBGFGFGGGGEFGCFGFFGGFBGEGGGEHFBBGG:FGGFBGGABGEB<<@AC	G	57	A	55
16	31415004	C	32	tcCttcTcttccTcttcttCccctttcccttc	CA?ACGGGCAGGGGD:GC5BHHHEAEHHHCEC	C	16	T	16
16	46697098	A	30	AgggagaAgAagggagggagggggaggaaa	ABBCFCFDCFFCCCFBDDGDDDDD8DDHGE	G	18	A	12
16	46773999	C	37	aAcCAAAcACaCaaCACCaCCcAaCCAccaCcccCac	CFDHFFFDFG=GFFFFFDFGGEEFFFE@EFFAADGCA	C	21	A	16
16	49670390	A	310	AgGgagaAAaGGaaaGagaGGgggaggAagaaAAGGAggaggggaagaGGaGaaaGGgAGaGAaaGgaaggaagggaaAaagggggAGGGAagAggaagAgggAAAagaaAGAgaaAAgAGAggaaaaGAAAGaAAaaaAgaAAgAgagAgggGAAGaggaaaaAggAAGGAAgggAAAGGAgagaGGggagaAAaaGGGgGGgAagGGAgagaGGagaaAaAAggAgGaAGGgaAGAAagggagaaGAgaGaAgaagagAaaaggaaAAGaaggAAgaGaAaAgggGAGaAggGaggAGGaAAGagGgG	E?;BCAB@BB:?CDCADEDCAEEEDF9HEEEEHHCCHFFEEFFEDBEEC@E@EEEC:EIDECH9ECFE?F:EECFDEEGEEDFFEEHCACHEEHFFEEEHF9EHG=EEECFCHGFEFHGG>GGEDEEE7GGGCFHGFEFHFFHFF>G:GHGFFCHHCFGFFEF;HGFGHACHHGFFHHHBCGGFFFCAE6EFEGHFFCCCFBCEGFFABHGFFDBBFDEECCGGFGGFBFGBBG>DBGGFEGEEEEF>GF<AFGGBFFEEGFEFGDFFGGBFFGFGFGFBCG@CGFFBGBEFFFADGEGCCCED?A?:>C	A	162	G	148
16	50069312	C	69	GCCGGGGCGCGGcgGGCgcCcGCCCcggGcgCGCgGGCGgGGcGGCgggGccCggGGCCCcCgCgggcg	??DFFFGGGGGGFFHHFGFEGHGGGGFGHFGGHGGHGDGGGGHGGFGG@GGFFGGGGFFFFFDFGB?B@	G	40	C	29
16	50338723	C	98	TTCTTCTCCTCCTTTCCCTCCcTCTTTCTCtTTcTTCtCCTCTCTTcttCTCttCcTtTTCTCCCCCtTTcttTTTTCttcTttTcCtCCttTctttC	BC?FFDGDDGDDGGGDDDGAD@GDGGGDGDHFG@GGCHDD<CFCFF;FHDFCHCCCFHFFCFCCCACHFFCHCFFFFCHHCF>HEBCHCCGGD6BBCA	T	57	C	41
16	50346120	T	80	GgtgGtggtgttGgggGGTgggGGgtTttttttttttTTttttttTtTttTttttttttTtttttttttttttttttttt	@C@@=D=BDBEDBDDDCCGCCBACCFBGGGGGGGGCG?GGEG@GGGGGFG@GGGGHHHCGGGCFHECHH:HGCHEGFC@B	T	61	G	19
16	50346126	G	71	AaaaAAagGGggggggggggGGggggggGgGggGggggggggggGggggggggGggggggggggggggggg	DA9DACE>?>DCBCCCCCCC>CCCCCCCCDCCCCDCCCCCC@B?CDDDDDDDD=DD9DDBDDCDDDCCDDD	G	64	A	7
16	50744624	C	107	CCcTTTcTccCTCTcCtCTCtCCtCTCCTTCcccccccCctTTTTcTCctccTcTcccCctTCccccCcccttctcCttttcCcTcCCtTttttctcTcCTTTtttc	B;BABABF@DGGGGDGEGEGEGFEGGGGGGGDDDEDDDGEEDGGGEGAEFECGCGECEGEEFFDED:EDEEFFEFCFEFFFEFEFDFFFEFDFFDFEF6FEFEA<>B	C	61	T	46
16	52473263	A	57	aggagggaagggggAaaagagaaGAaAgGgaaaGaaAgaaGaGaaAAgGtggaAgAG	G<CFCCCFFCCCC:HFFDCBCCFBHFHCCCFGGCGGHCGGCFBGGGC=?5DDGF?C>	A	30	G	26
16	53191470	T	192	CtTCttCCTccctTccCCTcTTCttctcCtttttcCCTctTCctTtcTttCtttctcttTcCCCCtctccCccctcctcccTTtccCttctctttCTCcttctCTtttttCctctCCtTctctTtcttCtcccctcctccTcccCCcCCTccTcttctccCtcCctccCcttccTttCtcttccttccttcc	ACA?AB?>??DC<CEEBBGEGGDEDEDEDEDEEEEDDCFEHDFEGEFGEEDEEEFDFEEGFDDDDEEEFFEFFFEFFEFFFFDEFFDEEFEFEEEDGDFDEGDDFEFEDFDGFFFDDFGGFFFFFGFED;GFGGFGGBGGGFFGDDGCCEGGFGFFFFGGCFGCBFGGCFFFGGFFFCDFFFGGFDEA=>?B	C	102	T	90
16	58544640	C	58	cgccgcCgGgcCgcggggccccccGgcgcgccgggcccgGcggcggcgcgcCgggggg	C?=ABBDBBCBDCBCCCC>BBB:BCBCCBC?BDCDBBBCCCDCCDDADCDCDDD@DC=	G	31	C	27
16	66511627	A	59	GGggAaGgAgAgAAgGgGaaggagAagAAaGaagggGggaGGggaggggagaaaaaaaa	@<@C>DBEHFHFHHFCFCFFFFFEHFF@HECFFFGFCGGGCCGG=FGGGGGDHGEGGE?	G	32	A	27
16	66613841	G	63	cCgcggGcCCCcGgCCcCCGCCGGCCCcccGCgGcGCCCGCGCGccCGCGGCGCCGGGGCgGG	>@C?DCGBAGGBHCGF5GFGDEHCGGG=?8AADG;AFFFGFGFGBBFGFGGEFEFGGFCC@DD	C	36	G	27
16	67221444	G	90	cccCCggGcGcGCCcgGcCggCCCGGcgCCCgGggcGCccGccgCGggGGcGcGGCccggGGCCCGGGcggggGgGgGGcCGccGcCgcc	ACC?<ACBBCBCDDBCDBDC@DDDCCBCDD7DCDDCCDCC>C>D:CAACCCBCBBDACDDBBCCCBB5CDADDBD>DBBCBAAABB@>;;	G	47	C	43
16	67316600	G	160	GgAGGggaAgGgAAGaGgagGGGAGgaAaGGaaGAgAGAGGAGGAGgagGgaGaaGAAGGaGGaaaGGgaaGaagAAaAGGGaGaGGGaaAAGGgaGGggAagagGgAgaGggagGaaGgaaagGaagggaGagGAaagggaAGgggAAAaagaggggGG	DA=AEFFFDFGFFFFFGFFFGGGFEFFFEGGFFGFFFGGHHGGGFGFFFGFFGFFGFFGG@G;GGFFGF7EGFGFFFGEGGAGFGGFEGGFF@GGFFGFGFEGGGGGFGGFGE:GFGF?GCGGGF=DGGGGFHHFEE5GGGEEFGGCEEEGFEEFFDCBC	G	91	A	69
16	67688172	T	39	TCtCCcTctCtTTtCtCttccCcCcccCtcTcTCtcCcT	?<FDDAGBGDAGGGDG>GGCCCADCBACICFCFCHBB=C	C	23	T	16
16	69419476	T	38	tttttCttCttttCCtCCCtttCtCtTTTtTTTTTTtT	CBDDEDEE:EFD9@?F8@D>CA=F>CAFFCFCCDAB=A	T	29	C	9
16	69970000	T	27	gggggggggggggttgtgttgtgGtgt	?ABEF=FFDAFFGF=GF;FFGFGGF>>	G	19	T	8
16	70287177	A	361	GgGGGGGAGAGAGAAGaGGaGAAAaAaaaGAAAAGagaGGggGGAgagAAGAGgAAAGAagAAAAggGGGgagAAAAggAagaaagaaAGGAGaggagAAAggGGAaaaaGaGGaGAAAGAaagagaaaAGGGGAAaagAGAGAGAgaaGgGAAgaaagaggAgAagaaGAAAaagGgaaAAGAGAgAAAaGgAgggaGagaAagggGGAAAAAGAAaaGAGAaaaaaGaGgaaaAagGggGAGgAAGgAaAggGGggagGGagagAAaGAAAAggGGgAAGAgggAagAGAAGAagggagGaaaagGGGAagaaAaagggaAAAaaaaaggAAagGAggGaagAGaaaggggaaAaaGAA	>?@>?@@??BBBAEEDDDDCEF<FDEDDDEFBFFDDFDEDFFEEFFDFFFEBEFF?BDEDFFFFFFFEEEFDFFFF>FFFDFDDDFDDF8EFEDFFDFBFFFFEEEDDDDEDEEDDDEEDFDAFDFEDAFEEDEFFDD:FEFEFEFGECDF<FFGEEEGEG6FGFEGEEEFFFEEG?GEADFEADFEEBFEBFFGGGDEEG<EEEGGEEED?F:EFEBBEFDEEEEEEEEC?EDDEEGDGGDDCBEEDEECE@GDDAGEFDDEGEEB@ED9DDD:HBDB?EDDG=F6EGDDEECEEGGGEGDEEEEEDDDDEGEEDECGGEBEDAFCEEEGGEEEGCEEFEB?DCA@?<ABB@>>>>=CAC	A	200	G	161
16	70513384	C	34	cgCgCGcggggcCCCgCCGCcCgcGGCggGGGGg	?C@A>@GFFFFFGFECGFEEGEDGDDFGGDDDDG	G	19	C	15
16	70515600	T	56	GGGTTtTGGTGGTGGTTGGGGGTgtTTTTGGTGGGTGGGtTgggTGGTtTTtTGtT	B>>CEG?EEFCEA7EDEEEEEEC>HEEEDED?DDDEDDDGBDDDADDEHDDCFCDC	G	29	T	27
16	70818759	A	27	GGaAaggggAaaggggggagaagagaA	5;DFECCCCGFFCCCCCCEDGGDGDGD	G	15	A	12
16	71264399	G	72	GCGCGCGCGCGCCGGGGCGGCCCGCGCccCCCCcCCCGGcGGCggCGcGGCgcCGGGccGgCCCGCCcccgg	@>:@EFEGFFEGFEEEEGEEFFFEGEGCBGGFFCEEFDECDDF?DFDCDDFDCFDBDCCCDEEFCDC>>;AA	C	40	G	32
16	71660115	G	57	CCgCCGCGcgGcCGGcccCccCgcGCGCgCgcgGgcCGCcCcGCggcggcccGcCcc	@A5<EEFEBCDBBEEBBBGBBGCBEFEFCGDCDEDBGDGCFCEFDBC7>ACADCD;@	C	35	G	22
16	71701248	G	33	gaagAagggAgaAgAGagagggaGagagagaga	>CBDEEFEFFEEFFFGEFFGFG;GEFFGFFFAF	G	17	A	16
16	71773190	G	76	tGTgGgGGttTggTgggtttTttGgGggggGgttgggttggggggttGtGtgttgggttgTtTtttggTTtTggTg	A=A@;CCCFGECCDCCCGGGFGGDCECCD8EDHHCCD=HDDDD@DHEEGE=DHGDDDGHDEFEBHHDDDEDEDB;A	G	41	T	35
16	71783729	T	112	ATTTAATttAAAATATTATTATATTAATTTAatAAAATAAATaTTTATTtaTTaAattTtaATTattTTttaATaAATTaTAaattaAAATtaTAATaATtattTTTtttAA	:FGFFEGEDFFFFGFGGFGGFFEGGFFGFGEGFFEFFFF<BFEBGFEEGFGGGFEGFBFFFEFFGFFEFFFGEFGEEFFGFEGGFEGEEEFEEFEEFFDEEFEEEBB>???@	T	60	A	52
16	72003732	C	55	CTCTTCCCTCTTCCCCCCCCCCCTCTcCCTCCCCCcCcCTCCCCtCcCTCCCccC	GEGEEGGGEGEEGFGGE=EAAGFEFCGCFDFFEFFGFHDDFFFEEFBFDBB9<A?	C	43	T	12
16	77228971	C	86	TtttTccTCctctccTTttcctctcccCcttTccTtccctCCcCtTTcctcttttCttCtTTttctCtccCttcttcttTccTtct	BCA?>>>:@=A>D6@CDGHABHBGAABGAGGEBBE;<BBGAFBHGEDABEB8GHGGDHGHEDH@CGGH=CGHHCHHCFFDBCBA<A	T	47	C	39
16	77246517	C	37	AcaAaAaaCCcCaCaAcAaaCcCaCccCcccCcAccc	GCEHEHBEDDDDEDE7EFDFDEDFD9ECEDFCEGC9D	C	22	A	15
16	77401684	T	35	ggGggtTgtGGTGGtggggtggttgggtggGtgtt	AC@A9DAFECFEHHEFFFDFGGFEGGGFGGGFGC>	G	23	T	12
16	77775459	G	51	AAGGGGGGGAAAGGGAGGGAGAAGAGAGGGAGAagGAgAAGGAAGaGgaAA	>AGHHHHIHEEEHGGEHHGEGDDHDGDGGG?GDGFGDGBDGFDDFEHEFA?	G	28	A	23
16	78142308	G	30	GTGGGGGTGGGGTGTTTgGgTGGGTGGTTt	HBHHGHHEHHHHCGDDDG:EDGGGDF@ED?	G	19	T	11
16	80654633	G	76	GGAAAAGaGAAGggGAggAggaGGGAAgAGGAGGGAAAGAgGGgGAAgagaaAGGGGaAgGAaGAAaaaGagaaAg	@DDE<FGFHFFGCCGFDDFDDGGGGFFDFFG@FFEDDEFED>FDFEEEGDGGEFFFFG@DFEGFECGFHFACGCCA	G	39	A	37
16	81161737	C	31	tctccctcctctTctttCccTTtccccctct	C@GABBFBBGBGGBGGGDBCEFH6BCBCACG	C	17	T	14
16	81171205	G	64	CcCcGCGgcgcCcccgcccggggcgCcgggcccccccgcgccgCccggccggggcgGcgccggg	AC?A=>BCEFFDFEFFFFFFFFFFFDF7FFAFF:BFFFGFFBGDFGFD>GEGFDGEBGGGGGFG	C	36	G	28
16	81303759	T	58	TCCCCTTTTTTCCtCTCCCCcCTTTTcTTTCcTTCCcCCCTTCTcCTtCtCCCttTTc	>GGGGFEEEEBFBCFEEFGEG9EECDGDDDF5DDFFFFFFDDFDGEDAEDFAB@=??D	C	30	T	28
16	81892913	C	29	cccTtttCtctcttctttttctctCCctt	AB>?BDEDEFAF>EFEFFEFGEGEDC6FF	T	17	C	12
16	81916865	C	109	TCctCTTCTTCCTCcCTtCTtcCCcCCttttTctCtCcccCTcTTCTCCCctCCTTCTccCTtCCcTtTtCCTTCctCtTCcCCcCTCCCCTctTCctTtTcTTCCTct	BA@<@GFCG>@DGCBDGGDA=B8CBD8GFFGGC?DHDCCADG9GGDGDCD?HDDGGDGCCDGFCCBFGGAD@FFBCHCHFC?CCA<FCCCCFCHCCBGFDECCC@AC>@	C	60	T	49
16	81939150	G	38	cccGCcgcgggcccgcggcggccggcgggccggcgccc	ACDCDDEDEFFCDDEDGECFFEEGFEDFFEEGEEFE@:	C	20	G	18
16	81954789	C	83	CCCGCgGgGCgGGCCGCGCCCcGgCCCGCGCGcCGGGcgCGGgcCcgcGCcGGGGgcCccgCCccCCgCCgCgcCccGCCgGg	@AEHGFGFHGFHHHGHEHFGGEHFGEGHDHGHDGHHHFFGHHGDAGGGGFGGGFGG=FGE;FFFGF>GFEDFGEDCCEBB@C;	C	46	G	37
16	82672920	G	50	GAGAAAAAGGAgAGGGGAAAAGGaGAGGAAAAAAgaAGAAGGGAGAgGGG	=E?GDHH6CCHDD<CCCGH>HC>GCGABGGGGGBDGGBGGA?@;=B<CAC	A	26	G	24
16	83983755	G	28	AGGAAGAGAGAGAGGGGGGGGAGAAAGG	CGFFFFFFEFEFEFFFFFEFFDFCBBC?	G	17	A	11
16	83986888	G	168	GaGAGAAGAGGAGgGGGGGAGAgAGAGAGgGAggAGGgGAAGAaGGGGAGAgAGaagGAGgaGAAgggAggGGGAAAaAGaAGaagAGgAGgAaaggGaGaGAAgGGgAGggagaAAAAGgAgAaAGGAGAagggaGGgagagaGgaAAAGgaaGGaggaggGaAagg	>DBHAHHBGCCCCF@BCCAHCHDHCH=HCEC=DEHACE<;GCHFCCC<DCHFHCBDFCH<FECHGFGDH?FCCC@GGFECFGBEFFGBGGBFGDFGF<EBFBGGFBBFGAEGFFFGGGGBFG>GEF<BGBGFFFFEBBG;GFEFBBFBGGAE?CBADDEEDC8>B9>>	G	94	A	74
16	84046669	A	55	aGaggaaaGGGgggggaggaaaAgaAaagGaGgGgaggaaagGagAagggggagg	CAFFDDDEEDEFEEFFEFFEE=EEEFFFFEDEF@FFFGFFFGEFFEFFEGEGFBD	G	32	A	23
16	84093062	G	99	GAGggAagggaaagaGAGAaAGgGAaaaggaaaagggGaGAaggAAggaaGAaaagGaggaaaagagagagggaggGGggggagaaggggagagaggga	CCAACFFCCAFFFCFGFGFFFGCGFFFFCCFFFFCCCGFGFGDCFFCCEGGFFFFCGGDCGGGGDGDGDGDCDGDDGGD?DDGDGGDDDDGEHDG@?>@	G	53	A	46
16	84135453	A	37	tttTTaTaattaAatattatAaaatatttttaaataa	?@@CGDGDDDDDEDDDDDDBFCEEEEEDEDEEEEE=B	T	19	A	18
16	84204043	T	253	TTATatatTaATatATTTTtttaAtTAATTAtaaaTtaAAttttatATttAtttTTAAttTAATaATAatTatatTTTaAATaTAATTatAtataTtattAAtaTAAAaTAatATaTtTAaaAaTATaaaTatttttaaaTataaaatatttAttaAattaAtttatataaaaataaaattaaaatattaataattattaattaaaaattatttttttaataaaaataatattttataataatttattaaatt	DBCBC<C?AC@@CBCBB@?DDEDAECGFEDFG@GGEFFHHCGGGEFHGGFHFGGGGH<EFGGGBFHGHFGBFFFGGGGFHHGFGHHGGFGDGFGFGGFG9DBBFHIFIEGHCGCDFGGGHFGHDGHFFFFGFGHGGGFFBGEHGEGGBGGHCHAHFHGH8GHHEHGHGHGGGGGHFGGGHFGGGFGGHGGGHGGCHGHHGGHHGGGFGHHGHGHEHHHGGHGGGHGHEGHGHGHHGHGGHGGHHHGGFFB@C@	T	127	A	126
16	84209498	T	93	tCTCCCCTTCCCTCTTCCTTCCCCTCCCTTCCCTCCCCCTTCCTTTTCTCTTcctCCTCcTccCCTCTCctTCCCTCcCTCTCctcCCcTctc	AGEGFDFFEGFGFGFBDFFA>GFGFGGGEFFFFFGFFFFEDFFEEEEEEEECCAHEEEF@ECCFEEFEECGEEFEDECECCBC>B:A@<A@B@	C	58	T	35
16	84209634	C	155	CCCcgggCgcGcCcgGgGGCCGggcgGGgggCggcCGCcccgcgccGCCGcCgcGgGCccccgcGggcggcggcGgCcccGgCggcgggCGCGcGgcGcgCcgCggcgccCccggccgggcgcCgcccggcggCcCggcCggggcGgGccccccc	D??<BAABCBDCFEFHFFHGEHFFDDGHDF:GFEDFHGDD>EDEDCGGGHDG<DHFBFDDDDFDHFEDFFDFFDHEGDDDGEGFFDADFGHGHEGFEHEFGEGFFCDFEEGEEFGEEBFFEEEFGE9EGGECFFEFGGDFGGGFDFDGEEA@=@B	C	78	G	77
16	84211969	A	136	CCAaacCAaACcCaaCCAaaACcCCaCAAAAcACCaCccAAaacAAcaCcccCCAaCAcaAcccAaacAccaacAcAcacaaCccCCccCAacCacacccaaccaCccacccccCcAccacaaccacaaacACaaa	DB?9@DFECFGFGDDGGFDDFEGGGDGFFFFGFGGDGGGFFDEGFFFDGHGGGGFDFEGEF?HHCEEHFHGE9HFHFHAGEEGHHGEH;GFEHG<HCHGGEBHHEFHHEHDHHHFHEGHEGEEEHEGEEEF=@>B>	C	74	A	62
16	84225327	C	43	CgccggCcccggcgGGgcgccGGCgcgCgccGgGGccGgggGC	>DFDEDFGGG=FGFEEGHGEHBEGGHFDEHHDGDDHHDGFGCE	G	24	C	19
16	84255809	T	101	TCCTCCCTTCTTTCCTtCCCTTCCCCTCCCcTcCTCCCTccCTtTTCTCCCcTtCCcttctcCTcTctTCtcTTCTctTtcTcTcTtcCtCccCttCCTTT	8CEEGGGGGGGGGGGFGGGG:EGGGFGEGB9DCGFDFGGCCGBGGGGGGDGCEFFFCAHCHCFFCFCHFFHBEFFFCHCHCE?FCFGCFHCCCEFDC@B?C	C	55	T	46
16	84402275	G	57	gGgcgGCCGGgCgcCGCCcCgcgCgcGggGGCcCgGcgGcCggcgCCCcGccGGcCg	AACABEGGBECH<BGEFFCGDCDGDBDDDEEFBCDE5AD@F@E>BFEECDC=CEBB<	G	29	C	28
16	84476022	A	74	AAAGGAAGAGgAAAGAAAAaAAaGGAAAAAGGAGAAGAaAgAAGAAAAaaAGaaaGAGaGAGaAaGgGGGGAgG	CFGBCHICH>EHHHCHFHHFHHFCC>AHHHAC@BFFCHBCGGHCGGGGFFGBFFFBGBBBGBFGFBDBC@?@BC	A	47	G	27
16	84486700	G	25	AGGAAGGAAGAAAAGAGAGAGaaaa	FEDFFEEEFEBEFEDEDECEDEC>@	A	16	G	9
16	84808969	G	68	CCcGggcggcCgGCcgGccggccccgcgcggcgcggcccgccggccgccggcgcgcgggggcctggcg	DDA<@>BBAA?5BCECFCFFFFFFFFFFFFFFCFFFFFFFFGFFFGGGGGGGEGGGAGGGG?G6@@GF	G	34	C	33
16	84808984	T	51	cccctctccttctcttccctccttcctccttctctctttttcccttctccc	@DEFEGDGGDDG?EDDGGGDGGDDGGDGGEEHEBEHEDEEEHHHEDHEHGA	C	28	T	23
16	84900472	T	94	TCTTTCTTTCTCTTTCTTCCTTCTCTTCCCCTCCTCTCTttCCCcTttcTTTTTTCCCTTCCCTCCcTttCCcCTCTtttCTCCTctTcCttcc	EEFEFDFEFGFEFECGEEGGEEFEFFEE9FEFEEF6FGFEFDGEGDEFGEEEAEEFGFDE7DFEEFGEFFFFFFEDDFFEFEEDFFBCBA??@B	T	50	C	44
16	85948098	G	171	AaAGagGGaGaAAAggAAAaagaaAAGAgggaAGAAaagAGaAggagGaAGagGgaGgGgAaGAaaaGggGGgagaaAgAaggGaggaaAGGGaAgAagggaGAgaGAaagGaggagGaaaGGAaAaGGaagAGAGggAGAgAgGAGAgGAGAgaaGGGaaAaagAAGagg	<?<?CBBADDFE@EFCEFBFFFFFEEEFFFFEEDFCFFFEEFFFFFFEFEEAEECFEFEFBEEEFFEDFFE?GFGGGEGFGGGDEGGGGFEDBGEFFGGDEGEFGGEEGF=EGGGFGDGGGDD?GEGDDEHHCDEDGFEDEGEGCEDEGDEDEGGGDDCEGDGAFCB@BBA	A	89	G	82
16	87445363	G	100	AGgaaagaAgGaGggGGAaaAagAaGaaAggAaaAGgaAgaAgGggGaGgAaGGAAGggGGgAaGggagAGaAaGGagaggAaGAAAGGAAgGggGAGGa	C;BBFGCFHECFCFDCCFFFFFFBEDFFHFFEFEHCFFBDFHBCGF>FCGHGCCHHCGGACGHGCGGGGEAGGGBB@GFFGGBBGDG8BGGDAD@<BC@B	G	52	A	48
16	87798732	G	41	GCggCCgGGGGgGGCGCGCgcCgCCGGCCCCGcCGCCGGCc	EGEFFDF9EEEFEEFEFDFEEFFEEDDEEEEDEFDFD<?A=	G	21	C	20
16	87871582	G	88	gGaAAaGgGAgggaGgaAgGGaggaagGggaGagAagAAAagAGAGaaAGggagAggGgaaGagagAaaGGgagagGAGgaaAAAGaG	C;DCHDCFBHFEFEBFDHDCCEDFEEECEEECEEHEEHHHFGGCGCFFHCGGECHFEAGEFC@GDFH7FBCGCFECBGB?EEGFGBE?	G	46	A	42
16	88500367	G	92	GAGgAaAggGGGAggGAAgaAaaAAAgGAgaAGAgaGGGGGAaGaAAAGGGAgAaAgAggAGGaaGgaagAggGaggAgaGGAagaGGGaGA	?;CCDFEFDGFBEFFGEEED;DEFEFFFGFEFGFAEGFGGGFFGFFFFGGGEGFFEGCCGE<FFEGFFFFEGGFFGGEFEFEEDGFGFDCBC	G	48	A	44
16	88593218	C	26	CCGGGCGGCCCGGGggCCCCGGGGCG	DBCCBDBBCCCABBAFCCCCB@?@@C	G	15	C	11
16	88600792	C	47	TtCtTCtcCTcTTTtTCTCTTTTtTCcTTTcTCCCTCCtttCCTtCT	BDDGFDGBDGBG<FHGCF>FFFCHFCDFFF=FC@CFCCGF9DCDG@A	T	29	C	18
16	88690963	G	50	GAgGGAgggAGAaAggaGGAAaagGAgAGAAggagaAagaAgggaaGAAG	?>DDC=CCCEEEFF;CFEEFFFECECAFEFE@DGDGEGDGEDDD6EDEE?	A	25	G	25
16	88713473	G	54	GAAGGGGAGAGGAAGGgGGgAGgAGAGGgAAAAGAGGGAgGAAAAGGAGGAAGA	BFFFFGGGGFGFFDGFFGFGDECEFEFEGEEEEFE?<FBGFEEEECDCAAABC?	G	31	A	23
16	88773528	C	281	CCACCCCCCAACCCACACAAACACCCCCaaCCACCcCAccCACCAAaCCaACCACAcACACCcACAAAaCccACCcaCCAAAaaACccCCCCcCAaCACACAAAACCCcCcAACCaCaAACCcccacCCAcAccaAcAcCACCAAAcaCAAaCACACCACccCcacacCCAAcCAACacAcAACacCACaCcccCAcACacACCaaCCCaaAcccccCAAAcAcCcCAcAcaaCCAaCCCcCACCAAacaccCcaaCcACACAcCCaAccCaaaCCAAccc	A>FDCDDDCGHDDDHDHDFHG9GDDDDCEECDHDDDDGEDDHDDHHEDDDHDDHDHBHDHCD@HDGGHDDDCHDDEDDDGHHDEG9DE9D?D>CHFDHDHDHEHC7DDEDDHHDBBDFHHDD@DEFEDDHDHAEFH@GECHDCFGGDFDHFECGCGCCGCEEDAFEFEDCGGECGDCFCGECGCECCGCFCEEB@GEDCEEGCC?FCCCCFGEDEEECGGGEGECECGDG:FFCCGBCCCECFCCGFBEDEEBEFEBE@DGCEBBA@C99=A>9CC??BBB	C	165	A	116
16	88781558	G	102	aAGaagggGGaaGaAGGGAgAAGAAGAagAAAAAaAGgaaGaaggAAgggAAAgaagaAAaGGAAGgGAgAgAGggGaaagaagAGAaAagAaagaAGAgAA	C?>DFBCBACEFCFHCCAGC=HCFCCHFCCHHHFFHCCFFCA@DDGGDDDFHHCFGDGFHG9BGGCDBHDGDEBDDBGGGDFGDGAFGGECGBACEF=;<AC	A	60	G	42
16	88787673	G	99	aAGAAGaaAaGaaAAgGgagaggaaggaggaGgggggGgAAaagggAgGGGAGgGaAAAggggaaAaggggaAaaagaGAAAaggagagaaaggGggaA	B:@?B@GFDEDEFFFCEFFFEFFFFFFFFFFEFF?FDEFFFFDEFFFGECEF:GDFFFFDGFGFFFG8GGGGFGG=>GDAEEG<GCFDGGGGFGDGF=A	G	50	A	49
16	88793910	C	49	TCTCCTTTTTtcCTCCCTTcTCTTCTTCTCTTTTCCTTTCTTCCTTTCT	:FCGGAE;FECBFBFFGFCCFFFEEDAEEEDEEEFCEDEDDEEEBDCAC	T	30	C	19
16	88798341	T	50	tctccCctttTtTttCcCcCcctcTctTtTttTcTTTTTTtttttttttt	CC@>=?@HGGFGECGGBEBGBBGAEB?FFFD;EBFDFEEEEEGA?:ACA@	T	35	C	15
16	88800139	C	45	cCtCctctTCctTTttcctCCtcCTccctcttttttccttccttc	A9EC>EDEGD>DDGEEDCDCDEEDGAEEFDBFEFFFEEFFEEFBA	T	23	C	22
16	88909095	G	90	AAaaaGGGGAGAAGGaGAGGGAAaAAgGAGAgAAgAaGaggAGAAagAAgGGGgGAgaaaaaGaGagGgaAGGAgAaGGAAGaAAAgaaG	CCDDCCC?CHCFGC?DCH<CCHHDHHFCHBG@EGF?EBEGAGBAGEGDGGB@B6BGGEECDCBEBEGBGEFAB>GFABBGGBCEDDA==C	A	49	G	41
16	88921634	C	47	gcGCCCcGGCGCCGGgGcCGGgGCCCgcGCGccGgGcGGGGggCGCG	>DGGGGDGGGGGHGF7FDGGGGG9GDFEFFFF@FFFEFFFFEFEBAC	G	27	C	20
16	89263851	T	79	CTcCTTttCcCTttCTTtTCCctTTTTTtCCtTTCCTTtccTcttCTtCtTCCtttcTtctcttccCtTtccTtTtTTC	ADA?AGD=DCDG;E;GGEHDAADDGBGGFDAEGFDDFGEEDGDEFDGFCFFCCFFFEFFEEEFFEECFFFEEFEFEFE@	T	49	C	30
16	89265101	C	99	tTccCctCccTcTtTtcCcctcCttCCccccTCtCccCtTccCttccCtTtccCccctcCTttcTtCCttTtcCtCccCttttCctCcCCtCCTtTccC	B@CDFEFFDDDDEEDEDGDDDDGEEGDADDDFFEGDDFEF?D=FE@EFFFFECF?EEEEEFEEEFF=EFFE8EFFEEEFFFEFFEFEEEEE@CDAA?=C	C	59	T	40
16	89293271	A	146	cCcccCAAaCaCACCccaCAcACacaccCcCCCcCcaACCAAaAcaaAcCCcacAACAaCCCCCaaAccaCcACcAacACacACACCCAcccAACcAaAaACcCAaACAaacaAccCaAacCACACaacCaaCcAcCCAaCcCCca	@BDDCACC>EDFFFGGGDGF>FGDGDGGGGGGGGGGCFGGFFDFGEDFGGGGDGFFGEEGFGGFE@EHHDGHFGHEDHFGEHFGFGGGFHHHFFFHEEFEFDDFEEEFCEEH@DHHFEEEGFDFEFEEGFEEFHDGEFEACBACCB	C	82	A	64
16	89293614	A	85	gaAGGAAGGAaAAGgAGGAaaGagGgaGGggAggAGGaAaGggGGaaGgGAAAGgGGaAaGGAgaGaaAGgaAAggaggGGGaag	C<FGGFFGG:DFFGFFGGFDDGDFCEDG9GGFGG<GGEFD8FEGGEEFGFEEEFGFEEEAAFEFCFEEADBCEEBACGGEFED@E	G	47	A	38
16	89973607	C	62	TTTCCCCCTCTTCCCCTCCtTCCCcCTTCTCCtCCCccCTcTcTccTTtccCtcTCTCTCCc	GHGCDDDDHDGGD@DD@DDFGDDDGDGFDFCCCCCCGGC:GF;FGGFFFGGBFBFBFAD@AD	C	39	T	23
17	177359	G	77	tTTTGTGGGTgggGGGGGTTggtTgTtGGtGTGtttttggggtttTgttgggtttTTTttgGtgtgtGggTgTGggg	CCCDAEHG:9CCCHGGF@CA>CGEDEHEBHHDHHHHDHDDDDHHHEDHADCDGHHDDDHHDFFDHDHGDDDCDFCDA	G	39	T	38
17	902850	T	119	TCCcCTTtcTTCCtCTCCtCcTccCttttCcTTcTtCCcCtctTcCtCtcTcCcttCCTtcccCCCCCTcTttCCCTCCctCCctTCcCCccTTCTtCCtCcccttcttCCTcTccTTc	BDACFA=DEEEGGEGEGGEGFEFEGEEEEGF>EFEFGFGEEFEEGFF9FGDFGGFFGGEFFGGGFGEFDGCFFFFFDFFFFFEGGDFGFFGGADFCFFFFFGGGFFGFFFECFCBFC?@	C	70	T	49
17	1410259	C	66	CCCCGCgGCGgCcCcGGgCGCGGgccCCccCcgcGCGcGGgCcCgggGcgCgggGGcCcCCGGCCg	CB:DCDD;DA?DD>CCCFD;DCCGEEDBEEC69BCDCEACG7EC@BFBEGCGGEBBECECCABC@A	C	35	G	31
17	1437334	A	48	CAACCACCCAACcAAAccAaACCCAaaaaaACACACCCAaCcCCcaAa	A?FGGFGGG<EGAFEFEECEEFFFEBF9FFDFEFEFEFEDCCGFDBB@	A	25	C	23
17	1490230	A	28	aaCCaCCCCCaCaCaaaaCCCaaaaaAA	CED<FD>DD=F7EDFFFE>8=D;FEAD?	A	16	C	12
17	1565211	T	306	CTCCcCCCTccTtCTCTCcctcTTCTTCCttTctTTCTTCTCTTTtcTCCCTTTTCCCTCCCTCCCTTCCccCCCTtccctCCCcCCTcCtTCcttTtTTtTTCcttCTtcCCCCTCctttTCCTcCTttTCcctTcccCcTCCTCctCtccTCTTTTTctctTttCtTTTctTCcCTcctcCTCTttttCCCcttcCCCcttcTTccTCCCTCCCtcttcctttTCTCCCCtCcctTtcctttTTtttTccTcTTCcctctcccccCTCTCTCTtctctCTttcctctCTTtCTctTccTtttCt	;=?;ABB@;CB8BDCFF9FEEFGEGFGGGDEGFEAGGGFGFEGDEEF<GGEGGFEGGGGEBGGGGGGGEGFFEGGEEFEFE8E8FGGEFG@GFFDEFFGGEFGGEFDGDFGADFF<GGFEFDFGFG<GFEB<GFFDGGGGGGGEF8GFDDGGEGFDG8GBFGFGFEFFFGGGFFGFGCGBFGFEFFFF<FFFGGFFGFFFGFAFFFGAFFFFFFFFEEFFGGFFFFFFFFFFFFGGFFFEGDEEDDDFFFGGEGFFFGGFGFFFGGGEFEEDEFDFDEG?EFDEFEEEDBDCBBD>?79:B????C	C	156	T	150
17	1637302	A	218	aGggaAAGGAGGgagaaGaaGAaAGGgGaAgGAGAGGGAAAaAaaAgggAGaaaagaggaaaaGaGGGgGGGGagggAGGggaGaaaaAGAagaGAagaGagaAaAgaGaaAgGAGGAGGagaGgggagGGgggAAAgaaAaAGGAAggAaAGAGAGGAAGGGAAAAGAGgAAggAgAGagGGAggGAAgaaAagaagaAAaaagggaaagGAgAAaa	C@BBAADGGCFGDDFDDHDBG?DEHHFGDEFHEHDHHFEEDD6DCEFFFEHDDDDFCDFEEEDHD=HHGHHHHEGGGD@AGGEEEEEECHEEGEHEEGEHDGEEBDFEGEE?GHCG?DGGEDEBGGFA?FGGEG>D>GEE;DDGGDDEGBEDGCGDFGDDGGGD<BDGDGGDDEGBGDGEGGGDFGG?DGE<DDFD?GDDCCAADBB==?B;?BA?>B	A	114	G	104
17	1674429	T	73	TTtTCTctCtccCTttTtcTCTttTTCcTctcTCTtTtttCttttcttTtcCtcCTtccctCtTcCctTttcc	C?CFCFAFDFBBDGGGGGBGDBGFGGDBGBGBDBGFGGFHDHHHHCHHGHCDHCDGHCCCHCHFCCBHFHD;=	T	45	C	28
17	3352309	T	269	CcctTCcTccccCTCtccCCCCtttcctTTTcTTTcttCcCttTCTCtcccccTTcCCCTTCCtTTCccTctcCCTcttcCCCCttTctCCTctTTtTCTTctTTCctTTTCtTctctTTCCCCCctTTctCTCtCCTCcttccCTCcctctTctcccccCcctcTTcCttcCCCCtctccCttTCtTcttCtctttCCCtcccCcctcCtTcctctcTCctccttTTtCCtTtttTctccTtccttcTtTCtcttCCtTtcCtcCctc	?CC@;@=@?>@>?AFG;CE@FFFFGABFEEEBEEEBGG>BGGGEE>GGBBBBBDCBGGFCBGGGEEGBBCBGB?FFBGGBHHGGBFEBGGGBBGEEGEGEEBHEEGCHEEEGHECHCHEEG6GFGCHEECHGDFHEEEG5HGBCGEGCCGCHEBGBCCCCGCCHCECCEGHCFFGFHAHCCGCHDFHDAHHFHCHHHFFFHCCCFBCHCFHDDDG;HCDDCHCBHHDDHFFHCHHHDCHCCD@CCHHCDHDEG<GGFFG:E?CC=>=C@	C	143	T	126
17	3397702	C	91	CCCTCCCTCTTTtcTTcCTTTCTcTccTtttccccCttTtCcTCcTTTCtcCttTccttcTttctttttCcctCcCTccTctcTttCCttc	D?BBB>CFFFFEDDEFDFGGGGGDGDD7EEFD6DDGFEGEGAGGEGGF>?EGFFGDDFCEBFDEDDFFDFEEFFEFFDDFEFAAFEFEF@>	T	48	C	43
17	3430271	A	29	GgaGaggAaaAgGggagAAaggggaGaag	==A?ECCHFFHCDCDGDHHGDCDDHAGGD	G	16	A	13
17	3577273	A	31	agAaaaaGGAgagGgagaagagagaaAaagg	EBD@FEFFGFCFCGCECFFDFDG;GGEGFCB	A	18	G	13
17	3783872	T	31	TCtccCCtcccttTTtCccttccccttttct	?BFFEGGEFFFEDGGEHFFFEFFGGFFFFGD	C	16	T	15
17	3819002	T	128	TCttctCCccCCtttcTCCtCCtccCTtcCctttTccccCTcCtCtttcCctcctcctTccTccCCTCccTCcCtTCTCcttTtTcCcTTCTCTcTTtttctCTcCCCtccTtccTtTcTCccTTCCC	BDC?C@BBDEADDCCFFGGDGFDGGF>DGGGBDDFGFGGGGGADGDDEGFGDGFEHGDFHGFDHFF;7HHFFHFCBFFGGDEFCEHFGEFEDGEHFEBDEI5FEHFEEEHGEEGHEEEHEEHHEDA@@	C	72	T	56
17	3978531	G	146	GgtgtGttgGgTtGTGtGgTtttGGttGGtttgttgTTTTtTGGGGGTTggggGttggTgtggTGtggTgGGtgTgtgGtTgtgTGgGgggggGtgtgTggTggTTgGggttTttGtgGTTTgGgTtTGgttGGgtTtTTGttgGt	B?B=@=>D<@BCHCFEFEBFGGGEB<GEEGGGCGGCEFFFGFEFEEFGFCCC9EGGCCFCG?CEEHDCFCEEFCECHDEFEDHDFDDE=DDDDEH@GDED>FDDBDCEDDGHDIIAGDDEEEDDCEHEDDGHDDDHEHEECC@<?E	G	77	T	69
17	3981148	G	148	CGCcGCgCGGCCCCGCGGGGCGGGcGCGCcGCCGCGCCCGcCCCCcGCcgcgCCGCCCggGGCCGCGgcCgGggcCCcGggGGGCGcGGcCggcggCGcGGCGgcGccgGgcgggCGCggcgcGgcCgCcGCGcGGGCggGcccGcgC	?DFFHGFGHGGGFGHGHFHBGHHHFH:GFFHGGGEHGAAGFGGGGFGG;GGGEGHGGGG@HHGGGGHGGGGHGGGGEGGEGGGGFGGGGGCGGGGGDGGGGFGGGGGGGGGFGGGFGFGGG@GFGGFGFGFEGGFGFFEFFDBBC@:?	G	76	C	72
17	3985832	A	102	GAAAgagagaGGggaagGaaGgggggagGaGGaagaaAgaggAgagGgGgaagAaGGgAaAgGGagAAAgaAGAAaAgGagAgAagAgaaAaGAggaAaAaa	@>=BCEEFFFGEAFFFFFEFGFFFFFEFGFGGFFGFEEFFFFFFFFGGGGGGGFGGGGFGFGGGGFEEEGFECDDGEDFEGEGEFGEGGEEFDEEACBABBD	A	53	G	49
17	4416638	G	113	GAaGGggGAgGAaGGgGGAAGGGaGAaGGGGAAAGGGaGAGgGAAGGaAaGGAgAGAgAGAGGGggGAAGAGGGAgGGaAagGgAAGggAaggAaagaGGGGggaAgGggaGg	<A?=>DACHFCHEC@ECAHHCCCDC7FCCCCGGGCBCFCHBFCFHC@FHDCCHGHBHFDC:AB@GF@GGAGBBBHGBBGD5FBFGGBBFGBFFF=BGEBBBBEECED=A?;?>	G	70	A	43
17	4461748	G	62	gaaGgaaAaggggGgagGaGGAggggggAgAAgAagAAgAgGgAGAaaaGAGAGagaaagAg	?C?>DFFHECCCCCCFCCFCCHCCCDDDGCGHDHF@;GDGDBDH>GH=GB>BGBFDGG=CBA	G	33	A	29
17	4495740	G	41	AAgaGagAaGGagGagaAaaaagaaaAaGGgagaagAaagg	>>EDE9FDEEE>FEEGEF?F@FFEFFEFDDFFEEEBEFDB:	A	25	G	16
17	4500304	C	32	ctTTTctCTCttcttttttcCTTttttCTTTt	ADGGG=EGGEHGCHHHHHHDFEFHHHHEFDD:	T	24	C	8
17	4638737	A	92	AGAgAAGAgGgAGGaaaAGGGgggaAAaGAagggaAgggAAgGgAaGAAaggGagAAGAgAaGGGgagGGagAGaAAAAAAggagAgAGgAa	>@?C?B8DFGBFFGFFFFGGGFF@E@C;GFDFGFFFFFFBEGGEFEGFEGGGGFFEFFEGFFFDFGGGF>HHEFGEDEEEEGGFDEGBB@?D	A	46	G	46
17	4641755	C	59	TcCCtcTtTCTtcctcctCTTccTtcCTTTtttctctCCtCcCtcccTctcCcttctcc	DA;=CEGEEDCDDDEDDEDEDDDGEDDGFGEEDDFEEDDFDEAEEDDFEDEC=FDFFEE	C	31	T	28
17	4642069	A	120	GAGAGGGGAAAGGAGGAAGGGAGGGGAAaGgAGGAGAAAGAGGgGGAAGAGaGGGGGAaAaAGAgAgAGgAAAAGAAAAGAAgAGGagGAAAGaaGAAgggGGgAGAAAAagAgAagAaa	BBHEHHHEEEECHCHHEEFGHEDHHHE=EHGCHHEHE=5HEHHGHHEDGEHEGGBGHDEDEDFDGDGCGB<DBBBDD@DGDDGDGGEGGDDCGFEFBCGGGGF=DCCCB>?A5BA=?CB?	A	61	G	59
17	4684095	G	70	agAggaGGgGAaggAgaagGgaggGagaAaAgaaggagagggaAGgGAGAgaaAaaGaggggAgagaggg	?@BACFCCCCHFCCHCFFCCCFCCCFCFHFHCFGCCGDGDDDGF=CCDBHDGDGGGBGDDDDGBFDGDCC	G	39	A	31
17	4688996	A	48	acaCccccaACaCcAccacAccacaaAcCCccAacaccaaaAccaaca	ACA=CFFEFHDEDFDFFEFHFFF?GFHFDCG>HDGGFGGGGGGGHEFF	C	26	A	22
17	4699947	T	97	GGTTTTTTTGTtTTTGtggTgGgGGTTggGGTGttGTgGgTtTGTttGTttTgTGtGGGGTTtTTTTTttTTgTGGtttTGTtGGgTGTtTGtttTT	:HEEEFFEFHEE;EEGHDCEDHDHGDDDDHHEHGGHECHDDHDGDHHHCHHDDDGHGGGGDDADDDDDHHDDDDGGHHHCFCAGGC>EC=ADB;CCA	T	60	G	37
17	4722133	C	84	CtTTtCTCTcCCTcTtTccTTtcCttcctTCcCTtcttctcctcTCCTctctctTtTctttcTccCctccctctttcccccCct	BA@;CB<@ADDBDFEECFFFFEFFEEFFEEGFDFEFEEFEFFEFFGF;FEFEGD5DDFFFFGEFGFGDADGEGFFFBFEFGFGE	C	43	T	41
17	4796656	T	112	tTCtctTctttCTTcTCttTTCttTTTtCTTTCTtcTCCTtcTcCCTtCtcTtctTTTctCTccCcTCcTccttcTCCtCtCtCTcccCCttttCCccCCCtttcTttTTtc	AA:B?DB?HGG5EB:FGG5FEFGGFEFGAFGEGFGBBF?AGBFCGFEHGDCCFCHBEDCGGFCBGBEGCFBCGHCEEFGEHEHFECC>DFHHGHFECCEEEEHGCEGGBBC;	T	63	C	49
17	4800304	G	31	AgGGAAGAGAGgAAGAGGAGGAAGAGAAGGG	ABAEFFEFEB7DFDDEDDEDCEEDEDECA@>	G	17	A	14
17	4805437	C	135	cAAAaAAACAACCaCCCCAaACAcCAAACcCcaAaaACacaAccACACAaCACcACAcCaaCCACaCcaCCCacCacacCccACccAAcAAAcAacAccCaCACaCCACCaCACAAaCcaACaCCCCAAAaCcca	?=?EDFFFGFEDEEDG<GGBEGFDGEFFGDGEEFFFEDFEEFEDEDEGCEGFGEFGFEGFFGGFEAGEFFFFEEFEEFDFEDEAEEEEDEEEEE:AEBEFDFEFAFFEFFEFEFEEFFEEDFCEEEEFCB@@=?A	C	69	A	66
17	4881776	C	111	GGCGGCCGCCGCCGGGGCCGGCCGCGCCGGGGGGCCGcCGCCCGGCGGGCggGGCcCgggCGGgggCGGGgCCGcgGgCCGGCggGGggcCGgGCCGGcgcccCGCGcgcG	:;@CBDDBDDCDDCCCDB>@CCDBDC?DCCCBCC>DCEDC7DDCCCCCCDFF@BCECG9GCABGGF7BBBGC?BE@@FC;BBCFFB@FGEBAFBBCAA@5DB;A=@==>=6	G	65	C	46
17	6012979	C	89	TctCcCCCcCTcTTccttCcCCTCCCcTtCCTcttTtCcTCcTTccTCtctTTTTTTTTtCCCcctTtCCctCcCCCTccTTCTCccTc	DCA:BGGGDFECCGDDD@FDG@EEGGCG>FAEE<FGEGEGGBGGEEFFBEFGGEFFFFDEFFFBDFDEFDE@FDFFFFEEEFEDF?=BB	C	50	T	39
17	6331836	T	146	tGtTGtTGTGTTGgggTgtTtTgTGtttgggGGtgTGtTgTtGgTTTggtGGGgtgtggtgtTTTTttTtTGggttgtttgTgggTGTtttgggggTttttgtGtGtgGGTtttttTtgtTggggggggtgttgTttgTttttttg	C<A>@=?@<CCBEFFFFECGDGDAGDBDFFFFGDFGGDGDECFFHG?CFDCGFFDFDDFDFDGGFGDDGEGGFGEEGDEEFFGGGGGGEDEGGGGGGCDEEGEGEFEGFFFDEEEEEEGEFGGGGGFGGEEEEGFECDFEE6AB=?	T	82	G	64
17	6338530	G	29	TGtttGgGTtggTttgTgTtttGggttGt	?CFGGHCHEGC>AH8DBDEHFHHDDHHCH	T	17	G	12
17	6524298	T	28	TaaaATtttaTTttatttttttttaatt	BCADCEEEEFEEEDFEFFFFFFFFG@EA	T	20	A	8
17	6546259	T	45	CttCTCTTTCTTcctTcCtctTCcctctTcttttcCtTcCtCcTT	@ADFEGECCGE>FFEDFGEFEEGEGEGDD=EEFFGFEDGFFAGDC	T	25	C	20
17	6607150	G	26	AAAGGGAAAGGGGAAGGGGGAAGGAG	F7FDEDFDAEDDDEED?DDDECDCBA	G	15	A	11
17	7012073	G	81	TgTTTTGtTTGGTGGtGTGTGGGGTTgGTGTTgGGGGtTttgGttGTgGTTTgtTGgGGgGTTtgGGGtttGtTTTTTGtG	@CEEE9GGEEHHDGHGCDGDHGH=EEDDECEEDG;GGHEHHDHHH9DDBDDDCHDGDGDDGDCHCGGGHHHGFDCDDDEDC	T	42	G	39
17	7012077	C	87	cTTTCtTTCCTCCtCTCTCCCCTTcCTCTTcCCCCtTttcCttCTccCCTTTctTCcCCcCTTtcCCCtttCtTcTTTTCtCTtctC	9FG?CEGHDDEBDEDG:GDDDDGFECGDGGEDADDFEFFEDEF@FEECCEFFEFFCECC8CFFFECCCFFFCFFAFFFFCFCDA@@@	C	44	T	43
17	7012079	C	88	cTTTTCtTTCCTCCtCTCTCCCCTTcCTCTTcCCCCtTttcCttCTccCCTTTctTCcCCcCTTtcCCCtttCtTcTTTTCtCTtctC	AFGFFCGGHDD@DDGDGDGDCDDGDCDGDGGBD=DDDGHHCCCHAFC<CCEFFCHFCCCCCCFFHCC?CHHHCFFB?FFFCHCGFBFB	C	44	T	44
17	7150552	A	65	AAAGGaAGAAAAgaGAAAAAAaGgAGgaggGaaAaAgAgAaaaGaAAAAagaGAGAaAGaaaAga	B=?FHDDFDEAECFHEEEBEEFHCDHDGDDGGGEGDDECEF@GHGDCDDGAGGDGBGDGGFFA<B	A	45	G	20
17	7163739	A	166	AGAGggGAGAAgaaGGGgAAGaaggAGGAgaaggAaGaAGAAGGAgaGAAAaGAaaaGGAAGgaAgAAGggagAaAGGgAggaAagaGAAgggaGaAgAggAGAGgAggggAGAAgAagaGAAaaaaGaGaGGgagaaAgaGGAgggGGGaaAAGAGGAgaggAAG	B;=@BAC@B@@CCBDEDDCCGEEEEDHGDFEEEE?EHEEHEEHFEFDHEEEDHEEEEHCEEHGEEGEDHFFFFBEBHHGDGGFEBFFHE?FGGECEEFDGGEEDHFDGGGGDGDDFDAFFGDDEFFFGFFFGGGFGFFDFEFFD8FFGFFCECEGEFCA@=AB??C	A	84	G	82
17	7185308	C	44	CcCcccCcCcCCCCCCCCCCCCCCCCCCCCCggggggggggggC	>8EC@BFA6BFFEGFFGGGGFGGGEFFFDEEDC@DB?CDEB77B	C	32	G	12
17	7185313	C	44	CcccCcCcCCCCcCCCCCCCCCCCCCCCCCCgggggggggggCg	>C@<?AE?GGEF@GEGAGGEGGGF>FFFEEEDAD@CC?CDDAE5	C	32	G	12
17	7220881	C	94	cccttctttTctTCcCTcTTtttttTccccTtcCccTTtTcccttcTtTtCtcTCcctTccCtctTttTCTCccttTctTtccttttTcCcCTc	AA?CD>EDEBBGCFAGFBEFGGGGGFBBBBFGBFBBG@GF>BBGG=FHECGGBEF?CHECCAH=G@HH?FEFCCFH=>HDH>CHHCHBCF=FC9	T	52	C	42
17	7245674	G	149	GGAAAAgAGggGAAAGAgAAgGaGaAAAGGAAAaAGAGGAAAGgGGAGgGGAaGAAGgaGAaAGGaAAGaAGGAAAAaAGGAGAGAAAAggaGAAGAAgAAAGGaggGaggAGgaagAAaagaGaGAGagaggGAGaagAAGggAAAGG	BCHHHHCHD@B@GHHCHDCHCBFBGHHHCBGHHGG=HCC@HHBDCCHACCCHGCGHCAGAHGHBBGABBGGBBGGGG=ABBGBGBGGGGCDCBGGBGGCGGGBBG@DBGCBCBDFGDGGGGDFAGBGA;?FDD?F@DC:CC@<=<???C	A	81	G	68
17	7246940	T	97	tTttTGTTTTTgtTTGGTgTTGtGtGgTgTGTttgtTgTtgTTTTgGtttGTTGgtGGgGgggtTtTtGtgttTTtgTttTTtGTGTTGGgGggttt	B?CF>9CEEDECGEEHHECC@GDGGFDECEGEHHDHDCEHDEED;DHGCE@ECHDH@GDGDDDCEHDHGIDBHDD@DDAHDDHGDGDDGFDGBAA@C	T	60	G	37
17	7288085	C	35	CctTTTcTccCtccCCTCcTTCTTcCCtTcctcCC	<AGGGCAGBBDHCADDFCCGGDGGACCHFCCH=CA	C	21	T	14
17	7350544	G	78	AgggGgGAGGAGAaAAGgGaAAGaAagaagaGagGgggagggAgaggaaggaagGaggaAgagagagaaGggggggga	EAAA?DCGCBCCHEHHCCBDHHB?FFCFFCFADCCCCCGCCDHDGDDGGCDGGDCGDDGHDGDFDGDGGBDDDDDE?E	G	45	A	33
17	7460685	G	33	GgaGGAaaaAGgGaggGGgaaaagagggaggaa	@ACABHDDDACFCEEFC=DEEEEGFGFGFGG<C	G	18	A	15
17	7490379	G	37	gcCCCCCGGCCCGGGCCCCGCCGGGGCGGgGGGgggg	BBFGDGFHGFEFGDG9F@FGFFFFFDFFE>?;BAD@>	G	21	C	16
17	7579472	G	52	CCgGgCCcGGGCCgcCGGgcCCgGCgCCCCcCGcGGGcGcgCcGccCGGcGG	@@BECFFBEEE9DCBFECDCFGDEBDFFEFCFDCDDDCD=DDCD@A@BB8A?	C	28	G	24
17	7579801	G	70	GGccccgcgCcggGGCCGGCcCgGGCcccGCCgcgGGCGGCgGggCcCgcGGGgGGGCCCGCGGGGGGCC	EDCC<:B?ACCCBHHGG<FG@GCHHGB<CHFGDCD:GGGGFDGCDFCDDCGGGDGGGFFFFFGGFDCC?C	G	39	C	31
17	7606722	C	112	CgCcccGCggCCcccGgCCCgCCcCgcccGgGGGGGCCGcccgGGgcCcggGcgcCgcgccGGcgcGcgGcgcCgGcccccCccGggCggGCgggCgggCcCcGCgCgCgcc	>?A@@CDFBCGGBBBECGFFCFFBGCBBBECEFEEEGFDBCBDEEDCFCDDD=D@GDCDC5EACDCA?DD<DCE@DC?CC=E;<DDEFCDDED:DFDDDFCECDFDECE;;@	C	61	G	51
17	7720858	A	110	taTTtATTTAAttTAaTaaaaTtatTATaaATATtTTAaAAATAAAAAaAATaAAATTTTTaTTAAAtTATTaTaTTTTTaaAtTTAAAaataAAATaAAATaTaAAAtt	?CF@EHFGGHHDEGHFFFEFFGEG@GHFGGHFHGEGGHBHHHGHHHHHGGHFGDFHGFCCFGFFGHGFFGFFGFGFFFFDDFFFFFGGFGGFGFGFEFDDDEB?ABBC?C	A	61	T	49
17	7750532	G	100	gggggCgGggggCgCgggCggggggggggggggggggggggggggggggggCgCgggggggggGggggCgggGgggggggggggGGGGGGgggGgGGggg	@>BBC=C=FDEE?E?DEB8EFEEFEFFFFECEFCDEEFEEDFFGFFFGGEF>A?FFDFFFEGF7F>GFAGGE9>6GF?GGEGGF;<@A@?B??9>C?D@D	G	93	C	7
17	7792465	G	31	gGCggggcccgGgGcGcGgcggcggGggggc	ACEDCCCABBCHCGBGCFDCDDCDDEDDDC@	G	22	C	9
17	8015579	G	29	gGggggggcgcCccccggcggccccgccg	>BBCEDEDDFDGDCDDEEDEF@DEEGEEG	G	15	C	14
17	8157310	C	205	tcttTtccCTCCTTCCtcTcTTcCTTTTcTCCtTtcctTCcTTccTCCCCCCCcTTTcTtTCcTctTCCTtcTcCtCCcccctCccCCtttctcTTtttccCCtTTccctccCtCCCTTCCTTTtTTccCttTccttTCTTCCTtTTCTtcTCCTCTTCTtcTCCCccCTtTCCCcCtCttTTTtCtCCtCtTtttTtcTCCcTc	ABBAACEEBF?DFCDDEDGDGGDD>GGGDGDDEGEDDEGDDGGDDGDDDDDC@DGGGDGEDDDGEEGDDGFEDEDFADECEEFDADDDFEFDFEGGCFEEEDDCGFEEEFEEDFCCCGFCCFFFFFFEEC@FFEEFDFCCCCCAFEFCEFEECDFCFFCFFDFCCCCECFFEC8CEC9CDEFFFFCFCCEBFDC?@C>?A=@@?B	T	103	C	102
17	8192377	G	81	TTGggggGGGgggGgggGGggTGGTgTggtTTgtgtgggttgTtgtgtTtgttgggtgtttggtttgggggtggttgtgtg	D=<BCCGABCDEECFFFCCFFGCCGFGDFDFGFDFCFFFDDFGDED=EGEGEEGGGDGEECGEEEEGG>GGEGGD;GCFAB	G	49	T	32
17	8243469	T	103	cccTCCTtccccCCtcCctcctTtTCTCctTTtccTTTTtTCCCcTTCCCCTctCtCtccCTtctTTTctCcTTCCtCcCCCtTcTtTtTTCCtTttCcccct	ACC?GFBG?BABGGGBFBGBBGFGGGGDBGGGHBBEGGGHGGGFC<FGGGG;CHGGGHBC<G@CHEFFCHCBEFFEHF=FFFGFCFHFGFEGCDAAB><<>;@	C	54	T	49
17	8296440	G	38	agGGAgAggggGagaaggAAgaaaGGgGGGAAaAGAAg	AA?DFCBCCCCEFCFFCC<FCEEGDEDEDDDEGEDEE>	G	21	A	17
17	8701799	G	116	gtGGTGTGTTTtTGTtTGGTGGTtTTtggtTtTttGGGGGGTGgttTTtGgGTGTttggtGGggtTGggtTGGTGGGgTTgtgTggTGTTGGTgTttGTTggTTTTGGtgTTGTtT	C<9@BEFEFCEDFEFDFE;FBEEDEE@AFDFDFDCEEEDEDEEGEEEFEEGEEEFEEGGEDEGGEEDGGEEDDECDDG<EHFGEGGEDEEDDEGEECDEEGGDEDEEA@BAA>C>C	T	62	G	54
17	9086338	G	36	gtTtgtTTgtggTgtttttttTTtgtgggttgtttt	CC8B?D:<CGCBECGGGEGGGECFB?DD8HHDD@HC	T	25	G	11
17	9124473	A	31	aCCCACaaCaAaCCaCAAACCCaAaAAAAAA	ED6B=DDDDDGED7@B@:G?C@D=EGGE@??	A	20	C	11
17	9471711	T	40	TTTGTTGTTggTTGTttTGGttTTTgGttttgtgTggtgt	AAGCHGAGDGGGFBGFFFBBFEFFFGBFFFFDF=FGGC??	T	26	G	14
17	9680679	C	41	tccTCctCccCCtCttccttttttcctcTttcctcctttct	AC?@CBGDBBDDGDGGBBGGGFEGCCHCGHFC8HCCHHH@E	T	21	C	20
17	9783855	A	41	aaagggaaaagGgGAgggaggaaaagaggagaagggggaag	>@ACEDDDDDFGFGFFFFDGGEDD>?EGA=GEEGGGGGEEE	G	22	A	19
17	10216442	C	71	CACcacCAcCACCCcccAACACaAcCCCccCCACCcAAcaCAcccCccCaacacaaaAcaccCCAAaAACc	;@@DDCFEDFDFFGDDDEFC<GDFDFFFDEFGFDGDFDEFFE@EEFEEEAFE=DEFEDDFDDCCBB@CACB	C	44	A	27
17	10231498	A	25	Cacaaacaaaaaaacacaccacccc	BDGCCDGDDDBDDDGCGDCAEFHE>	A	14	C	11
17	10236465	G	85	aAGAaGggaaGAagGGAAAaAGgagAaGaAAgggaAAaggagaAgAAAggaAGgAAAaAaaAaaaaAggAgAaaGgGagGaaGaa	C<=EDBFFFFCHFFCCFGFF9CFGFHECEHGGFGGHHGGGGGGHGHHHGFFHCDGGGDGGGGF?CGHGGFGGGGBEBGGBEGBGB	A	53	G	32
17	10355371	C	70	CCCCcctCCCctcttccccCcTtcCtctcTcccCctccCcctttCccCtCcTttCCtTCtcCTcccTCcc	DADGCDEEGGDEDEE?DDDGDEEDGED=AEDEEFEFEEFEED9FDEDGEFEDFFFFFDFFEFDEEECFA@	C	48	T	22
17	10442977	T	43	tTCcTCtctCctcCCCcTttccttcttcttttcccctttttct	@?CFDFDFDFGDG<GGGEDDGGDDGDEGDCEEHGFHEEEDEHB	T	23	C	20
17	11757556	C	176	GcGGGgGGGCGCGCgGGCccCcCCgCGgCGGccCcGCgGGcCgggggCGCCGcCGccGGggCcGGCcgccCCCCccgcCccgCcgCCcCCgcCgggcggCgCCCcCCccgcGGCcgcCCggGcgGccGgGgcGGcCcGgcgCcCccGgCccccgccggggccCcggcccgcccGCc	@C;5><?@?AACBBDB?>AAD@DECDCCDCCBBDBBDCCCB8B;CCCACDC?BDCC;CCCCDACADCABCDDDDCCDBDCCDCCDDDCCCDBDDDDCCDCCDD=BDDC@CBBBCBDCDCDDBCDBCBBDBDCB9CCDBECDCCCCCBDCCC6BDCCDDDDB=C@CCB@@?>7==A>	C	100	G	76
17	11778240	G	25	GAGGGGGGAGGAAAGAGAAAGAGgG	CHCCBCC7HCCGGGBGBGGFBGBF>	G	15	A	10
17	11827353	T	33	ttttctcccctCcCctctttcTTccttccCtcc	CCABACEEDDEGDGDEDDEEEGGEEFFDEF?E@	C	18	T	15
17	11865110	G	27	AAAAGAGGGAAAAAGAGGAAAAGAGAG	E9FFEFEED;EFEEDEDDEEEEADEEB	A	17	G	10
17	12852392	G	92	AAaGaGGggaAGgGGGGGAAGGGGGGaGAGAgGggaAGGAgAAgAAAgAgAaGgAGGagAaaagggggAGaAGgGagGaGgGGGGagGGgAA	B<D?C@ACCFFDCEEFEEFEEEEEEEFE@EBDADDGFEEFDFFDFFFDFAFGDDEDDGDEGGFDDDECEDGEDBDDDDGDDDDCCE@A><CC	G	56	A	36
17	16842991	G	46	gAgAAGgaAagggGgaggaaggGgGaagagggGaaaagGgAGGAgA	AAAA?@BEFFCCCECFCCFFCCA=EGG?GDDCDGAGGDDDEDCD?A	G	27	A	19
17	16855878	C	139	TttCCTCCccTCTTCCTTTcCTCTTcCttTCcccTTtTtCTtTcCTCtcTtCTccTTtCtctCtttcttcttCCCCCccCTtccTctTtCCtctCTccttTTtccTtcTTTTCCTtcctCTtCCcTccctcTctttcct	=@C>@CC>A?GDFGDDDGG?CGDEGBCGFHDBC=GGAEGDGFGCD5DHBGGDGBCGGFAHCHDHHDCFHCBHDD7DDCCDGGBBFCAFG@CCCHCFC?HHFFCBCFFCFFFFCCFHC@HCFHCCCFACBHCFCHGG?>@	T	73	C	66
17	17062241	C	47	gGGGCGcGGCgCCCcCGgCcCCCCGGgGGCgcGGgCcCCgGgCcGGc	ECACBCDCCBCDDDED;GDEDDDDBCGBBC5EBBGCECCFCBB?=9>	G	24	C	23
17	17124625	C	122	TCCCTCTCTTTTCTCTTCCCTCCTCTCTCCTTCCCTCCCCCTTCTTtCTTTCCCCCTCTCtCtTTTCTcCTTcTTTTTTTCtTCTtCTtTccCCtttTCTtcTCCcCcTTTcTCCcCCCCtc	C;@DBFFGCFGG5BEFFGEGFEGEF;FFFG59GFGEFEFGEADDEEEFED?AEF6EDFBFECC;D=D?GEEEGDDE65D?EFEFBFD@FCGGEEFAFDDEDEDFFFDCBC@A=A?@>A??CD	C	61	T	61
17	17179481	G	117	GGggaaAAGgGAGGAGGGAAgGGAgggGGGggGGGgAgGgaGgGaGAaagGggAGGgaGGAgGgGgAaggggaaggGagggAggGggaGgaAAgaagGaaagaagggggAaggagGG	A@??DB@BGBHEFGEHHHDECHHECCCHHFCBHHHCEBHBEGCHGHEGGDHDDCHHDGHHCDHDHDEFCADDFG@DGGADCDDDFDCG:DGDDDGGDGFFFDDHCCCE:CFCBF9AA	G	79	A	38
17	17326604	C	82	ccTCTttccTttCTCTctTTcTTcTcCCCCCCCcCctTTtCCttCCCCCcCCtcTCtTttttcttcTttCCtTTCCcTTCtC	FFDFDGGG>=GGFF<EGFEFGFFHFHFFGGGGFHEHHEEHFFGGGEFFGHFEHDDFHEHHHHGHHGDHGEEHDCDFGDADEA	C	42	T	40
17	17326605	A	86	aaGAGggaggAGAGagGGaGAGaGaAgAAAAAAAaAagGGgAAggAAAAAaAAgaGAgGggggaggaggAAgGGAAaGGAgAGgaa	CCFHHFFDFFHH?HDFHHDH9HDHEGDGHEHBHHDHEFGGGHHGGGGGGGAGFGE:GFGGGGGEEGDGFGGFGGGGDFGGFC?DBB	A	45	G	41
17	17425769	T	52	TtttttTTTTTTTTTTTTTTttTTTTTTtTTTTTtttTttTtgggggggggg	<B8BCC?BD9?EAFFFFFFE;AFFEAFFHFFFFF=B=EE=EH@9D:C?=@;>	T	42	G	10
17	18042976	C	54	AcCaCaAacAAccaaaaaccccacccccaacccaaccccacacaaccAcacaac	C?9BBEH?DHHDDEEEEEDDDDEDDDDDEEECEBFEEDDFDDEEEEEGFFEDED	C	29	A	25
17	18043817	C	104	tCCtcCcTCccCTTCTCcTCCcTtttCTcTCTTtTCTcCtcCctcctTTccCTTctTTtTCccccTcccccTTCTtTTCcTTCTttCtctccTTtccTttccCt	?8>E?BBGCBBDAGDEDBGDDBGGGGDGBFDGGGGDDCDGBDBHBCHFGCCDGGCHGGHGDCCC;GCCC9CGGCFHFFCCCFCFEHCHCHBBFFH=CFH@C<@C	C	53	T	51
17	18046058	A	95	CCCCACCAAACCAACAAAAACCCACCCCAAACACcAACACAAACccacAAACCaAcAaCAaCAaCcCccaccaAcccAcaaccCAAacAAaCAcc	<:DFCAE>BEGDFDGEEEDCEGGEGGGGEEEF>F9DEEEAEEEGDEDDAD@CDCDEDCFDFFDEFEFECAEEEDEEDDEE?EEFDCEADACFB@=	C	48	A	47
17	18149854	A	137	gGGGagGagaGgaGAAaagGAGgGaGgggGgaagaaaAAGgggAaggggaaAGgggagagaaGgaagaGgagggggAaaAAGAAGAagGAAaGagGGAGGAAAAGggaaAGAAAGaAAGAggGaAGAggAAAggGaG	?==:CA9CAD?BFCFEFFCDCECEEECCCCCFFCFFFGGD@CCEECCCCFFFEDC7FCGDECEDFGDGEDGDDDDDFGGFFEFFEDGDEDCGDFD:DEDDDEEEDDDGEEDEEEDGEEDECDD@EDEC@?77?<A@C	G	72	A	65
17	18167684	G	152	GGGgAGggggGgAagGgGAaggGGgaGgAAgGAGGgAgaaGgAgaGAaAaGgAaggGgggGGGAAAgaaAaGGgggGGgaAAAGAGaagagggAGGaaGAaaGGgaaGggGagagaAggggagAAggAgAgggaAGGaagGAAAGAgGaGGg	BBBC>=BACDDCEFBECEFFCCEDCFECDCCEEEECFBF=ECFCFEECFFEDFGDDEDDDEDAEFFDGFEGDEBDDEEDFEEFEEE>GDGD?D?DDGGD=GGDDDGGADDDFCGDG@DDB8GCEDDCECEDDDGDCCGGDCDCDDF@A?BC>	G	91	A	61
17	18776020	A	53	tATATaATTTataaTtatttTattattataTTatataaaattatAtaAtttaa	?BCEDEF<GGCDDDFDDDDDEDDDEDDDE=GGEEECEEEEEDEEFEEEEDEEC	T	29	A	24
17	19564634	C	82	CGCcggcCGCGcggcccGgccgcggCcgcgggcCcgcggCcGccGgccggcGgcCcccgggcggggccgcgggcgcccggcc	DB;C@ABB?DAEGGFEFEEFFFFFFGFDFFFFFGFFFFFGFEFFEFFFFFFEFFFEFGFGGEGGGGBFGGGGGGGGGFAA:B	C	42	G	40
17	19609947	C	144	GGCGCGCCGCGGGCGGGGCCGCCgGGGCCGCGCCCCCGcGCGCGgCcGgCgCCggcgGGGGggGCGCGCCCGgggCGCCCCCGCCCGCGgCGcGGGgGGgcCgCgcCCCgcgGGcGGccGCCcGcCCgCCgGCGGccCccGGGc	ADEHFH?AAGHHGGHHHGH<GGGDCHBGG5GGGGG<FHEHGHGHGEEHDGGGGGGE?G@GHFGGFFFGFFFGGFGCGDF=FEGFFFGFGGDGECGGGGGGEFEFFEFFFGEFGGEGGEEGDFAGEFEGFFEDACD?9C@=AACB	G	74	C	70
17	19643810	G	228	AagGaaggGaGgggggAGAaGGAGaaggAaGAgaAagaAaggAGaaAAgaaaGaggAGGAaAGGgggaggggGGAAGgGAAaAGGGagGAAgAGagAaaaAGgGGAGAaagagGGAagggAGgaAgagGGaaGGAGAGgAgaGaGGgGAAaaggaGAAggggGAaGGggagaaggagagaaaGGgagaggaaaaAaaggaaaGggaaagggggagggggagaagaaag	CA?>AAAA@B?CDDDCCDDECCFCEDEEFE9EFEFEEEFEEEFEEEFEFEEEDEEE@EEFEFFC>FFEFFEEAEEFEFEFFEACCEFG<FDFEEEEFEDD;EGEEEEFEE7FFEEFFFFFFDGFEGFFDEFEEEE5EECFGF:EEEFAFFEFFFFEF;GFGGDEAEEEEDGFFGFFFFGFFED?CBGF?D@FFDEFDGGFFBDGGFEEGGFFEEGGEFF<DDB:BA?C	G	121	A	107
17	19644472	A	59	AtaATaaAtaTtaTaaTaTAttATTATatTTaaatttaAatTtAaAttaatttTtatta	@CCCCEFHFFGGFGFFGFFBGGHGGHGFGGGGFGBHHGH>HGHHGHHHGCHHHF>FFFB	T	31	A	28
17	19707968	T	38	CCTCTTTTCTTCCTTTCCcCCtCTcTTTCCcCCTCtCc	@FHGGGGFFEFFFF@FDF@FEHFFCEEFFEAB=><@@<	C	21	T	17
17	20013802	G	133	AaggGGgagaaaGGGaAagAaAAAGGaaGgaAAgGAGAAgagaagggGaggGggAgGGAGaaagaaGggggaGGGAGgggagagaaGGaaggGGGgGggaAagaGggggagggGagggaaggGGGggggAagg	=C??BACDCFEEBEBECFBEF6;EDCFFHCFCDCDEHCCCFCFFCC9HECCHCCECHHAHFFFCFGHDDCDF:HHDGCDDGDGDFGHHGGCDHECDGDDGDGDGGDDDDGE9EGGDDDGF@DGGGCC<A@B<@	G	82	A	51
17	21194820	G	158	GGgGGGAGgAGgAGGagAGaGagGGAGGGAgAGGGaGggGGGaaGGgGggggGGGggGGggGgGggggGGGGgggggGggGggggggGgGgGgGGAGgGGgaaagGGgaaGggggGGgAgaagagAggaGGGGGggGAGGgGggaGGGaGGagaAggg	@7>=<?CBFFBDHCBFFHCFCFFCCHBCC9FH8BBFDFECCCFDCCGCFFFFABBG@@CGGCGCGGGGCCC@GGGGGCGDCDGGGGGBGAGBFBBGBGBBGGFGCBBG<GBAGGGBBGGEGGGGGGGGGBBBABGFBGBBGBFF>AAAGB@C=AC?DA	G	127	A	31
17	21318629	C	100	TCCTTTTCCTTTTcTtTTTTTTCCCTtCCCCCttTTCTCCTTcTTCTCCCTCTCCTttCCTtTCtcCTCTTtcCCtCtTCcTTtTCCcCCCTTtcCcctt	AFABFFBF9FFAFBFGF@FCFFFCFFHGFFFGEHEFFEEEFECEE?BEFDBEEFF?HHFFEHEEHCDEEEEECFEHEHEECEE>EDFCFECDB@=A><@:	T	54	C	46
17	21319007	G	236	ggggggGggaaaAaGAgAaaAGGgaGGAGagGggAaaggaaAaaaAgaaaAaaGAgagaGAAggggGgGGggGgaaggaGgaGAAAggagAGaaGAaGAGAgaaAaGGaAAGGagggAAAGgaaAGagaAAGAAaaggGGgAGagagGagaaAAGGgAGGAAgAAgGggAaaaagaGagaaaaAAAgggaagAGgggGAaaGgAAgGAAaggAAGggAaAAgGaagaaggggGgGg	C?C@A@BCDEFFGD;HBHEECCCCCCCHCECCCCHEECCEECEEEHCEEE=EEBDCDCECHGC8CCCCCCCCCCEECCECCECEHHCCECHBDECGECGCGBFDBFCCF=HCCFDDD@H=@@FFHB:DFHHCHHFFDCC9D@CFAEDBFDEF@GBCDGBAGGDGGDCDDGFB?F8FBGEDEFFGGGDDDEDDGBDDDBGFFBDGGDBGGEDDGGBDDGFFGDAEDCD<@?><:8?@	A	119	G	117
17	21319008	G	239	gggGggcccCcGCgCccCGGgcGGGCGcgGggCccggccCcccCgcccCccGCgcgcGCCggcggGgGGggGgccggGgcGCCCggcgCGccGCcGCGCgccCcGGGcCGCGGcgggCCCGgccCGcgcCCGCCccggGGgCGcgcgGcgccCCGGgCGGCCgCCgGggCcccccGcgccccCCCgggccgCGgggGCccGgCCgGCCcggCCGggCGcCCgGccgccggggGgGgcgg	=?AABC?AAFA?GBDAB=EAC@AEEGDBCECCGBBCCBBDBBBGCBBB8B@DECBCBEGG@@BCCECEDCCECBBCCECBEGGGCCBCGEBBEGCEGEGCBBEBAEECG9GEEBDDDDG:E8CCEECDBFDEFFCCDDE?DGECDCDECDCCGFDEDGEAGGDFF8EADF?BCCCDCC7?CCFFFDDDCCDFDDDDDFCBDDFFDDDFCDEFFDDDFCCEFDCCAD@AB@@>99A<6AA	C	120	G	119
17	26575380	G	65	ggGAaagAaAaggAggGaaaAgGGggGggGaaGgGaAaggGggAaaagaaaaaaagAAaaaagga	AC@?FACFFFFCCFCC<FFFECFGDDGDDFGGGDGFBGDDGDDFFGGDGGGGGGGAEC?GHFDCD	A	35	G	30
17	26850929	A	91	CaCACACACACcCCAACACCAACaaACACaAAcCAAAAaAaCacCcacAacaaAccAcAcccACAacCCCAAAccccccccAAAAAaaCaa	@=DEDHDHDHDDDDHGDCDDHGCFFHCGDFHHEDHGHHFHE=<EDEFEGFEB5DEE=EGFFFGCGFECCCGGGBDEEEEEEGGGGFFBB?>	A	48	C	43
17	27437710	C	55	CGgGGCCCggCccgcGccGGgccgGggCcGGCcgcgccgcggccgggcCgggcgc	A=A>=ABDFFDCDFD@DDCBEDDFCEEDDC<D9EEGDEFEFAD?FFF9CFGGCBA	G	29	C	26
17	27438469	G	59	AGAGAGAAAAGAAAAGAGAAgAAGGgAGaaAgaGGGAAaAGAaGAGAgAGAgaAAAGGA	>EFEFCDDCFEFDFFDF88FFDECDDEDFFEFFDDCEEEEDEFDEDBEECCDBCBA@AC	A	36	G	23
17	27441077	C	191	CGCCCCgCCCGGCGGCCCGGCCcGCGCCCGGCCCggcCcgGgGGGGCggcGCccCccCgGCcGcGgCGGgcCccCCCCcccGcGCCgCCcCGCgcggcCGCCcgcgggCcGccGccGcccccgCGGGcggcCGGCGGCCcgGcCccCcgCGGcGCgccCCgCCCccGcccccGCCgCcGcggCGGCGggcC	<;BDCEB8GEHHFGHF>G=HGGBHDEEGEHHEGGCCB@BCI@HGEGGDDCHGB@GBB>CHGBH>HDEHHDCCCCFFGF9CCHCHDGDGGB<HED?DDCGGGECDCDCDECGCBGCCCCCCCCDFGFG<DDCCFGFGGFFCAGCFCCFCDDGFCCFDCCFF:FFFCBGCCCCBEFFD>AFBCA>@CBD;<<?	C	115	G	76
17	27449059	C	74	AAcaccaacaaaaacacaaacccacacaccCaacCcacccacccaACAaaaacacCccacaccccaAaCcaaca	:ABBCCEDDEEBCEDEDDDDDDDDDEDDDDD?EDDDDEDEEEEEFHDHFBFBEFACEEFDFEFEEFGECECCEA	A	37	C	37
17	27904617	C	78	ACCACCCCCCCAAACCACAcACCCCcCCAaCAcAACAAAaCcACaCCACCCAAAACACCcCCAAcCCAAcAcCAaaac	BFGFFGGGAGGFFAFFAFECF6GFG@FGFGFFCEF<FFEGEC<FHDEEFFFEEEEFEFEBDFD<CFFCD?A;AAA=A@	C	44	A	34
17	28268800	A	54	CCCACACACcCACCCACACCCcACAcCcACCCACAaAAaCccACcCAaACAacc	EFGFEFGDGEGEFGGFDFGGGED>FEFEEFFFEFEGEEAFEEEFEFEFEEDEA=	C	33	A	21
17	30439658	T	39	tTgTTtgttTGttTGgTTttgtttgggttgtgttggttG	@DCEGGCGGGB<GFCCGGGGCH8CD>DHGCGDGHDDHE>	T	25	G	14
17	30520958	C	82	CTTCTTTCCTCTCTCCCCCTCTCCCTCCCCCCCCCTCTTCCTCTCCCCTCCCTCCTCCCTCCTTCTTTTCCTTCCCCTCTCC	CDEHEEEBGEGEEEGGGGG@GEGGGED?GGGGFEFEFDCFDDFEFDFFDFFFDFFDFFFDFFCDFDDDDFDCCFEGFCBC@?	C	52	T	30
17	30670991	G	64	aaAaaggaggagaAAGGAAagaGaggGAaAggaaagGgGAaggggagGaAaaaagaAaAagAAa	6A@B<FFFFFFFFFFEEFEFFFBFCFEFFFFGGGGGEGEFGGGGGFGDGBGGGGGGEGCGGDDD	A	38	G	26
17	30791503	C	277	CTCCCCCTTCCTTCTTTCCTCTTCTcTCCCTTctCTTCTtcGCcCCTtTCccCCCttCCccCCCTCCTccCCTccTCcCtcttcCCCCcccttcTTtCccTTCcCTTtcCCCCCtctTCcCtttcCTccCCtTCCTTtCCtttctctCCCctTcTCtCTTTCccctcttCTcccTTcCTCttctCTTtTCttCCTTCcccTTcTTTCCCTccctctTCcCtTcCtcCTcctTccccCCCCCccCcctCcctTTcttCCcccCCctccTttcccctcc	BB=?<B???DC:DDDDEEGEFEEGEDEEGBEEDE<EEGDC;9FDGGEEEEDDGDGCCGGDDGGEDGGEEEGGEEEEGDGFEFDDGGGGEEEFFDEEEGEEEEGEEDDFEGGGGGFEFEGEFFFFDFDBEGGCEGGEED?GFFFEFDEGGGCEEDEGEG<EEFE;DF?E<FECEEDDEFEFBFEFFDDFDFFFFFDAFEEEDDEDDDCCCDDDEF:EDFEFFDDFDEFDEEFDEEECFFFFFEE@EE=FEEF6CAFFFFCD<CDAB@?@=A>@=BABB	C	166	T	110
17	31105651	T	29	GtTggGggGGgGttggtgggggtgtttgg	@A@BEHFFHHFADEFFFCGEGFFGFFFG@	G	20	T	9
17	31319033	G	52	CcgGggGgGgccgcgccggggcgcgGcgCCcggCggcCgcGGcccgggccGg	ACC@GEAEBFDDEDFDDFF?FDFDECDEDDEGGDGFECFEBBEEDFGGD@?C	G	30	C	22
17	31319092	T	25	GtgTTgggtttggTttttGTTtttt	?CDFFFFF<EEFFEFFFFEEFEFF?	T	17	G	8
17	33482522	G	46	gGaGAGaaagaaaGaGGAGGagAgggGgagagGgggGAggagaagg	C?DEFEDDDFDDCECFEEE@DGEGG9EGEGEFDEGGDEGGC@EEBB	G	28	A	18
17	33497050	C	148	ttttCCTTTCCTTTttTTCCCCcCCtcCTttTcCCTTttcTTCTTtCTCCTTtCTTtctCCTTTCCtTcCCCTCTCCTTCCTcTTCTCTCTTCCTtTcCCCctTTTTtCCTCcTTcTTTCCTCcCTCtctTtCtttTTTttctTtCCC	A7C=5D<GFD@GFGEEGGDDD>DDDEDDGEEGDDDGGEFEEGDFEFDGDCGDF8EGEAFDDGEGDDFEEDDDF>GDD?GADGEGGCFDFDFFCCFCGECCCEEECEFECCFCEFFEFFFCCFC@CFCEEFFFC=EEEEFCA?@A>AA?	T	84	C	64
17	35632979	C	89	CcccAaacAAacAcAACCCaCaaccaAcaCcaaCCAcAcAAccaCAacAcacAacCcaAaAacCCacaacaCaaaAcCaccccccaCCa	ABB@GFFCHHBCHDGHDDDEAEEDDBFDEBDCEDDGD:CHHE6E5CEEHEEAH@ECEFHDCFBC>F7>FEEADEFGECEEEAEEDEBB=	C	45	A	44
17	37830900	A	121	AGGGGGAGGAGaAGAGAGAaAggGgaaGgAGGAGAgGagAGaagaaGgAGaAAaggGgGGAAAAaAGgaAgGgAAgGAAAaGaAgaAGagAgggAaagAaagAAAaGAGAAgaAAagaAAg	<BF8EGFG9FGDFCDGGGGDEFFG?DEGGFGGFGFGFEGEFEEGECGGFFDBDEGFFEGGF<FEEEFFBFEFGEEEFEEEEFFEGDEFDGEGGGEDDFEFEGEEEEFEFDDEABB@B8?@D	A	66	G	55
17	37879762	G	65	GGaGAagAgGAagaggAAgaaGgAgggaAaggAAaaAaAGGaGAGAGGaagGAAGGAaGgaAAAG	@;A=AECHCCHFCFCCHHCBGCDCDDDGHGDDEGGGGFGBBGAGBG5>GGDBGDBAGE@ADCCAC	A	35	G	30
17	37898722	G	104	GaaGaaGAAGAAAGgGGAGAAAGaAGGagaaAAAgAgaaGggGAAAGAGggAAgagAAgAaAAGggGAgGGAAaGgGaAGaGAGGgGggAgAAGAAGGaGGAGA	<FFBFFCHFBDH=CF@CHCGHACGH?CGGGGHHHGHGGFCGGCHHG?GBGGHGGGGCGGGGGGBEHBCEBBGGGBEBFGB=B;BBGBGGGGGGBGEBBDAA?C@	A	53	G	51
17	38100134	G	47	CGcCCGCGGGGGGCGCCgCCgCgCCCGGGGGGCCCCGcGgcCGCGCC	FEDDGEFEC?EEDFEBEFGEGFGFFEDDDDDDEEFFDEDD=DCCBAA	C	24	G	23
17	38121993	G	177	AaAGGaAGAAGGAGAaAGAGAAGAaAaagGgGGAgaaaaAAGaGaggaGAgGgAaaAGGAAAgaGGAgaGGgAgGGaAgaagGaaGAgGaggGAAgagGGgAGggaGAAAgAAgAGAgAAGGAGgGGgAgggGGAAGgGgGaAgaaagaAAgagaaaGGggggGaAagAaAgGAGaa	E@;=?CGBDECCCCHDDCH@HGBHDHDDF=FBCHF9D@DHHCECDGGCCH>CGHDEHBCHHHGECBHEECCEGGC@EHEEEFCEECHGCAGBCGHFEFABGFBGFDCGGGGGGCHBGGGABBGBGB@8GG>FBBGG9GBEBEGGEEEGEGGGEFEEEBBFG7E8CFACC9CACC?BA	G	89	A	88
17	38129996	A	55	TTAATaaAtaAAtaaaaATtAtaaTatAAattTTaTAtTataAAaATAATtAAtT	CCFFGAEFEEFFEDEEEFGEFEFFFFFEFF9BGEFFFFGFFDFE?FFCEFFEEBE	A	32	T	23
17	38130139	C	58	cCtTTTTTCCTtCCCCCTTCTccCctTcTtcTttcctcCcTcTCCtccccctttctCt	C9><FACAGFFDGGFFGFEGEF>FBCFEECFFE?GHEGFHEHFGG?BHHH6EECHDE?	C	31	T	27
17	38179492	A	114	GAAGGGAggaAAAGgAAgAAGGGaagGAGGaGAAagaaAAAGgaAaAAAAGagggaGAGaaGGGgaAgAAAGagAAGaGGaAaggaagggGaaGgggAaggaGgaGGGGAAAaA	?ABCCDDEFDEEFGFF@FFFGGGDCFHGHGCFFCDFDCFFFGFDDEEF@EGEGGGEG:GCDGGGGEFGFFDE=GEFEEFFEEEGGEE@GGFEEFGGG@EGGEEGEEFFGFEC@?	A	60	G	54
17	38420965	A	103	AaaaaaaaaaCaaaaaaaaaaaaaaaAaaaaaCaaaCaaaaaaaaaaaaaaaaaaaaaaaaaaaCaaCaaaaaaaaaaaaaaaaaaaCaaAaaaaAaaaaaAa	=C?ABCD;BD?DDEE@>ADEDE?DECGEDDD;AECB7EE?;DEE?ADEEEDEDCE?EB=D?FBD8FE>DFBBBE>:EDFFEBFFDC57DD?FE;EE=;7B<D;	A	97	C	6
17	39041309	G	116	aAaaagaGgaGGAaagaagggGaaaAAGaAggGaAGagAGAaaaGAggAAGggagaggaGGgggGAGgAAGGgAgaaGagAAGgaaGggaGaaggggaggaGaaAagggagaagga	C=CC=BBCBDGHEEEE6EFFEGEEEEE5ECFFFEEHE=EGEEEEHEFFEEHFFEGFGEEHHFFF?DHGDD>HGEGFFH@FECFGFFHGFFGFFGFGEFBGFGFFDBDGFCGFFFD:	G	59	A	57
17	39406291	T	90	tTTttTttttTtTtttTTTTTTTTtTTTtTttttTTttttttTttCTCTttTtTttTtTCtTtTTtttTtCtCCTTTtTCTtCTCCTTTt	ABEDD@CBDD@:GDDDFGGGGHHG6GFGDGDEDDGFEEEDEEFDDDGDFBEFEBEEGDFD<GEEFEE=FECECCFFF8FCFECEBDCC?>	T	80	C	10
17	39406427	T	147	CcCtcTCtTCctCcTtttcccCCCCCCCTccCctctTCTtcctcCTCCTTCTTCccttTcCCTTccCCCTCtccTtCCcttCCCTctCtcccCTtCTTctTTTtttTtttTTtttttTttttttttttTttTttTttcccctttttt	D?;BCCFEDFEEGFCDDEA<FGGGGGGGCFFGFEFEEGDEFFEEGEFGEFGEEGFFEEDFGGEDGEAGGEEEFFEEGGEEEGGGEGFGEGGGGEF<DCGFEDEEFFEFFDEEFFFFFDFEFFFEEFFFDFFDEFBEFGGGFEEECCC	T	83	C	64
17	39883595	T	55	tcctCTcTCtCtTccctccctccCtTCtcctCcttttttccCcccctTCttcCCT	C?:HCGAGDGCGGBBBGBBBGBBDGFDGBCCDCH:HHGHC@DC=CCFFCHHCCCE	C	31	T	24
17	40125864	G	115	GGGaGAGGaaaAAaaagGAGGagAgAGGAGagaAaaAAGAAGaAggaGgaggggGaaaagGgAGAGGAAaaggggaagGAAGaGgGaagaagaAagaaGgaaagagagGAaggaa	BB@AAEDDDEDFFEFFFEEEEFFEFEDEFEFFFFFFFGFG@8F@DDGDGGFFEGEGGGFGEG:BFEEFFGGGGGFDGFEEFEGEGDGF8F?GGEBGGGDEFGGGFGGGCDEA:??	A	61	G	54
17	40716235	C	91	TcccTCccctctTCTtCTttCtTCtctTCCCttcccctttTTcCttCCctctCTTtCTccCcCCTtttTCtCCccCCTTCCcCTcTTTCCT	@CA?BA>??@CFGGEGGGGGGGGDGBGEGGDGGBB<@GGHBFBFGF=GBFBGGF@H<GCBGCGDEHHGFFHFFC:FFFFFF=FFBFFEEDD	C	48	T	43
17	40720605	G	66	gGGAgaAaGGgaAGGGGGGgAaAgaGggGAAAGaAAggaaAAGaaggaAaggaAaaggggGggaga	@?<GCFHFC=CFHCCCC;CCHFHDFCCDCHGG5FHECDFGHHCGGDDGGGDDBGGGDDDDBDDF@B	G	35	A	31
17	40721360	C	118	cCacaACaaAcCCcacCCcAcaACcACaaAACACAaacaAAccaAAcAaCAccACccaaaCaaacACCCACAcCccAaaCCCAACAaCAACccAccAcCaAaAACAaacaAaAccAAa	C>B@EDFEF@AGFBFBGFBBBF;FBFFFFFF5EGFFFBFF:BBFFDCFEGFBC>GBBGGGFGGGCFGFFFDEBGCCFG=FFFEE=EGFEEFCBECCECFFEGEEEDGGCGEFDCC?BA	A	64	C	54
17	40737043	G	51	CCCCCCCGCCCCCCCGCCCCCGCGCCGGCCCCGGGGGCGGCGGCGGCcGCC	8DDD>BD:8DDDDDA@CCCCC?CBCC@B@CCCABBBBC@BC=BB??@AAA?	C	33	G	18
17	40818584	C	308	CtTttctTTttccctCCTTCctttcCTCCtccttcttttcctCtccCtTctcccctCtctcccCCtCCTCCCTTtttTTCtctTCccTCCcCTCTCCttcCTtctcttTCTCccCTTtTCCtCtcTtCCCTtcctCctctTCctttttctTCCtCTccccCCtCTctCTcTCCccccCctTcTCtcTCCtCCcttCcTTctCttctTTtcttCccTctTCttTccCCcccCtctCTCttcCttccccttcCCccttTcCcCtctccccCCcctccCccTCTctctCcCtctctcCtcccCCcTCccct	AC?A?BC@ABBA:BBAACCADCD;DDEDDDCCEDDCDDDDCEDDDDDEGDBDDDDEDEDEDCDDDEDDGDDCFFDEEGGEEDDHD@DGDDDEHDGDDEEDDBEDEDD?GDGDDD7GGE;D>E9E?GB?DDGEDDEDDDDDGDD;EEE>EDGDDFDGDDCDDDFDGEFDGEGCDEEEEAE?GEGD?EF@=FDDE:DDEGGEADEEE@GGFEE@DABEEFFCFFEDEDCDEEDBEFDFDFDCCF:EEEE@<ECCEEFFFEC@?EEEEEEECCE@EEECEEFCFEFDECECFEEEEE5FEEDCDDDBBA?@	C	175	T	133
17	41244936	G	319	GAGAaAgAGAgaAGGGGGAGAagAGAGGGAGAagGGAAGGAAAGGgAagGgAAaaAaagAggGAAGgGGGgGAGGAGAaGAaGGGGAGaGGGaaAGggGAAGAAggAGAgGAAaaGGGGAGAAAGgAAGAGGGAGGaaAGAGGaaGAGAgGGAAAAaaGGGAgGGAGggGGAAGAGggGAAGAagggggggaagAGGGGgaAGgaAaggAAGGaggAGaggggAaaGGGGAGaggagGaAGAAgaGGGaaaaGAagagggGGAAGAGgagggAaaAGAAAaAggggGgagGGGaagAGGAaGAgGaGAAGGggagaaaa	@A8@D@AD@GDGFBCCBAHCHFCFCHC@CGCHF5BCFFBCGHHCCCIFCCCHHFFHEFCHC8<HG<CCCCDCHCC=BHE>HFCCCCHCFCCCGEHCDDCHH<GDDCHBGDAHHGGCCCCH:HHH@DFGCHCCCHC7GGHCHCCGGCHCHCCCHHHHGGCBBHDBCHCCCBBHFBGBDDBGGBG6DDDCD;DECDGBBBBDGGBEHGFCDGGBBGCDGBEDEDDGGGBBBBG;GDDGDBGGBGGDGBBBGGGGBGADGDDCBBGGBGBDGDDDFGGGAFGFGCD?CCBCEBAAACDA@??EB=C=<?AA??CA>DADDDC	G	175	A	144
17	41352643	C	53	TCccCCTccccctccccTttttTttcTttttcccTttccTctcctttcttttt	CACA=AGFFFFFEFFFFGE>EFFEFEGF@FF8GFGE;AGF>FG8FFFGEFEB>	T	29	C	24
17	41570427	T	42	CCTtcctTtTtctTccTTcTtttCTtcctttcttctttttct	B?@AFEDEDDEFEEFFDEFAEEEGE:FGFFFGFEGFFCGFGC	T	28	C	14
17	41590928	C	85	CTTcTCccccTcTCctTTttttccCctcCtCtccctcCccCctctcTTcCctttTctttctcctcttcCcttctccccttcttcc	DDDCB?ACDDEGGGEDGGEEEEFFCFEFGEGEFFFEFFFFGEEGEFGG?GFFEEGFFEFFFGGDGFFGGGFE7FGGGGFFGCFA<	C	47	T	38
17	41613691	G	68	TtGTGGTTTggggGTTTGtGggGGgGTTGggGgTGGTGTtGTTGTTGTGTTGgGGgGGtTttgGTtgg	BEGEHH>DFFFFFHEDEHFGGG8HGHDEHGGHGDGHDGDFFDDFDDGDGDDGGGGGGGDDFEGFDA@A	G	39	T	29
17	41797692	A	70	ccCccCCAcAAaaaCACCcCCCACCAaAAACCACCAAcAAAAACCCACAaCACCCAAACAAAAAcCaCAc	C?FEEGFFFFFEF=GEDEFGGGFGGFFFEFGGEDFEEGFEEEEFFFEFECFEDFFCEEFEDCFEB@BACD	A	35	C	35
17	42453065	A	72	cccacaCacAcAaaAcCcacaaaAacaCcAcaAccACAcCCaacCaccccCAacaaAAcaAAcCaCaACCaa	A?BACDBEEEFCFEEFDFFFF=F:FFF<FEAFD?GEBFFEFGC;GFGG<GFDF@<?EDGEDDGFGFEEDF>B	A	37	C	35
17	42461603	T	39	ttttttTTTttTtTTTTTTTgTTTTTTTggggggggggg	C?BB;HCFFGGBGFDD;EEEDDDBEE@EA8?DC8:D9CD	T	27	G	12
17	43131480	A	217	TAaAaTaAAAaAttTAaaATAAAAATattaTAaTTTtaTaatATAtAATTATATtATATtatATattaTAtaAtAaATtAaAAATttTaTAtaaaTAAAttTaTtaATTattttaaaAATTTTtataattATaaATAaTAaTaaTTtAaATATttaaataAAaTATTaaataTTAttTAAaatttTAAtTataAAatttaatAtAatAAAattTAAa	D>@@CBDDEDCFD:GFDBFEFFEFFFDDDDGEDBGGDDGDDDFAFDFFH@FGFGDFGEGD;DFDD?DDGFDAFDFEFGEBDFFFGEEFEFFEEEEFEFFEEFEGDEFGDEEEEE:EEFFGGGDEE:EED>FFEEDGEDGF=FEDGGEEEEFEFCEDEEEEEEEFEFFEEEDEFFECEEEEEEECEFEEEFEDEEEEEEDEE;ECEDDCCB??=BBBB	A	119	T	98
17	43163851	T	92	CCCCTTTTTCcCCTCTCccTTcCCCcCCctTCctcCTtCTCTTcCCCcCTCTCcTCCCccCcctcTTCTCctcTcCtCTCTCTCCcCCCtct	@?BGEEEEEGFGEDGEGFGEEGGGGGGGDFEGGEGGEFFDFDDGFFFGCCFDDGDFFFGGFBGFG>DFDFGFGC?AFFCEDFCFFF@CBA@<	C	60	T	32
17	45331358	C	61	gGGGGggCggCgCgGGcgcCGcccGCgcGcCCCggccCcgcccgcgcGgGcGGgcCCggcg	?<><=AEDEEDEDFCCDFDD@DDBCDEECEDDDGFEEDAFDEEFEGEB=BEBBEECCGGCD	G	32	C	29
17	45363546	G	35	GtTTTGTTGTTTTTGTTTTGGGGTTGGTTGGtGtt	HEEEEGE@HCDCDDDDDDDGGGGDDGGDDGGDC9B	T	22	G	13
17	45369789	G	142	AGaGAGGGAaAGGGAAAaggaagagGAgaaAaGGaAGaagGAGGgaAGaAgGgGGgaGAGgGAgggGGAAGAGGGgaaaaAAaAGgGAAGgGAGGAGAGGAAGAgAGAGGAGGGAGGGAGaAAgGAGaAGgAggGGAGAAga	AACCE?EEFFFEEDDFEFCBEEBFCEFCFGFFABGFEEGDEEEEDGFDDFDADEEDGEFEDEEDDDD9F>EEDDDDFFGGEEDADDD>9DDDEDDEDEADEEDCDEDEDDECDDEDDDEDG;EDCDCGEECAA@99ABBBAC	G	77	A	65
17	45385012	C	70	cttcCtcttcCcTcTttcTTTcCctCCcCTCcCCtCTTcCtcCCTcTctttctcTtttTcctctcttctc	AD??6FAGF?GAEBGGGBGGFBGBG<GBGGGCF<HGGDBGH:GFECFCHHFCD=FHHIFBCHCHCHHCH>	C	36	T	34
17	45750596	G	67	AgggggggaaAgggaaaggaagaggggggagggaaaagagggggaaaggagagagaagaaggggaag	B@BBAABCCDCGFEFFFFFFFFFDFFFFFFFFFFFFFFFFFGGFGGGGAGGGGFGGGGFFGGEFGGB	G	39	A	28
17	45822092	C	25	cTtTTTTCCTCCTTTCCTCCTCTcT	CACDDB<EGEGFEDDCFDFFBECBC	T	14	C	11
17	45894735	A	53	GGAAagGGaggGGAGaagAggGGagaaAgAGgGgagGGgAgaggAggagaaag	D<>CCFGGDFFEGEFDCFEAEGGDEDDFF?FFCGEDGGEFAAGGEEGEGCA6E	G	32	A	21
17	45915788	T	156	cctctttTtCttTCcTTtTTTcCtCtTtctCTTTTCCcTCctTtCTTTTtcCtCTCTTTTtTCtcttTTttTTccctCCCTtTTCTTttTCCCCTCtTctCctctTTtcTTTCttCtTCtTTCttTtCTtctTcTCttccccCTCtTcCtTTcTCC	A>CACCBCDEEDC9CGGEEGGDGBGDGEDDGGFGG>CDH8>?G5G?GGEDDCEGFGG?GCEGGEEFFFBFFGGEED6GEFEEGGCFEAFFFFBGFFE=EFFEFEFFF>EFFFF8EFFFF:FEF@EFEFFFEFFEFCFFBEEEEFFFF9FEED?AA?	T	97	C	59
17	45994154	G	134	AGagAAgGgAAGAaaAGGAGGagGGAGAgGAagAAGGGgaaGGggaAGGaGAggagAgggGaagGaggggaggAAGggagAGagAaaAGagaggGAgAAgGaGgAgAAGGgaGgAAGAaggaAgagaggaaGAG	>@CC=<A?DFA@DD>HBCF=CEEACHCHE<HDFH@C<CEDECAFDDHCCDCHF?EEH=GFC=FFCFFCDGBGFCHCGFFEHCFF=EAHB7GFFGCGFG<FBFB;GCGGBBE=BFGGBGEFEEGCBBADB>@CC?	G	74	A	60
17	46052793	A	28	ggggggaaaGGgGaggGaAggaAgGAGG	BCDFDEEEECCFCDEECFHFGFGFAFAA	G	19	A	9
17	46055347	A	37	gaAaGaGgggggGgGggggaagagagaaaggaaaaag	@BCDGDGFFFFFGDGAGDFECGEGECEDEGGEEEEEF	G	21	A	16
17	46923384	G	79	gAgaGGAGgAGgAGGGgGAAaaGAGGAAAGgAAgGGAAGGaAAaAGgGagaaaagaagggggaggaaaggaaggagggg	FFFFGGEGFFFFFGGG>GF@DEGFFFFFFGGEDGGGFFGFFDBGEFDFGGGFBGGDGGG:GGFFGEG@FE@BCBABB>?	G	43	A	36
17	46939658	C	139	CCGgccgcgGGgCcCGcgCCcgCCGGccgCGgcGCcCCCGcGgGgcGCCCgcCCCGCGCCcCGgcGcGgCcCGggCccCcccCcGCcGCcCCgCGGGgcGgCcGcCCCCggGCGGGGCcgCcCGGcCcggGcggGcGcc	A?@CABBAB:>BDCD6DFDDDFDDC?DDFC;FC@DDDDDADCGCFECDCCGADDDCDCCDE7CFECE:FDDC;G7CEDCEEECEBCEBCDDCFCB?:FBBECDBECCCCGEBCBBBBCEG8EBBBCCCFECDFD@A>@=	C	79	G	60
17	47044463	C	95	CTTcCcCTCcTCcCTCCccCTtTTTCTCCCCCTTCTTCcTTTtcTCccCCTTcCTTTtCttTtCttccctcCcTTTcTtTcctTTTtcTtTCttc	A@;BBCBGDDGCCDGDBDDEGEHHGDGDDDCDGEDG@DEEGFEEGDEEDDGFDDGGGEDCFFFCEFEEEFDCEFFFEFBFEDFFFDFEEFECBA=	T	49	C	46
17	47210506	C	37	CcCCcAacaACcAaaaaaccaaAccaaacacaAcacc	??;BED>EFFEFFFEAFFEFEFFGE=E:GFF9FGCFF	A	20	C	17
17	48212910	A	42	AAGGGAGGGgGAAAAAAGGGAAGGAAaAaGAGGAGAAAGAAG	FFBC7CCCCDCHAGGFGAA=CGBAGGHGGBGBBGBGHD?BD:	A	23	G	19
17	48263021	C	90	TtTtcCtTTCtccttTCTTtcctCCccCTTTcCCTCtctccttTtCtcCttcCcCcCCcCTcTtcCtTTCtCcttttCcTtTCccTCTCc	>CCF@FGFFFGBABFFFBGG=?FGFBBFFFBCGFFFGBFC>G@F:FFBFHGCECFBFDCF<CEHADCEEFCF=GEHEECD;FFA8=BCC9	C	46	T	44
17	48270098	G	119	gAGGggggGaaggaaaAGGaAagaaGaGggGAgGgAaaGaaagAaagggGAGGagaGgAGaagaGggGaAAgaAGGgAggGGAAaGgGaagaggaaAgggAgGAaagAaaGGaAgAGaa	C@;@CCCGCCDFFDDDHCCDHDFCDCDBFFCHFCFFCD?EEDFHDDFFFCA<CEGECGGCE;FECAGCEHHFDHACFGGGCCHE<CEBEE?EGGCEGFG=GGBGECGGEDAADG9C?B>	G	62	A	57
17	48431197	C	45	CcctCtTtTcCtcCTccCCTcCCTCTTTCTCTCTTTCTtCCCCCt	?DDDDAGEG;DF>8FEDDDGEDDFCFCFCFCFCEFFCFEBC<=@@	C	25	T	20
17	48446130	A	46	AgAAGAGAAAAGAGGGGAGAAAGGAaGaAGGGAGaagGaAAGGAAg	ECHH@HBGHGHCHB@CCGBGGGBBDEBEGBBBGBDCFBACCAACA@	A	25	G	21
17	48560883	A	48	GgAgaaaggaaaaaaaagaGaaGaaggaGggaaaAAggAGaAAgAagA	?CBBDGFFFF>FFFFGFFGE=GA>EGFGEGGGGFAFGGEDGECGCGAA	A	30	G	18
17	48647011	T	154	GGTGtTGGGTGGTTTGTTTTtTTGGGgGGGGTTTGTTTGGTTggtgGTGtgGTGGgtTGgtTtgtGGTtTGtggGGtGtGGGTTGGGTgTgTGTTTTGgGTTGTTTTTTTGTGTGTGGTtgTTGGTGggTTTTTTgtgtgGTTtgtTgtgGGGt	A@EHDEHCHEHHEEEHEECEEDEEHHFGGHHEEEGEEEHHDDGEEDHDHFGHEHGDF=GGFEFCFHHDEEHFGGHHFH:GDGD@GHHDGDEDGCDCDGGGDDGDDDCDDDG;GDGDGGDFFDDGGDGFGDDDDDCGFFFGGCCFGEAA@8DA@A	T	79	G	75
17	48669026	T	56	cctcTcCTTcCCcTTCtCcCtcCtTTTCcCCTTTTTTCCTTCTCCcTCCtTCCcCC	?BH?<BDGDBDDBGGCGDBDCCDHGE;C=CDECFEEECCFFCFCCBFCCH6CDAB@	C	32	T	24
17	48693760	G	60	gGGCCgcGCcggggCcCcGcCCgccGCCGCcGGgCGgGCcCggccccccCgcCgcCCcgg	C<=<EBB?GBCCCCFAGBE;FGDCCBDFEFAEEDDDAEECFDDCAC?BCFDCFBCFECDA	C	35	G	25
17	48701692	A	29	CCCaCCaaCaaaaCaAaaAaaAAAAAAAA	<BDE>AFB9FF>F;E;CCFDDD>;BACAC	A	22	C	7
17	48701697	T	36	CCCtCCCtttCtCCCttCCtttTTTTTTTTTtTTTt	9<AD9DD@ED7F:7:EBC?EFFEEFEFFGFG<CCC=	T	24	C	12
17	48735774	G	205	AAGaGGGGAgGGaGAAAagGAaaGgaAGgAGGaGAGAaGgggAGaAGaAGAAaGGAAGGAAgAAaaGGGgAaagAAAaaGAaGGAagagagGggaaGgaaAGGAgagAAaGgAaAagaGgGGaGAGAGagGgAGaAAaaaAGAgAAAAaaGGgAgaaGAgGgggggaAagAagAGaaaAGAaaAGAgGGaaGgaaaaaaggAgaa	B@>C@>?=HEC;ECHGGFFCHFFBFFHCFHA?FBHCHFCFFFHCC<CFHCHHFCCHHCCEGGHGFECCCGHFFF5GGFGCHGCCHGGGG:GCGGGGBGGEHCCHG8DFHGCGFGHEGGCGBCGAFCGBGGBGGBFEH8:EG<GGGGGGGG@BHGFGGBGGBGGGGGFGGGGGGGBGFFGBGGGFBGGBBFF@>BA=AB?:@BB<@	A	113	G	92
17	53491455	C	66	AACCcaACaacAcaCcCCCCcCcCaCCAAaCCaCCCAAcCAcaaaaAAaAcCcACAcaCCAcccAC	@BADFFHCFFEEFFDGDCDDGDFDFDDHHGDDGDDDHHGDHGFFGGHGGG<CGGCGGBBCFFCCB@	C	37	A	29
17	53852111	T	32	TtTttTtTtCTtCCtTTtTcCTTTTCtcCCtt	AEFDDFDEDGFDHFDFEDFHGFDEEEEHDDC@	T	23	C	9
17	56386358	T	99	tttTtAAtTTTATaaAtAttaAtaATaaAAttTtTAtATAATtTATATAttAaTTATATaAAtTTTATaTaAaATAaATAATATTtTTTaaTAtaaAaa	?DFGDHHEGGGCGEEHE<EEEHEDFFAEH@EEG6GHECGHHGEGHGGGHEAHFGDGGFFFHHFFFCGFEFEGFGFGEGFGGFGFEEEFEDEEDC@>@@@	T	50	A	49
17	56388238	C	61	CGcgGCcGCggCggCcCccgGcggGCGGCcgCCcgCgCgggCCgCCGGcGCGgCgcGcccG	B=DEEFDEFEFEFF<DHDEFEDEEEFEEGEFGFEFGEFGGAFEGEFDDE@EDFE9DD;@??	C	31	G	30
17	56400617	T	48	TCcCTCtTCTTTCTTTTTTCCCTTTCCTTTTCCtTCTCCCCtTCCTtC	DDCFAGGFFFEFFFEFFFFFGFCFFE;EEEEGFFEFEEFEFHEECBCA	T	27	C	21
17	56432362	C	31	GCgcCGgcgcGggCccgcgcgccCcggccGg	9@CBFECBCBECDECCDCDCDCCFCDDCCDD	C	16	G	15
17	56448297	C	94	CCCTCttTTttCTTCcTCCTtTCcTtttCcCTCCCCCttcTcCCCCTtTTTttCCtTcCTCTTccTTtCtccCtTtcTTCtCCTtCcctCtccc	:?BFFFGFEGE6FFFBFFGFGFGBFHGHFCDDGAEFEHGCFCGGGFEHFFFFGFFGFCFEEEECCEDHFHCCFHEHCEEFHEFDHEBBEBC56;	C	47	T	47
17	56620167	C	81	TTCTTcCCctcTttTtcTtcTttCtTcccTtcCCCCtcCCtTCTTctTtTtcCcTcCCCcccttTCCCttctCCtcCTCtT	BC@CA@B:BGBG?GFGBGGBGGGDGGCCBGGBDDDDGB>DGGDGGCGGHGH<CCF?CCCBCCDHFCCCCHCHADG;BD@BA	C	41	T	40
17	56737838	G	59	GAGGAAAGAAAAGGAAAGAAAGAAAGgGGGAAAGGGAGAAgAaGaAGGAGGaGAAAGaa	>HB;GFGBHHHHC:EGGBFF8CEGGBGBBBDGG@ABGBGGGGEBGF>AFABCADD@:DD	A	34	G	25
17	56738919	G	70	GAAGGggaaaaaAGggggagAaAgAaggaGaAGGAgggaGgaaaggaaaggAggggaggAaAgaagaaga	<C>@@D@DCDDCEEEFDFDFFDFFDDFFDEDEEEFFFFDEGEEEGEDDEGFFGGGGEGGEAEFDEFEEGB	A	35	G	35
17	57289709	A	30	CCAAcACCAACcCccCCaaAAACACCcaCA	GHEFEFGGFFEDFEEFDFFEEEFEFFEEGB	C	17	A	13
17	57289711	C	32	AACCaCAACCAaAaaAAccCCCACAAacACaa	HHADE7HHDDHEGDEGFFHCCCGCGGEFGC=B	A	19	C	13
17	59544775	C	31	cTCCTTCCTTTTTTCCTTTCCCCTTCCTTTC	AEGGEEG@EEEEEDFFDDD=FFFDDFFDCDA	T	17	C	14
17	59544810	G	61	GGAAAAAAGGAAAGGGAAGGAAAGGGGAAAaGGGGAAAGGAGAAaaGgaGAaAAAgAGAGG	?AHHHHHHC:HFG=BCHHC>HHHBBBBGGGGBBBBGGGBBGBGGGGBCE?F@?CD>B=B<A	A	34	G	27
17	61560763	T	113	TCCCCCCTCTTtCcCTCTTCctCCTTTTCTTCttCtctcCCCCCCcTCCTCCCCCTTtCtTTCCtCCtTTTtccTTcTtTctttcTctCtCCTTTcTTTccCTTCcTCcCCcT	BCB@AEFEFFFECFGDFFFGFE8GEF=BGFFFFFGFFFGFFGFEEGBGDEEEEFDEEF:F@BCEFFEGBEEGHHEEGEFEGFFEADGFEEEFEEDGDEDGGDEFEFCCAAA?@	C	59	T	54
17	61562309	C	113	TctTttcTctCCCTtCTCCcCtTCttctCCTtCCtCTTTTCTtTtCttCCcCTtTCTCtCccCcccTTTTtctcTctCTCCcTtccCCtctccttCCctcTCtCcctcttTcc	DA>AABEGGCDDDDDDGEDDD=GCEDGDDDGDDDEDG9GGCGEEEDCBDDHDGEFCFDE?5HCDHHFFBFEIEHFHECFCCHFEGHC8EHEHHBECCHEGECEBHHAGA@DA<	C	58	T	55
17	61562553	G	37	aGAAAAGGAAAGAAGGaGGAGAAGAAGAGAAAAAaGG	@GFFEEGGEEFGFDFBFEFDFDE7CEEDEDDBCB@>C	A	23	G	14
17	61564281	T	67	CTCcCTCTTCCCCTCCTTCcCTTTTCCcCTCCCTCTTTTTCcTTTTCCTCTcCTTtTCCcTCCCtCT	CDFG?F8FCGAGF9GF<EFHEFACEAFFFEFGEEFEE>EEFGEE5EE:EF>HDCD9EED9DCCB>AC	C	36	T	31
17	61564522	T	29	ctCtcccttccctccccttttctcccccc	C6>?EFFEEFFFE=FFFEEEEGFG5GFGF	C	19	T	10
17	61565998	A	157	CAACAcAAaAACaaaCcAcAAaACcCCCAaacACACCAAcCAACAAAAaAAcaACCACCCAAACACcAAAAACcaAaCaAAcCAACAAacCcAcAAAAacaAaAaaAAAacaACaCcAcaCAAACacaCAcAAaacaacCCaacccAaAcCcAAaAC	?>ABBDFFDFFGEEEFBFDGFEGGDGGGEEFBFBFGDFFCGFFGE<EEEFEEDFFGF<GGFEFGFGEFFFFFGEEFFGFFEDGFFFEEBEFEF>FEEEBEFEEEEBEEEBEFE@FFEEEFFEEEFFEEFEEEEF=EFFEFFFFCEEE@FDBABBAC?	A	97	C	60
17	62025238	G	26	GGTGTGGTTGTTTGGTGTGTTTGTgG	HH6GEHHDEFDCDGGDGDGCCDEA<C	G	13	T	13
17	63533768	G	59	AgGaGAAGgaGGGAgAaGaAAGggGAaGGAAaagagAAaaggAAgGagGAgAgAaGggg	A9ADDFEECEEEEFC=F:FFFEDDEFGEEC<FFDCC?DFGD9EEDDGDDDDDDCFDBA?	G	30	A	29
17	64735042	C	91	TTttTtTtttccccCcccCccCcCccCcCccCCCCccccccCCCccCCcccCcCccCcCccCccCCccCCccccCcccccccccccccCcc	B=A?=B@FFDDDCCBDCDGDDGDEDDGDGDDGFGGDADDDDE?GEEECEEEGEEEEFEGEEGDDGGEEFGEDEEFEFFEEEEEDEDEEGA@	C	81	T	10
17	65341976	A	46	gGAgAaagAGAgAGGaagAAggAAaAAGagaAGgGGgGgaGAGAga	BC@CCDDFEHEF7HHEEEEEGGEEE<DHEGEAGEEGDGGEFDGDE?	A	23	G	23
17	66883719	A	32	gagGggAGGaGaaGggaggAaaGggGagaaga	?DFFEFEGCEGDFFFGDEFFBFDFGGFGFFFF	G	19	A	13
17	66985992	T	83	GTTGTGTGTGTTGGGGTTGTTGGGtTGGGGGGGTgGTGTTTGTGTTGTGtgGGGTGggGTGTGTGtTTgGgGgGTGTgGgTgt	ADEHCHEHEHCD:HHHEEHDEHHCFEHBHHHHHDGGDFDDDGDGDDGDFFDDGGDFGGG;GDGDFFDCGGFGEEBDCBD?>DC	G	49	T	34
17	67024799	T	51	ATTttAtaTtatattttatAatTaaTtaaAatatataaaattttattaaaa	:=DDBEDDEDDCDBDDDDDED<D<DEDECEEEADEEEEEDBEEEEEEEEDD	T	26	A	25
17	71238433	G	104	AaGgaAAGaagGAGgGgGAaAAAggGagggaGAgGgaGAggaggagGgGAaaggGggAAgGAGAGgaGggaGAggAGaaAAGGGGaGaaAGAgagGagGAGggA	B?@ABCDHDDFGEGFHFG?DEEEEFGEFEEEHEEHFFGEFEEEFEFGGGEFEGFGGF?EGGEHDGGFGGFFGEFFDGFFDDGGGGFGFBDGDGFGGDFE@EB@A	G	60	A	44
17	71375794	C	41	ccctcTttctttCtTctctttttcctttcTctcTctttctt	C?>B?BGHBFGGDGGBGB<GFGGBBF;GCGBHBG?HHHAHC	T	26	C	15
17	71426841	A	37	ggagAgAgagAaAaagGaAaaaaaaaaaaagggGaga	?>AAAFFDDFEDFDCFGDFDCEEECAEDDDGDGFEGE	A	24	G	13
17	71443924	A	36	GAggaggaaagggaaggggagaAagagaaaggAaga	D>>ACFFDDDDFFDD@FFFC;EEEGEGEEEGGDEBE	A	18	G	18
17	72339369	C	25	cttttctTtTtcctctttTctcctt	CDDEFBDGGGCBBGBCGGFCHCAHE	T	17	C	8
17	72351406	C	71	ctCcCCCCTcTCTCCttTTCCtCtTTTctcttTtccCtTCCTCCCtCtccTTCccCTTCcCccttCTTttt	<CDAG@GGGBGE?GEB<BGFGG<HG@GCHCGHFG<CFCFFFFFFFHFF@CFFFCCFEF=CEBCGDCCCCEC	C	37	T	34
17	72358170	G	95	GgGaGgAGAaaGagAgAGaGGAgggGGAGGgAgAGGAGGGGGAAGaGGAAGGaGGGgGGGAGAAGgGAGAgGAgAgaAAAAagGaAGGAGaaGaG	<B@ECCCCHFECFCHBGCFCCHCDCCCGB?DGCCBCGC6CCCAHBGBBGGBBGB?AEBBBGBGGBDBGBGDBGDGDHGBGGDDBGEBAH@@D?=A	G	56	A	39
17	72367843	C	42	CCTTCTCCTTCTTcCCCCCCcCTCCTTTTCTCTTTTTCCCct	DCGGCGDDGGDGGEDDDDCCEDFCCFFFFCFCFFFE;CBCA@	C	23	T	19
17	72588326	A	129	acAcaaCccaCaAaaAAcaCAcCCccCaaAAaAaaCaAaCcCCCaaaaccaCCCCccACaacAcccaaAACccACAAAAaaAACCCAAAACaAcAaaAacCcCcCAcAAaACCCCACCACccACcAccA	AC;?CC?CBA@BFEFDEFDGFFFFFFEFFEFFFFEGFFEGFFGFGGGFFGGFBFFGFEGGGGFFG:GGFFFGGEFEEDFFFEEEEFFEEDEEEGDGGEGGFFFEFEGEEFEFFEFDCFDFEFCCCB?AC	A	67	C	62
17	72588806	C	82	ACCaAACCcAACCACCaCAcaAAACCACCCaaacccCccCAaaaaaaCAACAacAccaAcaaaacCCAaaccaaaaaacccc	CCEEDEGFDFFFDFFGEGFDEFDFEGFFGCEFFEDEAEEGFEFFFFFCFFFEFEEEEEEEFEFEEFEEGDED>EFFEFA>>A	A	44	C	38
17	72610089	C	113	TTcTTTCCttTCTTCTCTCCTcCCCTtTTTccCTTtCCtCCTCTCTTTtTCCTCCCCTCTCTCTTCCTTTCTCcTtcTtcTCTTtctCTTTTCTTTCTTCttCCcCCcCCCCt	@@>CFGDD@GGDGGEGEGDDGBDCDGAEGGCCCGGHDDHDDGDFDEEFHFCCFCCCCFCFCFCEFBCFFFCFCADHCFGCFCFFHCGCFFDFCEEFCEFBFHDCC=8>==@?B	T	60	C	53
17	72691928	T	79	cTcTcTTtTCtCTCTtCtTTcTTtTCTCctctTtttccTcCCtcttTTttTCtttcCttTtCctcTTccCCtTTcTTTt	@??DBECGDGGGEGBGGGFFBEEGEGEGBHCFDAHHBBECEGHCHHEEGHEEH:HCFHHDFC:HCD8@CDFHCDCCDCC	T	50	C	29
17	72791266	G	43	aggggggGAgGggggGagggAaGaaaaAgAaagaaagagggaa	BFEEEDEAFEEFEEBEEFFCFEE@DFFFDF=FGFFFFAFGEEB	G	24	A	19
17	72861974	G	65	aGagggGaagAGAGgAGaAgAaAGgaGAaaagAAGGAgaGgaAGaAaGggaaAagagAaaggaGg	C>CCCBCEFBHCHCCHBFHCBFHCCF>HFFFDAHCCHDFADGFCGHFCDDGGGGDGDGG?DDGB<	A	35	G	30
17	72862705	G	129	AGAAggaAAaagAGGAAAAGAgaGAGAAgAaagAAAGagaagaagAGAGaGGgGggagGGAggGAgGaagaaGgagAGGgaGGGaAAAGAaaaGGGgAggaGgAAAgagaaGaGgaaaaagGaGggaAG	C=DDDCFEHFFCHC@HGHHCHCFCHCH=CHFFCEI@CC@FECFFCHCHCDCCCCCCFDCCGCCBHDCGGDGGCDGCGCCDGCCCGHHH?HFGG6B>DGDDGBDGGEDEDGGBHBDGGGGGDBG><>AC?	A	67	G	62
17	72863030	T	59	tCTtcctctctccTcCCtTtccctTcTtCTCCTtTTccCcCcTTCttCCTCTcTtcCtc	A@9EDDEDEDEDD@DDFFAEAEEFBEEFGEBGBFECEEEDEEEAEE<FEEFDEEFEC??	C	31	T	28
17	72927123	G	149	tgGgtgGgggTttttttggGTtttTgGGGGgttttgTtgTgGgggGttgGgttgtgTtGGGtttTTTGgGttTTgttGttgGGtttTGgttGGgtGTggtgttgGtttggttggTtggggGGtgTggTggtTgtgtgtttTgGtgGGgg	AC<;C@>BBACDFEHHGCCBGGFGGC;CACCGGGGCGGCGCCACC>GGCCCGECGAGGCACHCGGGGCDCGHGFDHF;GHDCCHHGFCDHHCCDHBGDDH5DHABHHHDDHH79FGDD8EB7HDFDDFCCHFDEDHDFG?FD@DA8==A	G	77	T	72
17	72937605	G	76	AAgAGaAgAagAaAAGAagaagAaaggaaGagaagGgagAaAGaAgaaAAAAAGgAaAagaGAGAGaGAGgGaAga	BCBHCFFCGFCHFGHCHFCFFCHFECBEFCGDGGCCDGDHGHCFGDFGGGGEGBDGGFGCFBGBGBFBGBD@DD=C	A	48	G	28
17	72945334	T	72	TTCCTtCcCTCTCTCcCttTCCcTTcCCTCtTTTCcCCCTCtTctTCccttCCTctCcttTTCTtcCcTTTc	@=AEEEGDGDEEFEGDGEAEGGDDEEGGEGFECDGEFFFDFFDEBDFEEAFFFDECFEDFDDFCEEFACCB=	C	37	T	35
17	72954749	A	38	aaCCCCAaCCCaCCaCaCaaCAaaaaaaaaaaaaaAAA	CC:@AD;E>DBF97F7F8FF;?8?EFDFEAFFEEECC?	A	26	C	12
17	73257830	C	60	tTccTTCCtCtcccTTTcTTtCTtCTtTTtTcCTTtCccTCTCtTCTtCTCcTCcCCcCT	CEDDEEBGEGEEEECAEEEEFF9DEDFDDEDECADEFECDFCFFDFDFEDFEDGCDC=BA	T	32	C	28
17	73258479	C	256	TcCTCTCTCTcTCTtTttCTCTCTCctcCCTTTCCCTTttCcCCCCTCCTTCCtcccCCtCTCccCCTtCcTTTTtctTcCccCtTCccCCCttCccTCCTcCCTCTTcTCCcTCCcTCtTcTTTCttccttCTtcTttccttTCttTTctCCTCcCCctTcccCTcTCtcTctcCcCcCtTTtCCtttcTcCCcCCcccctTcCCCCTctctTccTCCTcttcttcCCTCtccCTTCtCTCtttTcTCtcTCtct	?>?B?B>CBFDEDGEGEDDGDGCGEDDDDDGGGDDCGGEEBDDDD@GDDHH;EEEDDDDEDGEDDDDGADDGEGGFEFGADEEDFGDDEDDDBFCEDFDDGEDCGDGGEGDDEGDDDGDFGDGGGCE<EEFFDDEEGFFEDFFGDFCFFEFDCFCECCEEFEEECFDFCEEF;FECECECGF@8C=FGGEFECCECCEEEEFFECCCCFA<DE<EEFCCFEFFEFEECCCBFEEBEEBE>EBDFBFDEA>=CC=@A	C	142	T	114
17	73502645	G	75	GaAGAAAAGGAAAAGGAAGAAAgAAGAgGgAGAAAAgAAGAAaAgAAGGGAAAAaAGAgGAGagGgAAGAaGAGA	>A<>HHHHCCGGHHCCHCCFHHGHHBGEBGH:GGGGGGFBGGEFHGGBBBGGGGEGBGG<GB>BAEEE?D=CC?C	A	46	G	29
17	73606310	G	56	gGaaAGGAaaggAGGAgggggAGaGgggagGAggAAaggAggAGAagaggaagagg	CFDDEFGFDDFEFFG=EFFCEFGDGEEFEFGFFFEFAEFFGFE8DFFFFG>5GCFF	G	33	A	23
17	73626817	G	58	aggggAAagaaAgggaaagggagGggaAAgAgGaagGGAaaGgGAaAAgAgAgAGaAG	CA=BBDFFBFFBCCCFFECC?ECECCFFFDFDCGGDEEEGGD@DEFEEDEDEDDE@AC	A	29	G	29
17	73627539	T	120	ccCCCTccctcCcTCtCtcCttTCcccTTCCTcCCctCttCCtccctcCctTCtTTTccTTtccccTctttCTCCTttccccctTctTctTtCcCcCCTcCTctTTCTcCTTttCTTttc	?@FFFFCCDEDGDFFEGDDGEEFGDDDFFGFFDGFEFGEEEGCDDEBEFEFF<FFEFEEFFFEEEDFEDECFFFFEFF?EEEE?EEFEEBEFFFFEFFEEFEDFEEEEEFEDF=EDCA@B	C	66	T	54
17	73839214	G	34	cggCGGGcCCcGGgCGGCCCCgCGGCGGCGcCGC	ACBFEEEAFABEEDGDDFEFFCEDDEDDEB=FD?	C	17	G	17
17	73844748	A	47	gaagAaggGGgggggagaaggaGggagagGaagGgAAGgggAAgagg	CBCF9DFFFGFFFFFDDDDEFDGEFEFEGFEE=GGFEFGCGEAGEGG	G	30	A	17
17	73886888	A	49	aAAGAGGgaaaAGAGaGgaGaaaAagGGgGGGAaggaAAgGgAAagaGg	?BABHACCFFFH@HCFCCGCFGGBGDCBDBCCGGDDGGGDB6G?GDBA?	A	25	G	24
17	73888273	C	87	cCCtcCcCTtCTtctCCCTCtTTttTctCTctCttCtCtttctTCCccCTTCCTTTCcccTctCTCccTcCTTttcttcCCTtcTtc	C<;BBDDDG?DGEDEDEEGDEGGEE<DDDGEFDFD?BDFEFEFFDDDDDFFCDFG<CE:EFEFCFCEEFECFFFFDFEECCFD>CBC	C	44	T	43
17	73897046	A	165	AaAAgAGaaAAAGGgGGAAgaGagGAaGgAAAagaaaGAGaaAAgagAaagAAaaaGaAaGggGaaaGGAGgGGagGGgAgAaagaaagAaAggAaGGagaaaGgaaGggggaGagAggagaggaAAgAAaGaaGaaGaagaaaggagAgaagaaaGaggAgGag	@CBAAE=DEDGFB<CCCHHBFCFCCFFCCHHHFCFFF5GCEFHFCFCFFFCHGFFFCFHF@CA<FFECCCCCBCFCACDHDDGCDGGGDEFH@DHGCCGDGD=ADFGBDDD?GCFDHDD=BGDDGFGCGGG<GG=F?BDFDHGFDDGDGD@FDGF<BDDDEC?@A	A	93	G	72
17	73909948	C	175	ctCCCctccttCTttcttTtTCCtcttTTTTTTtTCCCTTtttTTTccTtCttcTTtCccCtctttcTCTTcctttcTTtcccCtcttttCTtttCccttTtcTtCCTCctttCTtttCTttccttCtTcttTcttTttcctctccttcctctTtctcCTTctctTttCcttttC	CA@ABEFEB<DGEDDFED<DBGEEFEDFDFCEFE;FGFDEEBECFEFFDEA:EFFCEAFAFE?EDEFCGFFBFEEEFB<EFFFFEC=DDEGFFDDDG?FFEFGEFGGFFFEFFEE:EEGCFF:GFFFEF5F:FGEEEFF?GEGFFGDFG6EBFE@GFEEEEGFGF>FEEFDB?AC	T	109	C	66
17	74011721	C	60	ccCAcAaaaaAccacaaCAcacAcccAcccAaccCCaaaacAcCcctaaacCaAcAaaca	C?C=>AFFEFFB@FBFFDFBFAG@@BF<BBFEBCFGGGGGC?79CCHGEG:DGECEGB<C	A	30	C	29
17	74898598	G	83	GAAGGGGAgGgAGGGAAAGAAGAAGAAAAgagAAAGAAAGgAGAGAGgGGaAAAGGaGGAAaAAAGAGgGGaaGGggAGGAGG	;DD?CCCCCCCFDADAHABHHCFFCH7HDD>DHHHBHG@BDG?GBGBDBBHGGGBBGBBGGGGGG@GBDBAGFA@>@@?=@=?	G	42	A	41
17	74901177	C	56	CCGGCGCCGGCCGCGGGCCGGCCCGGGCcGGCGcCGgGGCGgCGGCGCGCGCCCCg	@CACDC7DCC7DCDCCCCDCCCACBBBCGBBCBFCBGB>CBGCBBCBCBC@9BB@?	G	29	C	27
17	74921072	G	99	GGGGCCCgCCCgCcGgCGgCGCGgggGCCCCCCCGCGCcgCCGCcCCGGgGcCGCgcCCgccgGCGGcgCGcCGCcgggcGccCCCGCCGGCCGCccGC	BEEE?GFCGFGD>BECGECFEBECCDEFGFGFGGEGDFBDGGEFCGFDDDECGCDDCEEDCBCDFDDCDEDCEDFCDDDCD<CFEFDFCDDEEDF??AA	C	56	G	43
17	74921257	G	36	aagagagagaaAaagggagagggggaGaaagaagag	C>CFFFFFFFEHFDFFF8GEGGGGDGCFGGGGEGGA	A	19	G	17
17	74936656	G	84	aagGGaaGggGGgaagGgggaAGgAgggaAgaAAaagggAGggGggagaGaaaagAggaGAAggaAggggagaaaAgggaggaa	ACC>=B;=CC<?DDDEBEEEDCBFHFFFAHFDHHDDFFFHD<FCFFDFDCDDDEFHGFECHHEGCDGGCGEGDE:GG:GEFEE?	G	47	A	37
17	75085260	C	84	CCCGCGGCCCCCGGCGCGGGCGCCGCGGGGCGGgGCCCGGCCCCGCGGCCCCGGGCCCGCGGCGCCGGCCGCCgGGGCCcCGGG	DDECBA:D>ADDCCDCDCCCCB@DCCBABAABBFBCCCB@CCCCBCBBCC@C=BBCCCBCBBCBCCBBCCACBFAA>AA=?<A@	C	43	G	41
17	75488973	C	36	ttTccCCTcCCcCtCCCCTCTCTTttTCCCTTTTTT	CCGDDCDGECCDDFCDDDFCFCFEFFFCACFFEBCA	C	18	T	18
17	76134828	C	46	CaccccCAcACcCcaAacCaCcACAAAaccACacAaCCAAACAAcc	=EA@BBDHBED=DBGGG@AGCCCDHHFGCCGCG>GGCCGFBBDE>9	C	25	A	21
17	76498406	A	80	gaaAAggaAAAGAAgaGGggaAggggGaGaaGGGGgaaaagGGGaGagAagggggaGggAaAaGAGgGgAAAaGGgAGAa	CC?DFCCFFFEBFFA@GDCCFFDDD;GG:GE@GGGDGCGGDGFGGFEDEGDBDDDE=CD=?:GFEEDADDEFDCC9:BCD	G	43	A	37
17	76525805	C	58	cCCcgcccggCcgcccCGcccgGccgGccccggcggcccccgggggccggggggccgc	C>?BBCBDGEGCEDDDEE=DDEEDDFEDDCDFFDFFEEEDCEEF@FEEEEAGGAEFFE	C	33	G	25
17	76528831	G	28	AGgAgaAaaaAgAaagaGagAggggAaa	BBAFCFEFFGE6EGFDGGGDDD9DDEGA	A	17	G	11
17	76567883	G	59	CCGGGcCccCggcGgGgCgcgGccgGGGgggCCgcGgcGcCccGcgcgggCggcggggc	@>=@AAGAAGCCBECECFCBCAABCEEECCCFFCC@C@EBGCCACDCDDDFDDCDCDD>	G	34	C	25
17	76672322	A	28	aTtTattAttAattatTatAattttata	>BCBGEEFEEEFEEFEFEEFEFFEFGFB	T	17	A	11
17	77185990	C	26	GGCGGCCGCGgggGggGgcgCggCgG	DCDCCDDCDCGGF?GFBGCGCGGBD?	G	19	C	7
17	77768654	C	49	acaAACcacAaCAAaAAAAacCCAAAaACAcAaACCAAAAAaCAaCAca	EDEHEDDEEHEDHHFHHHHEECCGGGGGCG7GFBCCGGGGGFDHEAC>B	A	34	C	15
17	78069367	G	51	aaaGagggagGggggggaagaagaaGggaagggaaggggggaggaaggaga	CCA>CBCFDFCFFFFFFFEF@FFEEAFFGGFFFGFFGGCGGFCGFEEFGGG	G	31	A	20
17	78084688	C	124	ACcAAcaaCcCcACaaCCAcACCCcACCcacaCCAAACacacCAACcCAAcccAaAAcacAcccaACaaacacaaAaacccAaCcAcAaaAaaaaacaacAAacAAAacacaaCccCaaaaaca	=CD:FADEDDEDHDEE@DHDCEDD?HDDDEDFDCCHHDDEFDDHHDEDCHEEEA@HH:FEHDEDFHBCFEDFEFFGFAEEEGFCDGEGEFEBGECFEDFEGGFEGGGFEDCEFCEEBF?EE?=<	A	69	C	55
17	78086531	G	58	gggAagaAggagGaaaggggGGgaagaaggggaaggagaagaaGgaGaagaaGGGAgg	>BC<DEEFDEDEEEEEFEEEEECEEFEEFDEFEFEFEFFFGFFEGFDEE?FFDDDEGG	G	33	A	25
17	78180637	A	66	CAACAaAACACCACCCAACCCCCCAAACCCAACCCACCCAAACCCCAACCCCAaCAACACAACCCC	EHG8GEHGDHDDCD?DHHDCCCDCGGGCCCGHCCCGCCCGGGCCCCGGCCCCGECFFCGDEFBAAA	C	38	A	28
17	78219908	T	236	TTCCTCTCCCCCTTTTctcTCTTTTCTTCTTtTctCTtCccCTtCTTCcTCCCCCTTtCTtTCcTcTTTTCTCCtcCTTCCCTCctTCTccTtctTTTTCccTTttTCtccTtTTCCCcttTTtCcTTCTttcCTTttCcccttTTTTtcctctcTCctcTctcttCCtTCTtttcccCttcctctctttCCTttCtCttttTctcctttttttTtttTTTctCcTtCcttcTCtC	DA==B>B>BCBBEGGFEDFGCFGGGDGDDGDECFEDDEDFFCHEECGDFGDD>DDC?EDGEGDFGCGGEFDGCDEGDGGADDGDGFFAGGGGFGFGGGGDGGGCFFGDFGGGFGGDDCGDFGGFDGGEBGFEADFE>FDGGGFFFFF5FGGFGDGFCGE:FGGHDGCCCFCFFFFGEGC<EGGFGEGEBBCCFFFCECFDFEFFFGGFFFFF::FEFEFEFF;DEEB@B=<>CAA?	T	137	C	99
17	78220304	G	128	GGGGAGAAGAAAGAAGAGAGGGAGAGGGGAGGAGGGGAAAGAAAAAGGGGAAGAGAAAGAAAgaGgAAAAAAAAaGAAgGAgAAGGAAgGGAggaAgaGAGGGAaaaaGAGGAaGaAAaaAaGGaagg	<BCCHCHICHHGCGFCHCHCCCG;H@>C?GCAHCCCCH;GCBHG>HCCCCDHCGB;HGBGGCGFBFGGGE?GGEFBGGGBGEG5BBGGFBBGDEEFGEBDAABFFFDEC@CCHEA?C;?<B<C?CC@:	A	70	G	58
17	78222064	T	47	TGgTTttTggttggtTttgtTtgTTggtTttGTtTTGTTTtttGtGg	@>C?<7@GFFE;FEEGEEFEF?GGGGGDGCDCGFGB7<GFF:8@DB@	T	32	G	15
17	78261805	A	37	aaAagaGAAGAAAAaAaaggagGGagGaAaAAaGGAA	AEDFCF>HHCGHHFFFFFCCGDC@GCBFGHGFGA:E?	A	25	G	12
17	78444658	T	44	TTTGGGTTGtGgggGGtTTTTtTGGGTTTTGgttGTggtGgGTT	GEGCC>;GBFCGFGA:EBFF8FFB?BFFEFBGFCBFGGC>FAFD	T	23	G	21
17	78519519	T	58	TcCTCTCTtTTCTTCTtTTcCCTCCtCttcTcTcTcCTCCTCtCTTCtcCCtTCCccc	BC?DGEGEDECGEEGECEDFGGEFEEFEEGEC@HDHFDFFA>EFDDFD;FFEDEAHB@	C	30	T	28
17	78938003	G	34	GCCCCCCCGgCCCCgCCCCggGGGGggGGggGGG	9B99?>?D6FC88@F?=C:EFB<>@BB>>@>CCC	G	19	C	15
17	78938011	C	40	CCCCaCCaccCCACCACacACaaCCCCACAcAAcCCaCCC	:EB@EBBEHHDBEFFEEEGEEEEFFEEDEDGD=D>A>CAC	C	27	A	13
17	78938204	G	129	ccGGccgggCgcccgggCGcggGGGCGgGgccgccgggCgcgcggcGgCcgcccgcccgggcGcCgcCcGGgcgggccggggGcgcCccccccCggcccgcccgcgccgggcgggcggggccccgcGgc	C?>=>@AAAACDDDDDDEDDFFDEEFEFEF=CFDDFEFGFDFDE@DEFFDEDDCFDDDEFFDFDFFDGDEEEDEDEEDEFFFEEGEFEEEEEEGFGEEE>EEEEE8EE?FGDGFFAGFFE<EEEFED>=	G	66	C	63
17	79082862	G	126	AAGGGGAAAAAAgGGAAAAAAGGgagAAAGGAGAAGGGAAaGAAGAGaAAGgaAAGgGAGGGGAAAAaaaAGAgaaaaaAaaagAGAaGAaGAGggGGaaaAaagaaAAgGGagaaAgGgGgAAGa	CGCBCCHDGH=HDCBAH@GHGCCEEFHA=C;HCGG:@=HHGCHCCHCGHG;GGHHCG:GCBBBGGGGEGFABGGFGG?8GGFHHDBGGBGGBGBBGBBGGGAGGG@GGGG@?GGEFHE>C?:CC??	A	75	G	51
17	79094672	C	67	ctcCcCTtctcTTTTCtCTCTTCCTTTtTTTtcTCCCtTCTTCCCctTCTTTCCTTcCtcTTcTCtC	@CBDADGG@GBGGGGDG7GDGGDDGGGHGFDGCGDC?GGCCCCCC@HEC;CECCFFACHBFFCCC@A	T	37	C	30
17	79139473	C	56	gGcgCGgCCCCCCggCGCCGcgGGCgGgGGGgCCccggCCcgCgccGCcgccgcgc	C?DFD<FDDDDCDEFDCDACDFABDFCFCCCGDDEDFFDDE=DFDECCEGC@FCF<	C	29	G	27
17	79140505	C	34	GCCCCGCCgCGgGCGCCCCGcCCCCCGCcCGCGG	<DDEDCDDGDCEBCBCCCCBFCCCACBCHB@@AC	C	22	G	12
17	79172711	G	75	GaggAgGGaaggaagaggaagagAGAaAAAaaagGggAaAAaggGgGAGaGgaAaGAaagaggggGggagaGaaa	CDDCDCHHFFBBFECFCCFFCFCEGDFCE<FEFCHCCEFDEFBDFDFEGEHDGEGHEGG?GDDDEGDDGCGGEC?	A	38	G	37
17	79173398	A	34	GGggaggGaGgagAgagagaGgaAaAAAgGGaGa	=<ABECBCFCCECGCFCGDGADCGFGG@DBBFAB	G	19	A	15
17	79202956	T	115	CcCttCCcCccccTTCcTcTTtcctTtcCcccctctcctccTTCTcccttccCtttcCcTCtcccCcctttcTtttccTCtttttCtccccTcTcTCccCtttTCccttcttTTt	AC<@B==@BABBBGGDAGBHGBABGGGBDBBBBFBGB8GBBGFDGBBBGGBB>HGGCDBGDHCCCDC?HHGCGGHECCGBFC=HGDHBCCCF:FCFC@CCHCHFCBBGH:B@AD?	C	63	T	52
17	79203052	T	44	tttTTttTTTTTTTTTTTTTTTTTTTTTTTTTTTTTTggggggT	?CC>>DE=>9;FE?CE=9D;>DDD>E;5EB<BCDDED:8DA?<C	T	38	G	6
17	79213504	C	31	CGGggCCGcGGgcCggcgGgccgggccccGG	CACEFDDCDCDFDCGGEGBFECGGFDEED>C	G	18	C	13
17	79227092	G	42	AAggAAaAgGaaGagagggAGagAgAggagaagaagGaaaaa	EE=@FHFCCCFFBFCFCBCHCFDHDEDDGDGGDGGABEDCBC	A	24	G	18
17	79409189	G	44	AgaaaAGGAAaAAGaGaAAAaaaaagAaaAgAGGGGGAAGAagG	@BFEDFEEFFBFFEFEFEFEFFFFFGE5FEEEADDDCEBDCB>C	A	29	G	15
17	79414897	C	71	CccCaacccacCaCccCAcaacAcaaaaacCcCAAcaacaCaacccAaAcccccccAaaaacaaaACacac	DAC@ADCEDDCECGDDGEDEEDFDEEECED=DGFBDEEDEEFDBEDE;DEECEEEEFFBFFEF;CEFFEFE	C	37	A	34
17	79422289	C	82	TTCTcTTTTCCCtCtCCTTCCCCTTTTCTCTTCCCTTCCTCCCTTTTCCCctTTcTCTCCTCtCTcTtTCTTTttCCcTCTC	@A@GDGGF6EDDEDE@DFGDD?DGGGGD=C@GDCDGFCDGCCCFFFFCCCBEFFEFCFACFCFCFCF9FCFFFF?C@<BACC	T	43	C	39
17	79424537	C	41	cccTctccccctcccTCtctctTtcCcttctttttttcttc	AEE;FDFFEEAEFFFFGEFDFEFEFGGF;GFFFDFFFFEFF	C	21	T	20
17	79427822	C	41	cCcctTCcCTtTttTTTCCtTTCTCCTTCTTCTctTCCCTc	C<B@GGDBCGGGGAGGFADHFFDECCF?CE@CFCHFCBBC<	T	22	C	19
17	79479469	A	95	CcacAAaccaacaccacaaCAcaaCacccCcaAcaAaccAAAcCcacaACCaaccaaCCaaaCaaaaacacaccaaccccccacccaacaacacc	@@@D?>@EEDDHCFGDGDDGFGDCFDGGGFGDFGD?DGGFFFGGGDGDF?FEDG<EEGGDDEFEEEE@GEHEHHEEGHHGHHEHHHEEAEEH>F>	C	48	A	47
17	79954544	T	64	AAAaaaaatATTaAaAAaaTaAAttaaaaaaaataaaAttaATatAatAtataaATAAtATAAA	BBHFEDFFBGGGDF@I:FFGFGGGGG?GFG>FGHFFGGEHF;FE>GEGGHEDGG?FGGHGCDAC	A	47	T	17
17	79977813	C	29	ggggGcccCgGgccCCCccgcgcgcCccc	C=ABE@BAGCGCBBGGGB=@BCBBCGCCC	C	18	G	11
17	80007307	A	334	GAaGGGAAAGaGaaAGgGGGGGGAGgaaAAGggaAgaAggaaGaGAGagAGaaGgggaAAGaAGaaGagGgaGGgGgggAaaaaGaAGAAgaAAgagAagGgAAaaGGgagggAGgAGAaggaaAGgaAgGGGagAaaAgagGAAaagaAAaAGgagagAgGgAAgaggGagAAAagGGGAGGgaGgAAAAgGGAGAGAAggaAGAGggAGGGgaaaAGAGgggAGggAAAGaggAGGagAGaAagaGGgagagAagaggaaAAgggGAGagAGAaaAaAAggagaGaaGAGGaAGgaGGaAAgaagAGagGaGAAaagAAagaagaggAgAAa	=:B;9:EEB?EAGEECECCCCCCHCFEEHHCFFFFFEHFF@EBFCHBFFHBFF=FFFFHHBFDBFF@FFCFFC=DAFFFIF<FECFHCGGFFHHFFFHFFAFCHGFC<FFGEFHCGCCHGF8FEG:GGH<CCCFEHGGGGGECGHEEGGGHGHCGFGGCHGCDFGGGGDCFFHHBB@AC?HACB:CEGHHHACBGCHBGGFGGHCHBGGHABBFGGGGBGAGGGGBGCGGEBGGGGBBGGGBGGGGGBAGGG=GGE>FGFFFBGGFFBGAGFEBGGGGEGGBDGGFBGG@EBBGGBCEBB;FFGGEGFAGFCF@EED=ADEB>AB7@?@@BC?D	A	170	G	164
17	80054375	C	91	ccCccaAaAAacaCaccccCaCacaCcaaAAACcaaacaaAaaCCacaccAaaccaccccaacaCaCacacccacacacCaacccaccaCC	ACB@ACAA?ABBCCDDDCCFEDDDEGDEEFFFGDE8DDEEFEEEGEDEDCFDFEDEEEEE@FEFGFGDEFEEEFDFEF@FEFEDE?ED?@B	C	48	A	43
17	80213428	G	134	gAAAAGGAGagGgGgGgAgGagagaGgAAAgggGggaAgggGGggagaagaGagaaaagAgggggaagagaAgggAgGggaaggGagAAGgggGaaaggggaggggagagagAaaggagaaaggaaaaaAgggg	CC;A@;=@<BB?DAGAEGDCDEEEEABHCHFEECFFCFFEECCEEEFEEFECDFDEEEDHFFAEEEDEEEEHGEFHGCEF@CF9B;GEGCFGGCFFFGFFGC<GGGFDFCA?GFFGGFGFFFAGFFEFFFECBB	G	78	A	56
17	80280865	G	318	GAAGggGAAGAGGgggagGaagaGaaAAGAaaaaGGAGAGGaggAAAGGaaAGagggGagGAGAGGaaAAAggGAGGaaagAAGgaGGagAGGaaagGGGGAAgAGgGaGGAaaGGAAGAAagagAAagAggaGAgAAGGgggaAAAAaaGggAAgaaGGaaggaAGAGgGGgagAaagaGgggagggAgggaaaaggggagagGgaGgggaggggggggaagaaaaggaaaaagaGgaaagGagaaggagggaaaggagaaaaaagggagagggaggaaagagagggggagggaaagagaaggggggagggaaggaa	@@@AAC:AC=C99@@@D@=@DAE?EEFFBGGFFGCBHCGACEBBHHGCCEFHBFCCCCFCBF@HCCFFHHHCBCHBCFFFCHGCCFCCFCHBBFFFCCCCCHICE>CDFACHFFCCHHCBGFCFCHHFCHCCFCHCHHCCCCCFGHHHGFCCDHHDDGBBFFCCFHCHCDB=DGDEGGDGCDDDGCDDH>DDGGGGC9DCGDGDBDGCD9DGDCDDDDDDGGDCG<F?CGGGGGDGCDGGGCBGDGGCDGDCDGGGDDHCGHGEGGCCDECFDDDGDDGGGAF@GD:DEDFDCCGEGDEBDC?A=>><<<AACDAA@C	G	169	A	149
17	80574615	G	41	ggCGggGcgCcgGggggcgcgCgcggcGgggcgcccgcgcc	?B:CDDFDEADECFEEFDFDEGFEFFDHGEFDGEEEGC<;<	G	25	C	16
17	80789468	G	126	AGGGGGGgaAAGAGgAGGaaAAagGGAgAGGAAgGGAaaGagggGGAgGgGAaAAAAaAaaAgGaAggAAAaAAGAgGaGgagAgaGgaGAGGaaaGGaAgggaAGGAGagGGgGaaggGAGAAgg	D=9<;AACFCHCHCCHCCFFHFFCCCHCHCCGHCCCGFFCGDCCCBHCCCB:G@GEHGHGGDDCGHDDFHHGHHCHDBGBDGD7DFBDGBGBA?HGBBEGDDDGGBBGBHCABDAFGDDAD>D>88	G	66	A	60
18	166819	T	60	tcTtcCttCCttCCccTTCCCTCctCCtCcCTCCCCTTtCTCCCtCtTTcCcCTcTCttT	CAGGBFEGGHGGGGBBGGGGGGGBGFGHGCGEGGGFFFHFFFFFHFHFFCFCFFCEEGGB	C	34	T	26
18	264012	G	50	AGGGAAGAgAaGgGAgGagGaaAGgGAGAgagGggGgGggaGGGGGaGGA	CC7CHH:HAHFACCGD8?DCGGH?DBGBGDGDBBD>=BDCFABBAAE::B	G	33	A	17
18	673086	A	43	ggAagAGaAAagaggAgAaggaaaaaagaggaaaagaagagga	@@@BDE5DFFDFDFFEFFDFFDDDAEEEDGFDEEEGEE?EGFA	A	26	G	17
18	688463	G	40	TTTTTGGTTGGGGTtGTGGGTGTGGTGgGGTTTGTGtGGT	<FFFFEEF=DDDDDHDEDDDEDEDDDDDAAECEDDDE@>B	G	21	T	19
18	2847744	C	28	TCTTTCTTTTCcTcTCTCCCCcCTTCtT	GBGFFDBGGFCEFEFCFCCCCECFFCFE	T	15	C	13
18	5630531	G	39	AaGggggAAgGGaGAaaggaAaGgaaaggggagaaagaa	BABCCCCEFCEEFCFFFCCFFFDCGFGDDDDFDGGFDGG	A	20	G	19
18	5891637	C	231	CcccCAaAcaAacAcaaAaacaaacCCACAaaCAacaaAaCCaAaCCAAACAAAAAAcCAAAAaacCCaacaCcaaAcAaccAcaAAAACCaaaAacaccccaaaacaCAaCACCaAaccACCacaCaCAAAcaCaCCCCAcCCCCcCAAaCCccCACACcaacCAAaACAAaCaAcaCCaAaaCaacAcCaCcacaaCAaCAccAAaccacccAccCAcCCAaaCcCAcc	BCC?99:BCGFEBFBFFEFEAFFEBGGFGFFFFFFBFFFFGG>EAGGFFFG7FFFFFBGGFFFFFBGGCFBGEB@FFBBFBCFBFFFEFGGFFEFGCGCCCCFGGGCGGDGG<GGGDGCCFGGECGGFGFFFCGGGBGGGDCFGGGCFEEGDFACFEFEF:GGCF?EG>BEEG=CECGFFGEG?FGG@ECFGF5GCGGFEGFECCEDGCCGCBBECCFDBFGCDCA<B@<@	A	125	C	106
18	5956425	C	101	ctCTtcCcctctTTtcCTCccTTTtcctcctTtCtcCcCCctTcTtCTCccTcTtTtTtcttTTctCTTcTTTCtcttCTCttcCCttTTttccCCcccTc	??BAA@BBBDBEEEEDGFFDDFFFEDDEDDDFEFEDGD6FD?FDDFGDFEEFDFEFFFDDEEFFDFEEECFFFFFEFFDDFFFEFEFFEEFFEEFE@EEE@	T	53	C	48
18	7024345	C	33	CTCcCCCCCCCCcCTCCCCTCTtTCTCCCTCTC	BDGBGFCGGGGGCDDFAFFDFDHCFCDFCDDA@	C	24	T	9
18	7026187	C	28	TTcTtCtCCtTttcTttcTtcctccttt	ADBEF6GGGCEGEBGG=CFABCHCCEAH	T	18	C	10
18	7034464	T	62	TTATTTTAAATATTTAAAATTTAtATTTTTTTAAAAAATTTtTTTTATTaAAATTATAAATT	E8FBGGCEFEEFFGGFFFFFFEFFEFFFFFGFEEDEEEF=FFFDFFEFECDEDGFFBCC<BA	T	36	A	26
18	8784721	G	185	TGGGTtTGTTttGTTGTGTTgGTggGGGTTGTgGTTTGGGGGtGtGGTGgtGGGggtTTGgTGGGtGTtGGTTTGTGtGtTTTGggGGggTGTTGGtTGGTtggggTGTTTGTTtgtGGTgtttGTTTGTTTgtTgGGTtTtttTGTgGTGttgtGgttTGTgttgtGGtggGGTGGTttGgGtg	;ACEEAFE;FGGEFFEEEFFCEFCBEEEFFEEDEFEFCEDDEHEHEEFEDHDD9DDHFF?DEDDEHDFHEEFFFEEECDHFFFEA7EEDDFEFFEEHECDEHDDDBFEDEFCECHDHDDEDHHHEE=ECEEEDIEEDDEHEHHHEDEDD>DHHDHDDHHEDEDHHDHDDCDCCCDDCEGHD@CB>	G	93	T	92
18	8786117	C	34	cccCcCCCCcccCCCCCCCAAAAAAAAAAAAAAA	EDDDECD8DEEEC@CCCCCFEEFFDGFEBCDCC?	C	19	A	15
18	9888069	A	39	aaAgAaAaGaagGaagagGGAAgaaaaaGGGGGgGgagA	DEDCEFEFGFFCGFFCFCG@FFDFGGGGFFFFFDE>D8?	A	21	G	18
18	10691192	T	28	GGGTTTTGGGTGGTGGTTTTtTTTgGtG	7GGEGGFGGFGFGFFF@FFFDFFFEE=C	T	15	G	13
18	10696227	C	66	cCtttctctccCTcTctTttcCCTtcTTTTccctCcCcTCCCCCctCCtTTCTtctTTttCCTtCC	ADGHGBGBFABGGBGBGHGFBGGGGCFGGFCCCHFCGCGGAGGGCHFGHFFFEHCHFFHCFBD>AA	C	34	T	32
18	10741011	G	86	AAgaGgAGAGGaGAgGGGGgAAaAGggaAaAggGaaAGGGAGaaaGggaGggAGgAAGGgAaaGggaggagaaAgaagAaAGggag	B9AC=CFEFE;FEFCEEEECFFGABDCFFGEDDEGGEECEFE<GGEADFEDDEDD?EDDDEGGDDDGC8BDHEEDGGCDGED@@A>	G	46	A	40
18	10752666	C	139	CtCtTccccttCTCTTTCccctCtctTCcCctCtttCTTtCcCcttTTcCccTtCTCttctTcCTTccCCttctttCcTtctcTCTtcCCTcccctttcCctttcTTtcCtccccCTtctCCcccTccCccTcCTcTcc	AB?CB?>ABGFGGGGGEGBBBGGGBGGGBGBGGGBBGGFGGBGCGGGGBGBAFGGGGGFAH@CGFGBCGGHHCHHHGCFH@CBEGGG@GGECBCCHGFCFCHHHBFEHCFHCCCCFFGCHFFCC?FCCFCCFBGD@B5<	C	77	T	62
18	10759935	A	65	GAgAggAGgaGagAAgaggagaGGGAgAAggGGgGAAgAaGgAaGggagagaggggaaaaagaag	CAC;GEEGFDCDFBFFDFFDFDHGGFFAFFFGFGGFBGBEGGEEGGGAGEGBGEGGEEEEDD?@?	G	36	A	29
18	10759961	G	46	AAaGGaaAAaAGagAaGgAaagagagaaaaggggaggaagggggga	B>DCCADFFDFDDFFC@FED<:>FECAEEEG9EGEGGEEAFFFBB@	A	25	G	21
18	11824886	T	54	GGGGGTGGGGGGGGTGGGTGGGGGGGGGGGTGGTGTGGGGTGGGGTGGGggtgG	H@IHHEHHHHGHHBEHH@EHHGHHHGGGGGDGGDGDGGGGDGGGGDGFCBB?@?	G	45	T	9
18	12358661	C	26	CCCTCTCCCCCCCCCCCcTCTTTTCC	EGGFGEGGEFFFFFFDFHCFCCCCDB	C	19	T	7
18	12658600	A	123	AAAAgAaAaGAgaaAGagaAAaGAgAAAgGGGaGAgAgAgaaAgAAGGaGAaaGaAaaaagAAAaggGaagaaAgAGGgaaGggaAaaAaaAgaGAGGAgagaaAGggaAAGaAaaGagaAGa	BCBBDE@EDGEFDDFGDDDFFDBFFEFFFFGGDEGFFFDF@EFFFFEGEGFEEGEFEEEEGFF@EEFGEEGDEFGFGFFEEEEA9EEEFDDFEEFEFFDGFEDEEF9GDEEFEDEEEBB:AC9	A	78	G	45
18	12785944	A	104	GGGGAGGAGGAAaAGAAgAGGgAAaaaAAgAGgggggGaGGAagGAgGaAGaGagaaAgagggaAAgAgAGaaaaAaGGaaAgaaGgagAGggaaagAGGggga	@@ACEEC6GGFFDFGFEFFGGDFDDDDFFFF<DFFFFGDFGFEFFFCGDFGEGEGEDFGDEG=DFFGFFF?EEEEEEFFEEEGDEFEFB:FGEEEEGEFFE@@B	A	52	G	52
18	12788158	T	47	TttCtttTCccccttTcTCtTtcctCttcCtccctcttttttcccct	D?@F;DDGGFGGGDDGGGGDFDCGDGE?FGDHHBDHDEEEEEHHGHD	T	26	C	21
18	12982760	G	37	AaagAaggaaaaGGaggagagagaaaaggaggaaagg	@C?A@EFFDCDCHHDDFDFDFDFDDDEGGEGEEEEGG	A	21	G	16
18	13059326	A	129	AAggAaAAaGaAAaaaAaaaGgaGAggaGagaGGGaGaaAgAGggagGAgaAagGaAAGgaagagGgGAagAggaggGaaGGGaaaAAaggaaAAggAAgAgagggagaaggAaagAaaAgggaaggaA	?>@@?A@ADEGDEFEFFFFFGCFGFFFFGFFFGGGFGFFFDGHFFFFGFFFFFFGFFFGGGGFG>GGG?FGFGGGGGGGFFFGGGGFFGGDGGFFGGEEGEGEHHGGGEGGGEGGGEGGEGGGFGGCBA	A	72	G	57
18	13100451	A	94	aggAAaGGAGaAGGGGGGgAGgAaaGGggaGagAAgagaggagaGggagggGGAgaagaGggGaaGgAggaAAgAagagggaaaGagagaAggG	CCB@>EGG@FDEGGGFGFFFGFFDDGGDFDGDGFFDD@DFFEEDGGGCFFGDGEFEEGEGGGGEEGFEFGEEFGEE@EEGGEDEFFEEGEFB<?	G	54	A	40
18	19075808	C	90	CtccCtctctttccccTccTtctcCTttcCcTccCCcCTCcttCCttccttTTTcttTcctCcccTCtctTtctcctcccttctttcctc	=ABCBDEEFEEDFFF@EAFGEFDFGGEEFGCFCFAGGGGG?EEGGFFFFEE@GGFEFGGGFGFGGGDEFFFFFFGGGHFFFFGFFDE;?D	C	49	T	41
18	21759593	T	31	TCTTCCTCCCCCCTTTTTTTCTTtCTTTCtC	EGEEDGE:GFGDGE@EEDCDFDDHFCBCFHF	T	18	C	13
18	23865851	C	209	CtCtTCCCCCCCCCTtTctCCCCcTCTCCCTCCTTCCTcCCtcTCCCCTTCtTcCCttcCTcCCTCtcccTCcttCCTTCccTcccTCCTTTTCtcTcCCTctccCTTccCCTCctTctCTTtTTctTCtcTcctcTTccCccTTCCcTCTcTTTCCcccCTCTTCtcctCtctTcCTCCtctTCCCctcCctccCTTcCCttCcTCtT	B@?CBC?@DFCFFFEGFBGGGGFBFEDGFGBGCDDGFFBAFGBBFEGFFF9GFBFCGGBEFBC?FGHCB@CGCHHGFFFFC?FCBCEEFEFEF@HBEBGGECHBCFFFABGGFGCG?BGFFDHF=CHBFHCECCH?EECCECCEEFECEEDCEEEFFCC>FEFEEFHBCHFHCHECFEEEHCHEFDECHCECFCCFDDAFFF@C=AAB?	C	124	T	85
18	23873463	T	36	tCCTCCtCcTtCCctcCTcTtttcccCccCCcCccT	DGGGFFDGGGDGGGDGGGHEDEEGGHFDH@FCFFHE	C	24	T	12
18	28737407	G	99	GAGGGaggGGAAGgggAGaAGAGAGaAaGAGGagGAgaAAGAAGaGGaggAGGAgagGggGgGAaGAAaagggGgGAGGaGGAGGGAgAGaGAggAAGA	@?=?ADFFEEFFEFFF?EDFEFDGEDFDDFEEEFCEGEFFEEFEEDEEGGEEDEEEEDGGDGDEEDEEEEGGEDGDEDDEDDECDCDEDCDDBB??AA?	G	58	A	41
18	28898201	A	71	AGAGAAGAGgGAGGAAAAaGgaGaAAAGGGgGGaGaaAAAGAaGGGaaAGGgAGGAaAaGAGAAaaAGAAA	FDFEFFEFEGBFEDFFFFD;FCECFFFEDCGDDCDEEFDBDDEDDDECEDDGDDDEEEECDCEDDDFDB:B	A	41	G	30
18	28913599	C	136	CcTctCtcCcTCTctTCCCttTttTTctctTcccCcccttcCTttcCTTCCCCtCcCtcctctTcCTCCccCttCTttCCTCCTTtCCcCTTccTTtTtCCcCCcttctcCCccttttctCcCcCTcctCctTccc	9?>@EDECEBCGFBGEFFFGGBGGECBFBGEBBBEBB=HGBFBGGBGAF>GEBHFCGHB@HCHECG;FFACFH=GFHH@FE=FE@HBD?EED>CA;HDHFECEECHHCHCEEBCHHHH=HE?FCEDAAGD6A?@@@	C	78	T	58
18	29496218	C	26	CCCCCCcCCTCTCCCTCcCTCCCTTT	GGGFFGGFFEFFFFFFEGFDBA>?AA	C	19	T	7
18	29800119	A	30	aGAagGgagaGagaGAGAGGaAgagGagAA	ECHFFCFFFFCFGFBHCHCCEHGGGBGGFB	A	15	G	15
18	30846895	A	31	TAATAAATAAATAAATAatAtAAAaTaTaTT	EEC8EEEDD;DCDDDDDFF@FDDDBCBB?A>	A	20	T	11
18	32455379	T	149	ccCTcTCcccTCcCTtTcctCTtcTCCttTCTCtttcCTcCCTTTCCtCCTCCctctTtCttTcctcccTcccCTctTcCTtCCTTTttcTCCctccCtTctctctCtcTccctTtCCtcctctTtctTCttctTTTcttcttctTccc	AC@=?B@EEFDGFEDDEFFEGBEFEGCEDDGEGEEEFGE7GGEEEGGDGEEGGFEGAEFFFFEBGFGDGEFGGGEFEEFGEFGGEEEFFBEGFGFGGFFDGFGFFFFFG9GDGEDFDFFGGFGEDEGFDFFFGFD<DFCDCDABB>B?@	C	76	T	73
18	32470459	C	63	TctCCTTccttttcccCcttcttCCTtCtcTtTtcccTcccTctcttCcCttccttcttTccc	BCFGFFCBBEGGGBBBFBGGBGGEGFGGG@DGFHCCCFAACFBHCHHECFHHCCHHCHHCC>>	C	32	T	31
18	33721376	G	101	CGcGCgGGGGCGCCgGGGGCCCggCGGGgGCGGGCCGggCCCccGcgccgccgcccGgggCcggcggccCcCcgggcCcGAcgGcGggcggccggGgggcg	BBC@A@>@??BDEFB<EEEEGFCCFEDD@EGEEEGFECDGFFCAECCBCCCC?=CCDDDDF;DDCDDABGCECDD@AECDECDDCDDDCD:=@DDDCD@>8	G	56	C	44
18	33779855	C	214	TctTTCCCtTTCccTTTTCttCtCCTTCTtccCTCTTTTTCCTccTCCCTTtttccCtcCTcTtCCTCcCTTCCTCCccCtCTCCTCTcTtCcTtctCTCtTCCTCtTTCTcTCCcCCTcCTtTctCTTtccctTCtcTCtcCCCTtTtCTCttctCcCTTCctTTCtcCcCCTcTCTTCtTcTTcCtcTCtTTTtCTCTtCtccTCCTCccTc	CCC>BBBBCEEGCCGGEG@DEFE=FGGGG==DGGGGFGGGFEHDDGGGGFGEEEDDGCCEGBGEGFGGDGFGE6GDGEEGEGFGGGGFEFFGEEEDEGGGFGGGGGEGGGGEGG7EGGFDGEEFEFFFFFEEEDFFFEFFFEFFDF:FFCCEFF?FFEFFFFEBFFCDEFEFFEEFFFFFFFEFEDFF<EEFEFFEFFCDABA?9?8AC7@=C;	C	108	T	106
18	33783030	T	186	CCCCTTCCCCTTCCCCTTCTtCCTTTCCCcTCTTCtTTCTcTCTCTCtTcTTTCCCTTCtCccCCCTTCTTTtCTTTTTTCTCTCCTTcCcTCCTcTTtTtcTttctTTTTtTTCttttCCtcTTcctTCCcCCCcttcTctctCTCtttctCTtcTTCtccTTcTtcTCTcTCTTTccTccttcc	B@DCDEGGGGEEEGGGEEGEGGFEEEFFGBFFEEGGEEGECEGEFDGGECDE<EGG9EGHGCBGGGEEEEEEHGDE;EEE;EGEGGEEBGCDGGCCEDHEHCCHH<HDDDD?DDFHHHH<DHCCDACIDFFCFFFCHHCDCHCGFDFHHH@GFCHCDDFH?CDDCDHCDECCCEDDDBB@=>@@@@	T	100	C	86
18	34340486	C	77	CGCCGGGGCGCCCGCCGGGGCGGCGCCCGGCgCCcGCcCGGCcgCCGcCCcGgGgGGgcGCgGCGCCcGgCGcgGcc	FEGGEEEEGCGGFEFFEEEEFCEFDEFGEAFGEFGDFGFDD7GGEEDEFFGD@DFDDDFDFGDECCCDAA=AB?CDA	C	39	G	38
18	34647322	G	132	ttggggGGgggGgggtTgtggggtGgtgtgtttTGgTgtGgtTggtggGtgtggGTttTgGtTTTTttgtgtTttgttggTTgtttttGtTTGTGtGTtgtTtTgtgGgGTtGTttgttgTggtTGttgtTg	ACC???>@BBBEDGDH@FGDFFFFEFFFGFCFGEEEFFGDFGFFFGFFEGFGFEEBGGAFEGFFE@HGFGE;FGHGHHGGCCGHHHDHEHF=EFEHEEHGHEHAGHGDGDEGDE;HGFDGEGGHEDHHFDCB	T	70	G	62
18	34647323	T	127	AAtaaTatagGagaaagAagagagggGAaGagAagGaagaaAgagaaAGggGaAgGGGGggagagGggaggaaGGtgggggAgGGAGAgAGgagGgGagaAaAGggAGggaggaGaagGAggagGag	BACDBBDE@CFGDFFFBEFBDCF@CCHF9HFCFFCFFFCFFFCFCFFGECBECFCGGHHCBEDF=HDCGDDEGGGHDDDDDFDHHFDFDEHDGDGDGGDGEGEGBCEGEDGDCGGGGDGDDDGDGDA	G	70	A	53
18	40554120	A	70	agAAGaaggaGGAagaAAaggaaaaAaGaaagGGaAAgaaAaaagagggggAaggaagggaggaaaAgag	AFFDEEDFEEGDDEEEFFDAFE=DEFEGEEDFGGFFE>EFBEBFFCDGGFFFEF9FFFEGFEFFFGEFE?	A	41	G	29
18	42533315	T	94	TaTaTtTTaATtaTAaaTTatatTtaTtttAtattTAtAtaaTtTTtatAttATtTaTAaaTATTAATtaTAttaaTAtaattTTtatAATaAa	@CEEFEFEFEFEFFFFEFFFEFEGEFCEEEFFGEFAEFCF:EFFFFFGFFFFF@F=GEFGAFFFEEEEFEEEFGEGEEFGGFFEEFGFCEDBC@	T	54	A	40
18	43247784	C	47	TTTCCTTCTCCCCTTTcTCTCTTtTttCcTTTCCcTCCCtCtCTCTT	GGGDBGGDG7DDDDGFBGDGCFFHFHH@BCDFCCCFCCCHBGBC@CC	T	26	C	21
18	43328295	G	130	AGGGGAGgaAGAGAGAaaGAggGGGGGaGggAGaaGGGAGaggAGGggAgGAAGgAAggggAaGgagaGGGGaaaGgaAAGGAgAAGAGgAGaGgGGAAAaAggggGaGGGgGagAGgAaaAAAagAgGa	CCB:B@ACGFFEGFGFFEGFFFGBGGGFGFFFFCFFGGFGFFFFGGFFFDGFFGFFFGEGCFFFGGGCFGGGG@GGGEFFGGFDFFGEFGFFFFAGFEEEDECGDDF<F;F<FGDEFGEG>EEEE@DE>=	G	75	A	55
18	43435738	A	27	CccccCCccCAcaCaccaccccaaaca	@GGGGGGGGGFGDGDEH>HHHGEEEG@	C	19	A	8
18	43508800	G	43	AAAAAGGAGGgGGGGAAGGgGAAAGAAAAgGAGAGAGGaaGaG	>E<E9HHEHEFGHHH7DFGGGDEEGADDDFGCFDHEGEBBD?C	G	22	A	21
18	43666952	C	53	ACAAACAcCACAcCcCAAAaCACCAAcAAaaCcaaCTccACacAAaCCacACA	>ADEE<EFGDFEFGFGEDEEFEGGEEFEE@GDGFGF<GGCFFGDDGFFDB>CC	A	28	C	24
18	43670051	T	40	ttttttTTTTTTTgggggggggggggggggggggggtggg	BCDCDFCC>DED@@CCC:@A<>B<7DCDBCC8CC??7@C9	G	26	T	14
18	44126909	T	217	TtTCTCcctCtTTTTTtcttCCCcCTTccttCCtttTCcTCtcCCtcCCCTTCTTTCCTCTCCCcctCCCccCCctCctTtTCcCTccTccCttTCTCccCTCTCctcTCtCTcTTTCtTTCttCCccCtttCCTtctCTTCtCCCCctCtTTTTTcttTcccttCTTcTccTcCCTcctcctcCtttttTcTtTTtcTCTtCtccTCTtCcTCccc	D?@<?=DDACEFEGGGDFDDD@DFDGGCFCCD:CDDFDGFDDGDDCGDDDGGDEFGDDGDGCDDGGDEDD>F=DGDDGDGDGDGDG@GGHGDDEGDGDHFCGCG::EEGDE@GHGGGDCGGDDEDDHHDDEEDDG5HEDGGC<DCCCHDCEEFEFFHCCFHE;EECFF=DGGFBCCFHHDHHDHCEEEEEFHFEFEEHECFEBDCCECFDCDCABCD	C	112	T	105
18	44526798	A	28	CAaCCCCCCCCAAACCAccAcCAACCAc	DEEGGFGFGGFDDDFFDEE@EFDDFECC	C	18	A	10
18	44595809	A	77	TATAttaTattAaAaatTaTttTAaAAaTTtaAATtAttaAAAatTtaTAtTtAtaaaATaaaATaatttaAtAtaa	=AEEEEFFFEE<FEFFEBFDFEBFFFEEABFGFBFFEEEFEFFGEFFGEDFEBEFHGGDEG@GEEGG:EFGEED??@	A	42	T	35
18	44610718	T	98	TTCTCTCCTCTtTTtTcCcCtTTCCCCtcCtTTtTctTTTCTcTtCTTTTTCCcCCCTcTTcctcCCTctTTTTCccTtCTtTCTctttTTTCcctTT	B>?AGEGGCBEEEEEDFGFGEEEFGGGEFGECEFDFEDEEGDGEFGEEEE<GGGFFF<GDDGGFBCFAEFDDCDFGGDFFDFDFDGFFFDDCEGE>@C	T	57	C	41
18	46196865	C	25	aAACaACAcACAAACAACAACCCCA	EHGDFHC?EFCGGGCGGCGGCC@AB	A	15	C	10
18	46576238	T	139	CctcCCctTtcCTTCTCccCccctCtCttTCttttCCcTtCcTtcTcccCCtctTcTTCttctcCCccCCcccctcTTCctCCctCTTccctTCTccttcttCTctctccCCtcTttctctctCttccCctcCcctttt	D:A=@A?E;GB;GGGGGBBGBBBGACGEG8GGGGGECBGCHBFGBGBBBGGCBAGBGGGHGBHCGGCBGGC<CCHAGDECHGGCHG@GBCCGGGG9CHHCHHFECHCHBCCFI@FHHCHCHCHDHHA@FCHBFCBHGC=	C	79	T	60
18	47013723	A	87	aTTaaTATTAATTTATTATaTAAATATTAATTtTTATTAAATATTTTTTAATATAAAtTAaTAtttAAtaTATaaATATTTTTAAtt	CFGFFFFDGEFGGGFGFFDFFF<FFFFGFFEGCGGEGGEEDFEFFFFFFDDFDFEEEGFEEFEFHHEEHGFEFGECGDDBAB???EC	T	48	A	39
18	47339798	G	25	ggaGaAAggagaGgAagGAgGaGgA	?EDEDFFFDAFDEEEEGE<GD?DGE	G	14	A	11
18	47800179	G	174	GcGGggggcCccGggcGcgcCcgccGGcgCcgCgggcCgCGCGCCGCcCgCCCGcCCccccCGGggCgggcCGCGCCCgccggCGCCgcgcggCgcCCcgCcGgcCGCCGGCccGGGGggCgCgGgGCgcgcgCGgggGCccGgcCccccGGcCCGCCGGcgcgccgcgCCGgg	B?>>?7@@@CCAECCBD>CBDB?BB9CBCBBC@CCCBGCGEGEFGDGBECGEGBCGGBBBB>EEDCGDCBAGEGEGGDDCCDDGEGFDC>CCDFDCFFCBFCDDCFDEEEEFBCEDDDDDFDEDDDDEDCEC>FDDDDDFCCDD@FC@CCCDCFFDFEDDC@BB?>?><>@@?<	C	91	G	83
18	47908556	G	38	ggaGGaagaaAGGGgggAGgaGgAgGaagaaggAagAg	>AEBCEFFFEHDCCFFFG:GGCGHGBGGGFGGGGGGGD	G	22	A	16
18	48326378	G	48	TGTGTTGGGGgGGGTggGTTTGTGGTTTGgTGgGtGGGGTTGTGGtgt	DFGGGEGGEFF@GGB=EFGGGGGGFDFFFGFFFFEFFEFFEEFEG?B8	G	29	T	19
18	51804259	C	100	cccctcTttttctttcccccttccTTcttccttctTccttttCcccCtcttTtCtccttCcccttCttcccctcccttCtctctttctccttctttccct	??DDADDBBC@HDDDFFGGGDDFGGGGDDGGDDGDHGGDDCADGGGDDGDDGDDDHHDDDHGGEEDEEHHGGEGHHDEDEHEHEEEH;HHDEHEDEEA<?	C	50	T	50
18	51807123	T	116	ttCCCcCctTCCCcCtCCcTcCTCCcTtTCCctCTcTttTTCtCtTTcTCTCttTtTTTCCTcTCcTtCctCccttcTCcTcCtTttcttCTctCCCcctcccTCCctCCctttcc	CFGFGFFFECGFFFGEGFFFFFFGGFEEF;FFEFE?EEEBFFFFDFFGEGFFFEFFFFFFGFGFEAEFDGDFFGD;GEEGEGFFEBFGFFFEGFFEFGFFFGBDDFGFDEFEB??A	C	63	T	53
18	51858197	A	172	GGAaAAgAGaggagGGAggaAgaAGAGgGgaaaaAGAagGggAAaAAgAaGAagGggAgAAGgGGagGgGAaggAgggaaAGAagGaGgagAggGGggaaaGggGGgGagAgGgaaaggaaggaAgAgaAaAAGagaAagggGaggGaGaggaagaaaaaaagaaaggaagg	=B>AABDEEDEFEEGGFFFEFFEEFEGFGFDEEEFGFDFFFCFFDFFFFEFFEFHDEFEFFGFGGAEGFGFEFGFEFEEEFGFFFGCGGEEFFFGGDFFFFGGFGGGFEFFFGGDFFGFFFFFFFGFFDEFEEFFFFEFFGCFFFEFEF@FFEFGEFFFFFFEFFFFF>FEE	G	89	A	83
18	58290330	A	38	taTTataaTTaAttatttaAaatttattattatttaat	?>ABCDDDEECEDBDBDDDECEEEDEEEEEEDEEDEEE	T	22	A	16
18	59285628	C	42	GCCCCCCccCGGcCGcgGGCcggCCCGcGCCGcCcGgccCgg	@@EGFGGDDGGEEGFDFGGGEDDFGFFEFFFFEFFFGDEF>9	C	26	G	16
18	61383354	C	88	cccTTTTCCttCtcCTCCCCtTctCCTTcTccCTcTCcCcTtTCtCtTTCCtcctTTCTccTtTTTcTcCCcCTccccTCCCCCCTTT	CA?DFGGEGGGGGBAGHGEGCGCH@FDDA:>BGECGGCGB>GBGEEHGDG9GBBHBGFFCBFHFFFCF7FFCFFCCCCBFFEEEGE??	C	49	T	39
18	61570470	T	44	gtttgTgGTgtgtTgggttTggTtGttggTtggTtTttTGTTTG	C?BCCGFCGFEFEHF?GFEGGGGF=FFGFGFGGFFFFFFBFCCC	T	26	G	18
18	61570529	C	43	ggcCccCGCCCGCcgCCCGCcgCcCccGgGCccGGcccCGCGG	BEDGDDGEGFGHEBGFGGGGDFFBFECGFGFCEGGEEEEFFGD	C	28	G	15
18	72020475	T	85	TCTCTcCtCtTCCCccCCCTCTTcTTTCTCTCCCCCTCCTTTCCCcCcTCTTTCTCTTCtCCTCTCCTccTTTCtCTTcCCtcCC	EDEEFFGFGFEEEGEEGGGEGEEFDDDFDFDAD??FDDFDDAFFFGFEDFDDD;DFDDFF=EDFDFFBGGCDBEEFEEDCBA8CC	C	49	T	36
18	72167124	C	25	GCCGGCGGCCCCGCGGCGgCCCGCc	=DDCCDCCCCCC?=B@CBGCAA9@A	C	14	G	11
18	72347482	T	43	tccctcttTCttTctCctcTCTTCcttTTTCcTtctCtTCTct	?DE;EAEEEGEEEFEGGEGEEDEGGFFEECFGCFGFFCDECC=	T	25	C	18
18	72593097	G	38	agaaagaaggaaAgaAaggaggAagggaggaggaggaa	A9@BBGEDDDAEEFEEEBFDFFFAGFFFGFFG8<FF<;	A	20	G	18
19	327998	G	77	TTGTTttgGgTGtGggtTttTtTTtGtggggggtgtGTtGtGGtttgggtgggGgtTttttggttggGgggTgtttg	B><ABEECECFEGECCGEGGCGFFGEECCCCDC:CGEEAEGDBHHHDDDHDD8ECGFAHFCDDHHCDDBDDDCGEDA	T	39	G	38
19	498524	A	59	GAGAgGGGAaGaAGgaGgGGgggGGGaAGGAGaGgGgAgGaGgaAgAGgaaggggAGGG	>;AHCCCCCFCFHCC=BDCBDDCCCCDHCAFBGBD@DGDBEBDHGDGBDGFDDDDFBBC	G	40	A	19
19	507450	G	32	TgGTGgTgGGgGGgTggggtGtTGTTGgTTTG	FCFEEC<CEEDEEDDDDDDHDHEDEDDDEDB@	G	20	T	12
19	582927	T	79	aatAtaAATtATaAtATtAttaaTtTaTtATtAataAtaaaatatTAATaAaTTTAaAaAAtaAaTAaTaaaatattta	=ABACEEFCEFEFFEFFEGEEFEFEFF@EFAEFEFGFFGGFFEFCBFFEGEGEDEFG>G=EDGEGEEGEGGGGBDCCB@	A	46	T	33
19	643380	A	37	aaaaaaaAAAAAAAAAAAAAAAggAAAAAgAgggAAA	?CDDEEBFFFDEFFFBCEEEEE@AEDEED5C9=<AA?	A	31	G	6
19	687112	G	118	AGaaAgAAaaaAgGGaggAgaGGGGAaggaaAGgaAAgaaAgggggggAgAagaAAaGgAaAAggaGaaaggaAaGGaAaaagaagGaGgagggaaggagagaaagggaaggaggagg	B;?=ABDBDCDFFBCE>EHEEACC:HEFFEEHCDEHHFEEH=BFFEEEHDDEFEFHEDDGEHHFGDCEFFDFBHFCAFHBFEFEEGCFCFFFGFF;FFFGFGFFFEFEFFFFEGC?BA	A	62	G	56
19	695455	C	32	cgGcgCgCgCCGccGcgcGccCCccCgCgcGg	C?CBCDCDCDDCBBCBDCCCCDDCC@DCDCB?	C	19	G	13
19	813220	T	50	tcCcccttCttTTttttTccCctcctttccttctcCTTCctcTtccccct	A<CDCE;DGE:FFEEEEBDDCDEDEEFEEEFFDFEGFFFEEE<FDDDBE?	C	25	T	25
19	1036631	T	83	CttTcTTtTTtcCttCtCTcTCtTTCTTtctcTcttTCTCCTTtTctTcctctTttTtCcttCCtcctctctttttCTTCTtc	CFGGAGFFGGGBDGGDGDGBFAGGFDBCGBG;GCHHGDGDDGGEFAHGCAHCHBHHFACCGHCCFCCHCHCHHHHHCFFCEH;	T	53	C	30
19	1042850	C	29	TcttTTtttccttCtTcttCTtcttcctc	BA@DGGEEEDDEDGEGD=FFFDEFEA<FB	T	19	C	10
19	1044712	A	25	GAgggaggggGaggaggagagGaga	@CFFFEFEDFCEE>FFEFGFGCFEB	G	17	A	8
19	1062164	T	104	TcTTtTCCttTCCTTTCCcTTCCtCCTtTCTCTTTCTCTCCTtTCCTTcCTccCTtTCcCTCCctTtTcCTTcTTCttctcTtttCCCTcTTcTTTtTCtTTTt	ADGGEEGGBEEFGGEFHGDGGGEEGEGEGGGGFGGGGGGGG<FFFGFFEBFEEFFEFFEFFFCEFFFFEFFEEFFFFFEFEEBFAEEEECEFDFCDCDA:?CB?	T	61	C	43
19	1065018	G	48	ggTtGGTTTggGTtGTtTgGTGTGGGTgTTGTTTGGTtTGGGTGTTGG	DFCEE;EFFFFEFFEFEF=EFDFDDDEFEEEEEEDDDFEDBDEBACA?	G	24	T	24
19	1065197	G	176	ccccGGgGgCgcgCccCgGgGcgcCGCcCCGCGgGGCCGgggCCGgggGGgCCCCcCCCGGGGCGggcgcccCcCGCcGcCcccggCcCcCcCGCgGGCCgGccggGgGCCcCcgcGgcGcgcggcCcGcgccgcGgcgGGgccCGGGCgCcgCgCgGgcgccccCggGCGcgCGC	ACC:<@B?9EDBCEABFBDCEBCBGEFBFDDFD=EEGGECCCGFFBCBEBCGFCFBGGGDEEEGECD=DCA6ACBBFC?CGCCC<D7CGCFCFEFDEEFFCDCCDD@D?DBCECDCEDCDCDCDD8ECDCDCCDCDDCDDCBCCDDACFDECDEDFDDDCDCA;CDDCEFE?BDBA	C	92	G	84
19	1089419	C	45	CTTTTTTTTCTCTTTCCTCtCCTcCtCTCTTCCtCCTCTTTTCCT	FEGGGFEGGGCFFFEFFFFHFFF;FHFFFFFFFACFEEEFE5B@9	T	26	C	19
19	1090877	C	73	ctCCttTcTtcCCcTcccCtctctctTtCCctCccCcCTTCTctcTCttCTctTTCcTCCccTCCTtCtTCCT	A??GFGFBEGB9ABGBBB?GBGBGBGGGGGCHGCCGCGGGDE5H:EDD@CFCHFFFCDFFB<FFFFHFHECCD	C	41	T	32
19	1128312	A	45	GggGgggaGGGggggGaaagaAaggaaaagaggGaaaggaggaga	7ABBCCCECCCCCCCCFFFCFHFCCFGGGDGDDCGGGDDGDDGDE	G	27	A	18
19	1231040	G	49	agGGgAAaaAggggaaGaAAGAgGaAAgGAAAgGAaGAGgAaaAaaAAa	C@BECFFFFFCCCCDGEGFEEDDCGDDDD9=ED<EFDEDDD<GECCB?5	A	30	G	19
19	1358726	C	80	ttctcTttTcCTcCtccCCTCCcTcCTCttcttTtctCtCttTCcCccTTTttccccttccCtttTctttctccctcctc	AABCDFDEGDDGDCBDDDDGDDDADDFDEEDEEGEDEDEDEEFDDDEDFAFFDEEEEFAEE>5DFFEFCFEFEEEEEDEB	C	40	T	40
19	1360575	G	134	GAAGaAagGGGgGgGGAGAAaGAGGAgAGAAAAGgAAAgAGgGAAgGGAGGAGGGGGAAAAaaGGgGGAAGAAAGAGGGgAAaGgAGGGGGGAAAaaGAGaAGaGaggAAAGAaGAGAAGaggGGgAGggAAGG	BBE>EFFCBGGCGCGFFGFFFGFGGFCFGFEFFFDFFFDFGCGFFCGGEGGEFFGGEDEEEGGFFDFDEEFEEEFEFEFBEEGFDEFFFFFFEEEGGFEFGEEGFECCEF5EDCCBCBBDA>?BC;?B<8ACCC	G	72	A	62
19	1366422	C	54	GgccgcccccgGgcgggcccggggGccgccgggGCgcggccgcccgggggggcg	@ACDFD?CCCEDEDFEEDDDFEEEEDDFDEFFFDFEDFGEEGDDEEFGFGGFEB	G	31	C	23
19	1383649	G	33	TGGTGTTGGTtGGGGGGGTTTtTTGGTGTTTTg	CGHEFEEHGEEHHH=HGGDDDFDDGGDGDDCCD	T	17	G	16
19	1389517	C	203	ccAAAaaccccaccACACccaCCCAcaaaCAaACccCCCAacCcaCcCCaAcAcAcCacCCCcaACACaACaccaccccaaACACACCAAcccCCCaacccaCAccaaAAaccccCccAaacAaAacAacCcAAaCccccCCaCAaaCcCCCaAaCCcaaAaACCCaACAaaCccACAccCACaccCCAAaaacACaaaaaac	ACC?=CCCCCDBDAHBHCACCDDDHDECBDEEGDDDDBCH;DDC><DCCAHDHA<DDEDDDDDDFDHDEAD=D;>@D>DCEHDHDH>DHGDEDBDDBAEDDEDGEEEDHGEEEEEDEEGDEEHBH=EFEDDEBDFDEEECDDFDGFEDEBDC=FEDC9EFGFGCC7EDCGFFCEE:CGEDCBCAEECCFG9C;CHBBA::>9B	C	111	A	92
19	1487083	C	121	CtCtCtTtcTCtTTctCCtcttctctttcTCCTCtcCTTtCCTcCCTtctttTTCTctCCtCCTtCCcTCTTCTtctcCTCcCCCTTTTCTcTTtCCtcCTTCctCCtcCTcCTtTCtcTT	:D@CDGBFAFDEFFAGGGFAGGBGBGGGBFFGEEGBG@DCGGACGFFGBHFHCEGF9HFFHGGEGFEC=GEEEEH>HCFEECFFECEEEDECEEHFEHCEDEECCFFFBED@GFADA@;CC	T	63	C	58
19	1531869	C	145	cctCCtCTTCctTcttttccCCTccCTCtTcCTCtTCtTTTTTtCTcccccTCTtcctTTtTTcTctTCttctttCTtCTCCtcCcttCccctcCcccccccttcttccttcCtttttcTTctctttcccctcCttttccctTcc	AC@B@CBCBD@H;AFFFFAAFGFBBFFEGEBFFGGFGGFFEFFGG=B@ABBFCEBBBGFFGFCBFBGEEEFBGHHEFHFFEFHCGCHGFCCCHCFBACCCC@GHBHHBCHCCFHHH:HBEECHCHHBCD5C;CFHHHHCCBFD?;	T	73	C	72
19	1986414	G	45	AAGAGAGAGGGGGGGAAAAGGAAAGGAGAGAGaGGGGGGAGGAaa	>FEFDFFFEEEDDDEFFEBEDEFEDDEDEDEDEDDDDD<EEBB<;	G	25	A	20
19	1986455	A	92	AAAAAGGGGAAGGGAGAGAGAgAAAAAAGAAGggGgagAGAagAAAGAgGGGGGaAGAAAAAAaGaAGAaAGGGAGGAAgaAAAAaAaaaAg	<5A@FCCCCHHCCCHCHCH<GFHH<HHHCHGCAEAFF>GAGFFGGGBGFBB?@BFEBGGDGGGFBCGBGEGBBBGBAGGE9EEDCAD=@?CB	A	55	G	37
19	2043209	T	50	TtTTTTTTTTTTTTtTTtTTTTTTTTTtTTtTTTTTgTttTggtgggtgg	A<CEFFEEEEFFEF:FCEFEFFFFFFF9BF8FFDFE8EFEEE@A8AD@C9	T	42	G	8
19	2043271	G	38	gGggaggAgaaaaagaaaaaaggagggggggaaagGga	BGCCFCCFCEFFFFCFEFFCFBCFACCDCDCGGGDFDF	G	20	A	18
19	2046325	C	81	TTCccCtcCTcTCTtctTTtCTcTCtTTTcCCTTcTTCTCCTTCTCTtTCCcttccTTcCTCCtTcCTTcCTtCtTcCCTT	@CECDFED?FD=FDEDEEEEGEEEGFDCAEGGEEDDDFEEGDEFCFDEDFFEFFEECDEFDFFFD;FDDEFCFDECAB>?C	T	43	C	38
19	2073354	C	44	CAACCCCACAaAAAACAAACACAAACCACaAAAACAACAaACac	BFFFFGGFGFFFFFDFEFBDEDEDEBDEFFEEDDECDDA=???B	A	28	C	16
19	2098743	G	216	GAAaGGAAAAAGAGaGGAGAAAAGAAGGAAaGAgAGAAAGAAAGAAGAAAAGAAAGGGAaGGGAGAaGgAAAAGGGGGAAGGAGAAaAAAGaGAAgAGAAaGAgaaagaAaggAAagggagagGAGAGggaAaAGGagGgGGGAaagaAAaggagaaAaaagGAGgggAAaAAaaaGaaGggGAaaaAGgAGaAAaAggGAAGaagGgaGagaGAg	@:>A?=DEFFEDFEFEAFEFFFFEFEFFDFEEFCEEFFDEEEF7FBEFFFEE8EDEEEFFEEDFEFGED7EEFDDEEEFFEEFEFFG7F8EGEFFDDEFDEDED=GGDFFGDDEEGDDDGDGDDEDEDDCC9GBDDGDDEDDDAHGDGDE=DDADGGEGDGDDEDDDDDEAEEFGFDGHDD:CEEGFDDDECFDCFCA@BCCBBA99>@B>=?A?A	A	125	G	91
19	2109071	C	84	CCtCCCCTCCCCTCCCCTCcTtcCcCTTccCctTCCCCCcCCCTCTTTtTcTTccctCTctcCTTTcTCCCCTTCcccTCTccT	A@E@DDDGDDDDGDADDGD8GFGCGDGGGGDGEGDCDDDGCACFC@FFFEHFFEGGFCFGFGCFFFFFCCCCFFCEFFDAEB??	C	54	T	30
19	2109988	A	63	AATaTaatTTTAttaaTaatttTaATaTTtTTtAaaTAAatTtaTTAtatataATTtAAtAAt	?DEF?FAGFFFFGFFFEFFGGGFFFFGFFCEFHFGGFEFGH=HGEEEHGH6HGEEEADDEBBC	T	34	A	29
19	2110019	T	55	ccCtCtCCcCCcTttCTTtcCctCCTctctctTCCcTTcTTcccCTCcTCCtCtc	CC@EGEFFAEEFFEEGDEFFGFFGG;GFGDGEFGFDEEGDFGGGEEFCEFEFD6F	C	33	T	22
19	2118692	C	136	TTTCTTCTCcCCcCcCTCTTCTTTTTCTCCTTTCCCCCtttTCcccCccCTCTCCCtTCccTtTcCcTcttCCtcTCtCtCTccCccCcTTcCTTTTcCTCCCccTCccTTtTCTttTTcttttCCTcTtctCTtc	?A?BFFDGDBDDBDBDCDHGDGGFGG>GDDGGGDDDDCH;:GDCCCDCADGDGDDDGGCCCGEGBDCGCHGDCH=FCHCHCFCCCCCCCFFCCFFFFCCFCCCCBFCC@FFHFCFHCEFAGGG9CAC>CC>@CCB=	C	72	T	64
19	2121316	C	75	tTttcCcttcCtttccTcctCTCtTcCctCctTTCttctttTtccccctccCctcCtcttctcctctcccctctt	C5ACHDGDDGDDDDGGEGCBGFFCFGC>DGGDEFGEBGDDEFD:HHGGEHHEHEFGEGEEHDGHEHDHHFGEHD?	C	39	T	36
19	2123328	A	40	GGgGGgaAGAAaAagAGgAaGAaAGaAGAGaGGaaGAaGA	?GFC<FFFGFFFF=GFGGF<GEGE=GEFEEGFFGGFEFEC	A	22	G	18
19	2123516	A	32	gGaaGaagGGgaGgGaaagggggagaggggag	C;BDCDEFCCEECFCFDEFFFGFFEEFGFFEF	G	21	A	11
19	2132362	G	60	aGAGGGAAaGAAGAGAGGAAAAGGGAaaAGGaAAggGGAAAGAAAAAAGGGGAGgAAgAA	FCGCBCHGFCDGCHCHCBGGGGBB=GGGGB5EAGDDBBFGGBFFFGHH@?@>D@?8C??C	A	34	G	26
19	2253082	C	55	cttCTTtccctTTccTTTTCCCtctctCtCctCCTTttctcttttccctccttcc	CC?EBEEDDDDFDDDGAEFEFFEEECEFFFEBGGFFFFDBBFFE9EEE>EEDC?B	T	29	C	26
19	2253590	C	41	CCCTtTcCtTTctCCTCCTCTccCCcTCcTTtcCTtCcttc	FFECGFBGGEDBFFGDGFEDDCCFFCDFCDDGCFDEFCHHC	C	23	T	18
19	2271741	G	119	GGGAGGGAGAAAAAGAAAGAAAGAgAAGAGAAGgGAGAAAAAAGGaGgGGAGGGGaggAggaGGAagGAGAAGAAaaAAGgAaAAAAGgAaGGgAGgAgGAGGGGaAGAAAaaggAGGa	==AEDEDFEFFFDFEFEF8;CFEFFEFEEEFEDGEEEEDFFFEDEFEFEEFEEEEGGCEGAFDDDGGDEDEEDEEFFEEDFEEEEEEDGBFDDGEDFEGCDCCDCCE<>>B@@?ACC?A	A	62	G	57
19	2280885	G	33	AagAAGAGGGgGGGAGAGGagaaaAagAAaAGg	BFC@GEEAEECEDEFEFEDBDGEGFGDBEEC@?	A	17	G	16
19	2289962	G	64	GAAGGGAAAGAGGGAAGaAAGGGAAgAAGGGGgGGAAGGGAAGagAGGgagAGGGGGgAGAGaA	DFEEEFEBFC6EAEFB?GE=DDDEEDEEDCDBDDDEEDCDEEDGD;6DDGDADCDCDC;C<<=<	G	37	A	27
19	2290870	G	156	CGCgcgggCCgGCcccGCcGgcccgGccggcCggCcgcGGcCGcCcgccccggCcCcGggGGCcCGCGgGGGcGcGggccGGgGCcgGGCGGGGGCcCgCgCCCgcCgGCGCCgGCGcCGGgCGCgGCcCGCGGcccCggccGGcggGgCGCGGCg	A@AAC?=@??B?@@AACDBCCBBBCCB@C>BDCCDBC>CCBDCBDBC?BBBCCD=DCCCBCCDCDCD=DBCCCCCCDDCBCBDADCDC:>CACCCD@DDDDCDDD=CDBCCCBDBC;DCBBDCBCDBCCCABBAACCBCBAB@@?@@?>A>A:>CA	G	80	C	76
19	2339773	G	123	AGGAGGGAGGGGAGGAGAgGAGAGGGGAaGAAAAGGGAAGGAAGGGGAAAGAAAGGAGAAgGAAAGAGGGAAGgGAGAAGGAaGAGaaAGAgGGGGAGGGAGGGGagaAAGGGGAagAGGAAG	C7BD=6AHB7C<BBCHCGF;HCHCCCCGF?G:@GCBCH@CBG?BCBCGGGBGGABBGBGGGAFFGBBBB@GGB>BGBGFBBGGBFBGGGBGGAAABGAABFAABCE?CDC9;@?8;8@ACCCC	G	69	A	54
19	2340046	C	96	ctttTcTctctTccTTtCTcTTTTCTcCcTTCcCCCctTTTtcTtTtCTCcccCTttTTcTttTTTTTCCcttCTcTCCTctcCCCCCtcTtTTcc	?BBEF@EDEDEFDDFFEFGDFFEECEDFDFBGEGFGCFFFFEDFFEFGFFCEEFEFDEEE?DFEADEEF@EFFEEEEBFEEBEEFEDD5DEEBA@B	T	53	C	43
19	2761603	C	69	CcCTctcCtTcTTctTTCTtCttCtttCctttTcTcctCTcctcttTtctCtttctTctTccctcTcct	A?==EEDDEFDGBDDGEEFECEEDEDEDDEEDCE>DEFDCEEFEFFGFE<DEFFEFFCFFEDDEEFA?>	T	39	C	30
19	2767192	G	45	tGGgggGGtTggtTgTTtTggGGttTtgtggtttTtttgTtttgt	C;=CBCCCGGCCGGCFGDGCCCCGGGHCC@DHHHFGHHDFHHHDA	T	26	G	19
19	2917287	C	156	CCCCcAAAaacaCAaccaCaCCcCCaCACACCAcAAAaAaCAAAacCccaCacccAACCACacaCCcCAcAAccAaaACaaCaaCAccCAaaACcCaCccccAccAaCAAccCaAcACcCAcaaCacAcAAAAccaCAaCAAcaaacACcaCCcca	>DDB@A>>CCDDFEDDCEGEGGDGGEGFGFGGFDFFF>EEGFEFEDHDCEGEEDDFFEGDGEDEGG;GDDBEEEEEFFG;FGFFAFEEGFFBFGEG>FEEEEFEEEEFEEEEFDEEEFE6EEFDFBEEEEEEEEEFFEBFEDD9EECDBAAAA>>?	C	80	A	76
19	2997976	A	51	GgAAGgaaaAgAgAagaGggGaaggaagagaaagagggGgAaGaGAgggga	?FFFGFDDDF=EFECDDGFGFAAGEEEGEGEEEEEAGGFGBECEFEGGGF@	G	27	A	24
19	3110349	T	111	GTGGgggTTtGtGGttTtgTttttGgGtTTtttgGgggTtttggGtgTGTTGtTggTgtTgTtgggGGGGGGtTggtttttTtGttgtggtggtggttttgtgtttgggtg	@C<;BBACD=CGB=GGGGCGEGGFCCAGGFGGG@CCCCGGGGCCCHCECFGCFFCDG?HABG@DDDCCA;CCGGCDHBHFHEHCHGDHDDHB@FDDCCEFDHDHHHD@??A	T	58	G	53
19	3119406	G	55	GGGGGGttttTGtgTggTtgggGGtGggtGGtggtGGgttggtGtgtTgTGgggg	B=?5EEGGEGFEECBCCEGCCCFEGECCGEDCBDBDEDE;DDHE@@HCDDDDDC>	G	35	T	20
19	3434413	C	88	CGGCCGCcGGCgGGGccGggCGgCggCGGcCcCCGGGGGGgCcCgGcGGggggcgcGCccggGcggGCccCCccgCggCggGcggcgG	<CDEGHGDHHGFHGHDDHFEGHFGFFGGHEGDGFHBGHHHFGEGFHEGGFG>GDFEGDEEGFFEGGGFEAFFEEGFFFBGFGCFFBBC	G	51	C	37
19	3589339	G	39	AGAAAAGaGGGAGGGAGgGgAAAAAGGGAgGaaGGGGGG	AEEFFFDGEEEFCEDFEDDB<DEEDDDDDDDFGDDA@@A	G	23	A	16
19	3653525	C	164	TctcTTTTcCtttTcccctcTctcTTCtccCtTTttttTCCtcTCtCTtTttcCTtTCttcTCCCtcttcccttttcccTttcCctTTcttTttccctctCtCtttCccctcTTtCCccCcctcttcccccttttcctccCTtcttcttCttTtcCctCtttct	DAC<BAAA?@EFEEBAAAGAGAGBDGDGABDGGFEGGGGDAGBGCEDEGHGGBEFGGAGGAGDDDGBGGBBBGGGGCC>FGFBDCGGGBHGDHHCCCHCHBHDHGHDCCCHBG:GDDBCCCCHCCHCCCC;HFH>CCH;C=FHCHHAGHCHHFH?C@HCHHH>B	T	89	C	75
19	3784893	G	56	GaAagAaggaAGAaggaaaAAagaaaagagggggaaaAggAAaAGGGaGaaAGAGa	???ACDCFFCFDEDFFDDAFEDFCEEAGECGDEGEDDFFGE:BD7DDEDC>EDDD>	A	34	G	22
19	3820191	C	110	TCCCCTCTCtcCcctCTTccCCTccCCCCCCCTcCtCcctctTTTccCTtTTctcccTTTccttTCTCTccTTtCTTCCTcTTTCcttCTCCttcttcttttcttCCTtc	ABEEFCEEGGBFBBGE>:BBGE@B@EGGF>GF>BEHFCBHCHFFFCCFFHEFCHCCCEFC=<FAFG@BFC:EECA@FFFECEFFGCHHEEEEHHDGHCHGFGCHFCB@C@	C	58	T	52
19	3831449	G	25	gaggggggaaaaggggAGAGAAAAA	C?8@BCCCFFFDCDDCCCDBGGGAC	G	13	A	12
19	3958324	C	39	GCGGCCGGGGGGCcCCGCCGCCCGGCgGCcgGCGGCCGG	EG@HGGH:HHGG?EFDGFFGFFFGDFFGEDFFEEEB>AC	G	21	C	18
19	3963744	C	63	CGCCcGgccGcCcCccgCcgggccccccgGggGcgggccggcCCgccggGcgGCgccgggCGc	A><>C?FFF=EDFDFFFD6FBFFFEFFFFCGFCGCGFEGGGG?DG9FGGCGGBCGHEGGGCAB	C	34	G	29
19	4297925	G	39	GGCCGCCCCGGCGCcGGGCGcGGcCGGCcCGCCGCgCGC	CGEE9AGFGGFGGGGGGGFF:FGGFFFFFFFFFFFGECA	C	21	G	18
19	4297968	C	77	CCTTCTCcTTTTCTcTTcCTTCcCTCCTtCTCCtCcTCtTtCCtTCCcTttcCCtTccTTTTctTTTtccttTctTc	@8?BCGDBEGGGDGBGFBAGGDBDGDDGHDCDDHDCFDGFECCGGCCDFHH@CC?FCCCFFFCHFBFHCAEGD=AA;	T	42	C	35
19	4323511	T	67	CtttttttttttttttTTCTTtttttTttCTCtttCttttttTCttttttttttTTTTtTttttTtT	>B?B>FECEE:EEE=DB7?@?E<FDFAFF>D6F<EBEFFFF;C7;EEFFFE<FC=FEAEFEBC<B@D	T	61	C	6
19	4323571	C	77	cttccttctctctcTttTcctttCtccttcTTCTtTcTtTCCCtTcctTctTCCtctcccCcttcCttTtTttCttc	CEEDDEEDEDDDDAB6FEDEFEEFEEEFE>DDGEFEEEFEGGGFEEEEDEFDFFFEFFEEFEFFEF<FDEDFF><@;	T	44	C	33
19	4475362	T	122	TTTTtgGTTtgGGTggTTGgttGGgGTGTGtGtGTTTGGtTTgtGtGtGtGgTTggTgTgtTTtTtTgttgTGtGTtttttggGtggTTGgtgtGTtGgGtTTgGGggtggGgggttgTTgG	?BE9DFHEDEEHHEF7EEHFEEHHFHEHEHEHE:EEEGHEEEFEHFHFHFGGEAGAEFEEEEEFEEEFFFFEHFHEFEF@6GFGFFGDDGGFFFGDEG5GFDDDGFEEFGGFGFFFBFDB=B	T	63	G	59
19	4510723	G	143	ggaAggGAAGAAAaagAagagGAAAagAAAaaGAAgGgGAGaAaAAGAaGaGaaGAaGAAGaAggggaGGaggGGGGAAggAaAGAAAAagAagaGGAaAAAggaGAAaGGGGGaaAGGAAGGgaGggaAgAGaGAGgGGGAa	?BCEEDEFFEFFFEEDDEFEEEFFFEC@=FAEEDFFEGEFEFFEEEEFFEFEFFC@FEDFEFFEFFD@EEFGFEEDDFEGGEFFDEEEEFFEAGFDDEFEEEGFFDDDFDDDDDFFEDDECCD:ECGFEEEFDDCDB<@ACC>	A	77	G	66
19	4538599	G	42	aGgAgaAgaaaGgaGagaaGggaGgagaGaGGaAGaAgAaGA	C=8ABFECEEFECFEFCFFECDGEDGDGEGEE<EEFEDEB@C	A	22	G	20
19	5212311	G	112	gagagggAaGGaGaAaAGAagggaGGAAGAGGgAaaGGAAGgaAaGAgAGAGGAagaGAgAgGGAaaGGaaGGgAggGAaAAGAaGAAgaaGAAAGGaaaAGAgagGAGgAg	<?@BDCCHFCAFCFHFHBHFCCCFCCHHCHCCDEGGBCHGBDFHG:HDHCHCCHFDGCHDGDBBGGGBBGGBBEGDEBGGGCBCGBGGD>?AFFG=AGFG5@DAD?>C=>?A	A	58	G	54
19	5220436	C	39	TtCcCtCctTttccctttccctcCTtcttttccttctcc	@B@>6HEBGGGGBBBGGGBBB=CGFGBHDHG:CGHCHCC	T	20	C	19
19	5223018	G	45	GGaGGGGAgGaAAgGaGGgGAAgGAaGGagAGagAAGGGGGggGA	BBFCCCAHCBGHDD?FCCDCHHDBH=BBFEGBGDGBBAB???=:C	G	29	A	16
19	5264967	A	55	AgAGAGGGaGAGAGaaGAAAGGaGAgAGAAAGAAAGAAAggAAAAAAGGAgaGGA	EF6BHC<CFCHC?C;@CGHGCBC=GGGAGGGBGGGBGGGGEGGGGFG>CG@?C??	A	32	G	23
19	5778517	A	151	AtAAAAAAttaATtAATttTttttaAtaatttaAaaaaatAaAtTtTAAaatTttAaatattataAATtAttAtTTaaTTAaTAATTttaAATtaaAaAataAaTaAAAAAataaaAAAaTAAaTTATAATTTAaTTattTAttAATATAa	@?A?@BBBDDC?DE@FFEDFECEEEFEDDEEEDGDDBBDEFDCEFEFFAEDFFEFCFDFDF9FEFFEFFFFFFFFEFFEEFFEEEEEFFEEDEBFCE=EFFFEDEFEDEEEDEFEEEE8EEEEEEEEEE8DDEDFDDDDBEEEDCCCAB?>	A	86	T	65
19	5783634	T	65	TtccTtCcTCTtcTcccttCCCcCTCcTTtctccTTTctTCcttCTcTCTCCcCtCtCCCTTCTC	@B==BECBGDGFAGBBBGGDDDCDGDCGFGA>CCGFGCHGDCHDD@;EDG@DCCHC5CCCFEBFB	C	35	T	30
19	5783700	T	31	tTTTTTTTTTTTTTTtTTTggtTgggggggT	DAC;>GE5FFEFDEE:BAD>D;E=C8?DC9D	T	22	G	9
19	6187805	G	133	CCcgGgcgggccGggCgCccgggggcGgCGggGcgcggCCCgGcCCcGgggcGcgCGgcgGcgggGgggCGccCcgccGGgccccCGGgcccccCcgggcCGCcgggCGGgcccCCcgGggccGcCccgGGGg	BBBA?DGDFFGGAFFGFGG<FFFFFAHFGHFFHGEGFFEGGFHGGGG;FFFHHGF>HFHGHHFFFHFGGFHHCGHGHHHHGHHGHGHCGHCHHHEHGGGHFGFBGGGFGFGIHHFFHGGEGH>GHEFFFDEEB	G	71	C	62
19	6418142	C	136	CttttCTCcTctTCTCtTTcccTCtttcctTTtctttcTtttctttTcTtCCCtcTtTtcctttTCtcTccctctCtttCcctttctttctccttcttTcCtctcccCCcctccctTtTctccctcctctcctctt	A<A7C>A?BDCFEAGCEFGDDCGDEEEDDEFGEBEEEDHEEEDBEEDDGEDDDEDGE9EDDEEBGDDDGDDDDDA?EEEDDDDEEDDDDEEADFEED9GE;EEBEEED7;EBEEEDFEGDD;EEEEEDEEEEEDE?	T	75	C	61
19	6475613	T	215	TctcttttCTTCcTcccTcCctccCCTCTTTctctcccTttTcccccCTTTTCCTctctCTCtcttTctccTcCttTcCtTCTTCttCTtTctTCtccCtccCtcCCCCtCcctttCtTtttctccTTTtcccTCcTctcccCCctcCcCctCtTtCtccttccTctTCCCtcTCtttcCTtTcttTtttCctCttctttcCCcccCCttcTCcC	@CC???CBB@@?B?BCBB<EDFEDEF>FF>E;DDCCDDEEEEDDDDDGDFFFEFFDEDEG=FEDEEFDECDFDFEEFDDCAFFGGEEFFEFEEFEEDDGDDEAFBGFFGFG9DDDEEFDFFFEEEEFEFFEEDBF9FEFEEEFFE7DGECEFFFF@FFEEC?DEEE?EFEEEDDDFE?EFEFECCEEFFDEEFFFFEFEFADDDDCDC?A@AA=C	C	112	T	103
19	6477256	G	50	GTggGttggGttTttgGgTGGtTGgGGGGttgGGgGgTgggtGgGGTTgg	BDCCEGGCCEGGBGGDEDF?EHBCDAEBEHHDDEDDDEADDGDDDCFB<A	G	33	T	17
19	6678474	G	54	gagaAAgagggaagagGAaaagGAagggagAgggaaggaGAaaagAgGggggaa	CFBFEFCFCCCFECFCEEFFFCC@FDCCGDFDBDGGCDGEFGGGDEDDDDDDGG	G	28	A	26
19	6696557	C	116	cGcccggcGGggcccggGcgcGcGCccCCGCggcccgGcgGgCccgccgcggccGgccgCCGcgcGgcgGGgcggCcgGcggcCcGggCgCCgggGGGcgGgggCgGGGgCgCggG	C>BCCCFEBCDFDDDFD;DFDCDCDDDDDCDFFDDDFBDFCFDDDEDEF@GDEECEEDFDDCEGECFEFBCEEFGDEGAEAGECEBFGCGBCFFGBBBEFBGGFCGAABF@@?>>C	G	66	C	50
19	6696691	G	55	ggTGttgtTtTgGTtggttTGtttGGtTggtttTtGTGGgtGtGtTGggttgggt	==EEGGCGEGCCE=GCCGG@FGGGEEGACDHHHFHDFDDDHDHDHEDDDHHCA?C	T	30	G	25
19	6702246	T	60	CTTctTcCtcCcTcTTCTcTtCCtTtcTTTtCtTctTTctCtttCTtTtTccTTttccTt	>FFGDEFFDGFBEGGFFEHEDFFDE9HFF;EFEFHE<DHEFEEEFCEEEEEHEDECFC>B	T	38	C	22
19	6702598	G	122	ggAGaaAgggGAagaggagGgAGAGagGgggaaagGaAAAAAGgaAgagaaaagAgggaGgaaaAaGgggggaaggggaaaAGggagggagGaAAaaggagAaaagaggaaagaagaaagga	CC<@DDCCBBCDFCFCCFCECFE:EFCECCCFFFCEFFFEEFECFFCFCFFFFCDCCCFEDGGGFFE<DD?DGGDDDDFFGF9DDGCDDGCEGEEGGDDGDBGEGBGDDFFGDGGDGFG>BE	A	62	G	60
19	6718078	T	53	TTTTGGGTTGTTGGTtTtgGTGtTttTTTgGTGGTGgTGTTTTTGGTTTTGTt	B@EAFGHEEHEEEHEDEFEGDGGBFFDDDFGDGGDGFDFDCCCBHEBBBBEA@	T	34	G	19
19	6732018	C	290	CCCCTtcCTTTCttCCCtCCCCcTtCTCtTCctCccTCTTTTtCTTTCtttCcTCCcCCTctCTCTTTTCTCttCCCTCTTTTTTttttCTTTcTTTcTTtcCCTccCTCCTtTtTCCTCTtCTCCCCTTCCTTCCCCTCTCTttTTTTTtCCTTTTCttTCCtCCTCttCTTCTCCTTCtTctTCCTtCtCTTcTCTCTCtctctCcCCttCTCCCTctctcCTtTTCcCccTTTtTtTCCccTCtttCctccTCTtccTTcCtcctTccCTCttCcCctcTTTTtcct	AA?<?B=@CEGDGFDDDGDDDEBEGDGDGGBBGDBBGD?GGGGDGGGDGGGAAHEDADDDBG8GDBGGGDGDGGDDDGDGGEFGGHGGGDGFACGEFCGGHACDGCCDEDDG@GHFDBECG6DEDDDDGGDDGGDCDDFDADFF@AFAGGGCCDAFFCHHFDCHDD<BHHCFFDFCCFFCHFC5FCCFHCH@FF6FCFC7CHCFCHCCCCHFCFCCCFCHCHCC;HFFCBCCBFFFHFHFCCBCFCCHHCCHCBFBF>CBEFCCFCBGFAABEB?B@==>@=AA??A><?	T	154	C	136
19	6732241	C	198	CtccccttcccttcccctttccttCTcCTtcctcTttttctctcTCtTTttCccctttCCCCTttttTCCttttCcTTCTCctCCCcCtCCCccTCTTTtcTTTCTcTCTTCtctCtcTTcTTTCTTccCcTTtccTccTCTCTCCctTcTTTTcttTTTCTcTTCTCCCTTcctCTCTTTttCCcCCTCTTtcTTCc	AAAA??AC9AC<DBDEEEDDDCEDDGDDGEDD?DGEEEEDEDE@GDEGBEE5DDDEEE9DDDGEECEGDDFF7;DEGGDGDCFDDDEDFCCCEEGDGG?FDGGGDGDGCGGDFDFCEEG@EFFFCFFEECDFF?BDEFDFCFCFC@EFEEFFFCEEECFFCFEFFCFCCCFFAEFBECFFFF@CCDBBD@CCA=ACCB	T	104	C	94
19	6743626	C	62	CccccccCccCCcccCcCCCCCCCCCCCCCCCCCCCCCCCCCCCCgCCCgggggcggggCCg	DAAC>ABE<76F?<AF7FGEGGCFGGFFFFGEFFFCEFFEFECDD5FAECAD9D6DA>;BAA	C	51	G	11
19	6743634	G	61	CGGcccCCCGGCCGGCCCCCCCCCCCGCCCGCgCCCCCGCgggGGGGGCCGCGCGGCCGCG	@BAAC?EDEEEF@DEG?FBFFF>FFFEFGFDA=EFDEFDE>7?DCCCDDDDDC=AAB=>@C	C	37	G	24
19	6759631	C	146	cCTtCtcTTCctcTTcctctCTTTcctTcCtcCCTTccCcCCtcctcCtcCCTTTCCCcCTTCCCtttcctttCccctctTttcccCTTCtCTcctCCctCccCCcCCcCtCTTTctCCCTTtctcCccCCcttTCcttcCcccCt	C<BCCEBFGDAABGGBBGBGDGGGB:GGBDEBDDFGBBD@DDGB;GBDGBDDGGGDCDBDGGC@DHHHCCHDEDCCCHAHGHHC6BDGGDHDGCCHBCBHDCCCCCCB<CHCFFACHCCCFFFCGCCC@CCC?HFC=HHBBCB?AB	C	88	T	58
19	6760974	T	95	ttcctcCtTCttcttcCCctctTTCcCCcTtcttCcCtcTTcttCCTcTcCTtcCCtCTtTTtcctcTTctccctTcctCcttcTtTtctcttct	C??CBCCDDFEEFEEFGEF>FEFEECGGFAEFEEGFGBF5EFFEGGEGEGGDFBGGFEAFEE@@FFGDDGFGGFDAGHFDGFFGDFDFGFGFEE@	T	49	C	46
19	6833989	G	38	TgTggggtGTtgTgTTgttgtGGtttGtttgtgggtgg	=8ACCCCGHEGCFCEECGHDHGHGHHGHHHDHDDDHB@	G	19	T	19
19	7117487	C	44	tccttccCttcctccccctcctctctcctttcTtctctcctctt	ADFDEGGDDDGGDGGG:GDGGDGDGDGHEEEHGEHEHEHGEFCD	C	24	T	20
19	7543297	C	46	tTCcTTCTCcTtCtTTtcCCtCtcccttTctCccCcctCCcccTCc	@@BADFFFFBFGGGEFGC@8HFBCC@CHECHFCCFCCGEECCCDF@	C	27	T	19
19	7619338	G	39	cGcgGCgGGGCgcgcCGCGGGGCCGGCgCGGGGCGCCGc	A?GEEEFD?D?GGGFGDFDDDDEFDDFGFCCDCC@@A@D	G	23	C	16
19	7619700	G	29	aAgGGAAgggGAGGGAGGAGAgGAGAAGG	DCCHHEEBDD7?;GGC>GDFDDFCFDDGA	G	18	A	11
19	7626669	G	112	AaAAGgaAaaGgGGgaGAgAGGAaAgaagAGGaGaaaaAgaGagagAGggaaaggaaaggAaggaaaaGGaGgagaAagaagagggaaaaAagggAgagaagggggaaggag	AED@BCFHDECBCCCF?HCHCCHFHCFFCHCCFBBFFFHCFAFCFBHCCCFFFCCFFFDCBFCCGGFECCGBDGDGHEDGGDGDDDGGGGHGDDDGDGEFDEEDCDD=>?B=	A	60	G	52
19	7675917	C	100	GgGCGGGCCGCCGgGCCGCCGGGCGGgCGgCCGgCCCGGGCGCCCGCGGGCCCCGCCCGgCCcccCCCgCCGGGCcGgGgcCgccgCcgggcCcCgCggc	?CGCHGHGGHGFHEH@GHCHIHHGHGGGGGGGHFGGGG@GGAGGGHGHGHEFFFGFFFGDF<FFEFFFGFFGGGFEGGFGEFFEEFFEEGFEFEFEC?B=	C	52	G	48
19	7682402	A	108	CCaAAAaaCaaaaaAAaAaaAAaaAAaaaaaaaaaaaaaaCaaACaaCAAaaCAaaCAaCCaaAaCAaAaCAAAAAAAAaaaAAaaaAaaAAAAAaaAAAAAAAAAAA	;<CB5BFD77@EEB:GD;E?:=ED;FB>EFEB6EDEDEFA9?FG9EF?H;FF:ABED==@8;=F::;FHF;GFGGGGG?EAEGGFCFGCEGEFEHDDADDDBBCCBCC	A	96	C	12
19	7682408	T	119	tCCtttCtttttttTttttTttttttttttCtCCCtCCttttttttttTttTtTTtTTTtttTTtttTttTTTTTTttTTTTTTTTTTTtTTTTTtTTTTttTTTTTtTTTTTTTtttT	C>;:>DAEEEEDEE>@DEDCEEA>EDEED7D=@>?89?:EFDBFFE<@G9EDDFGFDFAF<FFFBFEFF9DFCFFFFF=FE?EFFFEFFAFFFGF?DDEEBADCCCD>B<C?DDDA>8C	T	110	C	9
19	7688798	C	27	cCtccttTttctctttcCtCttttcct	AFFBBGGFGGBGCGHGBGFFFHHGCCH	T	16	C	11
19	7710210	A	37	AggaagAaaaGagGaaaaagAaAaGGaAgaAggggaa	@@BCCBGEFFCFFCFFFFFFFFHFCBEHD??GGGGGG	A	23	G	14
19	7712425	G	53	cgcGcccgcCggggCcgccggccCCcgGccggccCGgccCcGgggggcgcccg	CACBGFFFFFFFFFFFFFFFFFE=AFAEFFFFGFFDGGGFGEFGDGGCGHHGD	C	29	G	24
19	7743879	C	41	CcTTTCCTTCTCCtCcTcCtCcTcCcCCTTCcTtcTTcTTT	7AEEEFFFFFEGFGEAB@EHFCE?GCFFEE:CE>CEECDBC	C	22	T	19
19	7755159	A	39	GagagGgAGAGgAGGAAGAgAgAaGAaaAAggAAGgaaA	BD8EFEEBEF@EFEE:EEFFEGEFDEFFEEGFAE6FFEA	A	21	G	18
19	7755285	A	114	gAaGAGAAGGaGGaAGGGGAaAAAAaGaggGaaAGaGAAAGAAAGaaAGAAAGAGAGaAGgGAAagAAAAgGGAAaGggGGAaaGggGaAAgagaGAAaaaAAAAGGAaGGGGG	?CFBGC;GCCFCCFHCBCCHFHHHHFCFD=BFEHCGCHHHCHF@CEGGBGHGAGBGBGGBDBGGEDGGG:DBAGGGBDDB:GGGBDDBBGFDGDGAHD?D7DBCC=<BBCACC?	A	65	G	49
19	8386367	C	57	CcTTttTttTCCctccccTctTtcccCCcctcTttcttTtcccTcTcttCccttcct	A@B<A=ACCEDDDEDDDDGDDGEDD;DDDDEDEEF@EFGFCEEGDGDFFCEFFBEDA	C	29	T	28
19	8555886	G	279	GCGCGGGcCCCCCGGggCGCCgcgGGGGccGGgcCCgCGGCGgggGCGGCCGcCCGGGcCggcCGGGcCggggGcCGccCGCCccgggcgggggCgGCggcGGggCCggGCggGGGGgggCGgCCCccccCGGgGcgGggcgCggGcgccggggCggcgGCGgcgGgCccCGcGCGcgggCggccggcgggcCGggcgcGgccCccgggcggcGGccggggggcggccgggcGccggGgccggcCGCgGgcccGggccccCggggCGcCGGcGcggCgg	79<?ABAACACCFEFEFFEGFFDE?E9GDCGGFDCGFGGFGEFFFGGEGG@GDGGGGGDGBEDGEFGDGFDFEGDEED@EGGFDDEEFDFEEEFGFFGFF=GGEFEED>GGEEGCGGGFEGGFEGGEADDF9G7GDFGG7EFFGFGEGAEGGFFGGFEGGGGGEBGFGEDGFDGGFEFFCGDGDEGGEEFFEFGEF;GEGEEEFEEGGFEFFEFFEEFGGGGBEGFEEFFGEFEEEFFEEEGGF=FDGFF=EEFEEEEEEFGGFDDFEFFEDGCFBADC	G	164	C	115
19	8619461	A	66	GAGAaagGGAAAagGgaaagAGAaAAagaaGgAAAGGGAAgAGGAaGgaGGAGAGAGgAAgGAGAa	@@=CDGBAAHHCFCCCFFFAGBGFHHFCEGCDHHG:BCGFDHBBGGBD=BBFBGBGBCFBD?@?B<	A	36	G	30
19	8808942	A	154	GGgAAaaAagGGAgagagAGGaGAGagggAAAgAaaAAGGgaAAgAgagGAaggGAaaGAgaAaaAGaagagGAGagAgaGGaagagGaGGgaaGGGaaaGAagggAGaAGaagAAAaGGaGGaagaaaAGagAAGaaaGggaAGgaaaAAGgg	B@B:=<<ACDCCEECECFCEDCEFEDFEF;BEFBDD?EEEFDFFFEFDFEEDFFDFDC@EFCFDD<DDEGDFEFEEGFGEDDEEGEGEDEEGDEEEEEEBEFAGGFEEE5DEEGFEAEAEEDD@FFECCEDCEEBDEEED=GAEDE;A@BA9>D	A	84	G	70
19	8962315	C	29	CACaCACCCACCcCAACCcCACacCACcc	9CCEDHDDBHDDDDHHCCECGBBDCGB<=	C	20	A	9
19	9068530	C	174	cttctCCCTCCtTCTTtCTtCtCtcctCCTTtCcTTctccTcCCctcCtcCTTTCctCcTtTTCtctCCCtcccttccCCcccctccTtTTccctctTCtctCcttCTcCCttcttcTCCTtTtcTCcttcCTtctctccCtcccTTtTttCtcCtTtcCTctccctTCtCCtc	CCAAC@BBAAAB:EGFCGGDECGDGGDGGEGDGGGBGDGGGGGGGDGGCGDGEGGGDGGGDGGGEHEGGGEG@HEEHHEGHHCCEHHFDGFHHHE6EGGEHEGHEEGFHFF;EFEEHFFFFEFEGFFHE@H;FEHEHD@HFEHHHFFEEEEFEHFEDEHFBGCGGFA?A>?CBE	C	92	T	82
19	9083174	G	74	gGaaAgGAAGaaAgggAaGAAgagGGGaGAGgGggGaAAGaaGGaAgaGgaGgggaaGAGAgaAggaGgGGaga	C@EEFCDEFEFFFCCCFFDBFCFCEEDFE:EADDDDAEFEFGEDCD7GDDGBDDD?GD9DEDGEDDGD@BCAAC	G	41	A	33
19	9084183	G	83	AGGaAgGAgaAGGAgGgGAgGAAGaaGGGAgGAgAGGAagAaAGaagGGgagaaGggGAagGGgaggaAgGgGaAaGAaGGaA	D@DFFCDECFFEEFCCCEFCEFEEF8EEEFCDFDEEDFGDFGFEFFDEEDGD<GEDDDEHBDDDGDDGDADCDGEGCFFCBB?	G	46	A	37
19	9362443	C	67	ccTCttcCCcctttTtCTTcCCcctcttcttttcttttctcctcttttttctcttttccttcCcctc	C??:BBA??CBBCDGDDGGDCDDDCDEEDEEEEEEFF?EFEEFEDDFFDAEEEFFFFDEFDDC@>?B	T	37	C	30
19	10071347	C	213	CCCCcttcTCCtCTtcctTTcTcccTTTCCttccctcCCtccccTtctcttcCCTcTtttcctTTCTCttCcTTcTTCTCCTCTcTTCtCCttcttTcCCcccttctCtcTctttTCCttcCtCCCtCtcttCttTCTttTcttcTCCcctTTcTtcTtcTTCTtctTtCtCCCTCtCTcCCCtctcttttTccttctttTtttttTCctccc	@<BA?DE@CDAFFDGCBFFGBEBBBEGGGFGCBBBGBD?GBBBBGGBGBGGBGDEBGDGFBBG=GDGEDGGBGFBCGCG8GGGGBGGAHGFGHCH:FBFGCBCHGCGGHCDCHHHFCGHHCG@GGGHGHC;GFHHFGFGGFCHHCGFFCCHFFCFACFHBFFEFFCHFHFFFFFFFHFFCFFFHCHBHHGGFCCHHCFG;FGFDEBAC@E@@>	T	112	C	101
19	10132290	C	328	TCTtTTCCtCTtCCTTcTccCCccTttTtctCCCccCtttCCTtCTCcTCTCCctCCccCCCTttCtCCTcTtTCCTTctccCTCcttCTCcctCtTtcTtCCccTtcTCTTtttcctctTTTccctCttcctctccTCttCTtctTCCCctCCCTCCctTTTTccCCccctccCcTTCCCCCTTcCCCctctccTcccctCcctcCCCcCtCCTcCtcccccCCcTCTTtTtcctTttCcctccccctcCCTTcctcttCCcctCctcctcCTcctTcctCtTTtCtCttcCTCttcTTCCtttctTcCCCctTcctTccCtCTccC	>DAA>>?A>@>@B?:<D?FFEFCG@DDDCFCGGFFGGDDDGGDDGDEGEGEGFGDGGGGEFGCDDGDEEEGED=GFEBGDGGFFEGDDGEEGGDGBEDGEDGEGGEDGEGEEDDBHFCFBEEDHHGEG9EGGBHDGGEGCDEDDHEEGGGHDFGFBFFGCEEEEHHFEHHGEHHGHADFGGGGEDHGGEHEHEGHAHHHHEGHHEHGGGHGEFGEHEEGGHHHFFHEEEAEDEHG@AEEFHHEHHHHHEHFFDDGHEHEEDFHDE<HEIIEHDCHEEDHHEFEDDEDCDEDHFDFEEHDDFF8EEHDDFEEFFEEGDBABC>?>>A;A	C	189	T	139
19	10218408	G	99	aAGAaaAAGAgGaGGaagaGAgGGaaAAaAGAaGAgggGAAAAAGGgAGaGAAGGAGagAgGaaaggAgGgGAggaagaGgAGAAGAAaaagAaggGga	C<9EEFD>HECHFHHFFCFGECHHFECEFEGDFHEDDBHEEEDEHHDEHGHEEHHEGGCDBHFGDDDD9GDGDCDGGEGGDDGDDGDDGGGDCGC@?AD	A	53	G	46
19	10225682	G	139	CGGGGCGCGCCCGGGGcCCCCCCGCCCCgGCCCgCGCCGcgCgCcCgCGGcGCccGccgGGGgcGcgGgcGCCgCccGCGGCCcGCcGCCGcCGGCGcCgggccGGGggGCccgGGcccGGGCgCCGCCgccggccggg	CFFBGGGFGGGGGGGGGD>HGGGGGGFGFGCGGEGGGGGHEGGGHGGGGFHGGHGGGGEEGGGHGHGFGHGGE<FHHFFFFFFHFFHFFFFGFFFFFHFGGEFGFFFAGFDHHGFFFGGFFFDGFEEEFEG=BB=>99;	C	73	G	66
19	10226052	G	41	AGAGAGAGGGAGAgGAAAAGGAaAGAAAAGGAAGGGAAaGG	A<HCHAH>AAHCGDCGHF;BBGGGBG??GBBGGBBBGGGAC	A	22	G	19
19	10229521	C	54	ccccCccttttttcCttCccctcTtCCccTcCCCtttTtcTCccCCTtCTTTcT	CCDFBEFEEDEEEFFFFBEGCFGGEFFGGFGFFEF<FFDGFFG9FFEEFCDC?C	C	30	T	24
19	10271141	A	100	ACcaCCCcccccaaCaCcaaaccCcaccccaACaaacACCacccAaAaCaAccaacaaaCCcccaCAacAcaccaacccCccaAacacaacccacacccc	>A>A@BA>BCCCEEEDGDEEEDDGDEDDDDEEGEEEDEGFEDDCEFEE?EEE6FFDEFDFGEADFGEFEEEEDEEFEEDG?EFD;EFDFFEEDFEFEEEE	C	58	A	42
19	10283932	C	27	Cccctccctcttttctttcttccttcc	BBEC?DDDEDEEEEDEECADFDDFFEF	C	14	T	13
19	10403368	G	142	GAGGGGGAAGAGagGAAAAAaGaGaGAGaGAAGAGGAAAGAGAGGGGaAAAAgGGGAAGAAgAGGAGAAGGAAGAGGAAgGAGGaGGGAaGAGGgaGAAGAgAGAAGGGGAAGAGgaGGGAAAaAAGAaAAGGgaAAGGaga	AEEAEEB@EEFEDEEFF8FFEEFEEEAEEDEFEEEEEF?EFAFEEB>D=FEDF>EE5>ECEEFCDEDEEDD:9DBD9ECFDD9DFDDDEFD6>DFFDAEDBFAAEDBCCDEEDE;EFDCD5DDEB;EEDCDBCBABB>A>D@	A	72	G	70
19	10404519	G	145	GgagggagAggAaagGAgaaAGagAggaAgggaaggGggGgaAaAAaAGGgGAaGaGaaaAAgAGGagGaaGaGGgAAGgAGGgggAagGAAagGAGgagaaaGGaaagAaaaAAGgAgAgaagaGgAGGGaagGGGAAaAAAGA	DAC?=ACA?;@<EFCGFCFF;FDCFCCEECCCFFCCGCC>CFFFDFFFGGBGFFGCGEE>F:DEGGEDGGGBGGGDFEGCFGG8DDFGDGEFG?FFG6FCAGGFEGGGDEGGGEEFDEDEDGGD?FDEFFFDGDEDBBC?ACC??	A	73	G	72
19	10444790	G	117	ggggGgggggggggGgGgCGgGgggggggggCgggggGggggggggCgCggggGggggggggggCGggCggggCCggCCCCCgggCCgCggggggggGggGGgggGGGGgGGgGGgg	?@BB9CDEECEEFF;F7F:6DAEEFEFEFFF?FFFEG<=EEFGGFF9F?DFGF5GC<DG?GGEG?9E8CBEFFCCGFB8B?B@FDA@F?9EEFG8FG>GCBA@E@?@@>?8>;<A@?	G	101	C	16
19	10463118	G	44	GGCGGGCCCCCcCGCGGGCCCgGgCcGgGGGGcGCCCGGGcCcG	>DGAEE>GGGECF?GEEDFFEDDDGCDDDDDDCDFEFDDDAF9C	G	23	C	21
19	10471796	G	98	GAGGggaGAagaAAGaGGgaaGAGGGGaAAaGaaAggGAAGAGgaAGagAggaaagggAgGggggaaggAaAaaaAaGgaGaGGGgaaagaaggGagA	DB>;@>>ECEBFEEBEGGCFFGFDGFGFGFFFFEFCCGFFGFGDFEGGDEDDGGGDDDFDG>DDDGGDDEGEEGGCGFEGFGEFFDGGGCFFCDFEDD	G	50	A	48
19	10531450	C	61	GGGgGcGGGCGCGCGGGcgGGGgCcGgggCGcgggGGGggCCCggGcCccGCgGggGggCG	=>5ECDCACCCDADCCCAFCC@FDECGFFDCEGGFBCBGG9CCGGBECEEBCGBAFAEFA?	G	43	C	18
19	10565651	G	37	ccccgGgcggcggcccccgggcccggccgGgcCgccc	A>BC9DCBCCBCCBABABDBDCCCCCCCADDBEDC@?	C	21	G	16
19	10883126	C	69	CGGGCCCGgCCGcgCCGcGCCcGGCCGCCgCcGggCCgGCCGcGGcgCCCGgCGGgccCccGGcCcGCg	?HGHGGGHEGGHHGGGHHHGGHHGGEHGGEFHG@EFFGGEFGHGGHEFFFGGFCGGGHFHGEEE>CC?B	C	38	G	31
19	10916684	C	92	ccttctctcCccccCCctctctTtcCccCTcCcccttcTTcctCcTCccctTccTtcTcTctttTccttcctTccttcctttcctcccttcc	CC?D@B?FCFABBAFF<GBGBGFGBDBBEFBGBBBGGBFFABGGABGBBBGF9BFGB<BFBHHHFCCFHCCHFCCHHD<CHHB@H@BCAG@@	C	54	T	38
19	10961273	G	80	ggAggaggggAAgaAggaGaaAGgagAggGaGaAaaagaaaAaGggAgaaaGGgggggGaaagagaagaggggaaaaaGg	AABABFBCCBHHBEHCCFCCFDC?FCHCC>FCFHFFFDFFFHGCDDH@GGF?CCDDDCCFGGDGDGGDH<DDDEGFFGAC	G	41	A	39
19	11134090	A	44	GAAAAAAGGAAAAAAAaGAAGGAAGaaGAaAaAAGAaGGGGGGG	;HHEHHGCBGHHHGHHGAGGBBGGBGGBGGGFFH@EA>=CCC??	A	28	G	16
19	11227602	C	47	CcCcTcCcTCTTTttctTTccCCCCccttCcCTCcCCCtTCCCCTTc	DAA=EBGBEFGGGGG@FGGCCGGGG>CHHFC=FFDFFFHBFEEFEFA	C	30	T	17
19	11303469	C	107	GGCGCCcGCGGGGCGggGGCCCGGGCCGgGGCCgcCGGCCcggcgcgggCGGGCgcGgGgGGCCGCcGcggCGGgGGGcgGgGGcGGGGGgGGCGGcgCggGGGcGG	ACDCDDDCD8@CC;BEE6CDD8BCCDDC79CDDGEDCCDDC?EEFEF>FDBB>CCECFBF<@CCBCEBEGGC=BGB;BEFBGBBEBBABBFA<CABCBAB9::>=C?	G	72	C	35
19	11526765	G	37	tggTTtttgTttGgtggggttttgttGggtgGtttgt	?C@=:HFGCDGGECGCCDCGHGHDHHEDCHDD=HHDF	T	21	G	16
19	12491779	T	153	TCTCtcTTCCcCTtTCCTTCTCctCcCTTTcTCCcTCctCTTcTtCttcCtTttcTtTtcTCTcTCCCCTccCcCTTCtctTTTtTtTTCCccTTcTCTCTttCTTTCCTCTTCCCcTtTTTcCtTtTTtcCTCtcCtttTCCtTTCTtTCcc	BDEEHAFBGFAGDG@GG=GGGGBGFBGGEGBHHGCGGBGGGGAGGFHGBGGGHHCGHFHBGGGCFGGGDFCBGCGGGEHCGFFFHGEFFFFCCFFCFFFFFHHEFFFFFFFFFFFFBFHFFFCFGFHFFHCEEFHCEGHGGCCDBB@>5AB<;	T	84	C	69
19	12491949	T	126	CctCcctTctttTTCCcctcCccCTtctttttcTcTtcttTctccCttcctCtctccCCcCcTtctctTtCctccCccttTtctcCtCctcCCctcccCTtTtTtTctcTcTTTCcccctCCTtcc	C?BABBBACBAD@DDFEEDFFFFFFEFEEEEEFFFBEFEEFFEFFEEEFEEGBDEFFGEFGG<EGDFEEFGBFBFGFGF?FFEFGGFFGFGGFEEGGGEEDEFEFEFFGEFDDDDFFCB@@>?B=D	C	68	T	58
19	12491955	A	117	CccacCccCAacaaaaacAcAacaaAcaccCaaccaCacacCcCCcCcAacacaAaCcaccCccaaAacacCaCcacCCcacccCAAaAaAaAcacAcAAACccccaCCAacCcaca	A?@>D@EEBGEHECDDCGHGHDGDDAGDGGDDDGGC?DGDGEGDEG9GEDGDGCHDDHEGFDHHEEGEHCGDDDGEHCCHEHHHCGFEG=GEGGEHGHGGGCHHFHECBFDFCECB@	C	64	A	53
19	12936617	C	108	GGGGcGGGGCCgCccGcGgCGGCCgCGGCCGCGGCGGgcGGCGgCGCgGGCCCGccCgcCCgccCcCCCCGGgCGGgGCCccGGGgcCCgcGgcgggCCCCgcCGcCG	DEDEDE<EEFFDFDDEDEEGEEGFEGEDEFEEDEFEEBEEEFE7FDFFDDFF5DDEEFEFFGDEFEFFEEDDGEDDEDFFEEDDDFDFDGEDFEGEFGFBB=@A@>BC	C	54	G	54
19	12958360	T	108	TCtcctcCtttctctcCccCTCctCCttctttTcccctTttCcCCCcCCCCtTctcTTCccccTtCCttttCcctcCCtCtCCtctcCCcTcTCctttCccTccTTTc	<@C?@B>=DDC>B@HBGBBFEFAGGGGGBGGFEBBBBGBGGGBGGGCGGFGGEBHCEEGCCCCEHF@HDHHGCCFCEGHGHFFHBHCEFCDCDDCHHHFACE@ADCC@	C	63	T	45
19	13220676	G	122	AaGagaaaagGgggAagGGaAAGgaAGagGaaaaggGagggGgggAaagAaaGGGaggGGGgaagGggGAaaGGAAAaAggaaGgaaAAaGGAGagaaggagggaGAAagaAagggagAgGG	=DDEDFFFFCHC5CEFCHHF;DGCFEHFCHFFFFCCGF@CCHCCCDFFCBFFHBHGDC:HHDGFDG?DHEGGHHEEEGDDDAFHCGGDBEGGDG@BGGDCG8CDGGDDGDGDG9CDGDD@ED	G	64	A	58
19	13323124	T	56	ggTtgTTtTgtTttgtgTgttgtttTTgGGgtgTtGtTTTTtTgTTTTTttGTgtt	CC<BA9EGFCG@GGCGC=CGGDGGGFBDEEDHDFHEHE>EEHEDEEEEEG>CECBB	T	39	G	17
19	13335432	G	97	aGAgGGGaGGaaAAGAGGGGGgaaGGGgAAAGagGGGAgGAGGgaGGGGGGAAAAAAGAAaGGggAAGgaggggAGgaAggagAaaAGgagggGaGa	D;AA?ACFCCFFHDCH@@ACCCFBC?CCHHHCFDCCC;BBGCCDGCCCCCCHHHHHHBHHGBADDHGBDFDDDDGBDGGDDGDFGGGABFC?>=;C@	G	57	A	40
19	13996647	T	38	CTTTTTctCTCTCTTCCTcCCCTCTTCTCCCTCctctT	=GGGGFEEDFDGDFGDCGECCCFCFF=FCCCFCEBD8F	C	19	T	19
19	14015815	T	40	tctTcctttCctCcctttTtttctcttttttcctctcTcc	CB@CFFACCDGDEGGDDDGDDDGEHEDEDEEGHEFEDFHH	T	24	C	16
19	14049143	G	38	gccccccgggCccgcgccgcgcgcccggggcgcccccc	?:<?:>@DC?DBBCBCBBCBCBCBBBCDDCCDCCBCC8	C	24	G	14
19	14142705	C	84	CCCCTTCTTCCTCTTCCCCTCCTTTTCTCTCTTTTTCTTTcTtcCTCCTcCTCtTTccCCTctTTCCTCTCCCCcCCttcCCCT	@DDDGGDAADDG?FGDCCDFDDGGBFDGDFD=FFFGCFFFEEEECFCCFCCFCFFFEECCFEFFFBCFBFCDCC@CBA:>AAA@	C	45	T	39
19	14150303	C	134	TCTTTCTTTTCTCTTTCtCTCTTTtTTTCCtCTTCTCTcCTTCCCCTCCtcTTTcCTCCTCCTCCTttttTTCctCTTTtctTTTTcTCCCCTTCCTctCCCCtTTTcCCTttCCtTCTCctcTtCCctcCcTt	A?DEGEFGGGDEDGGGDGDGDGGGGGGGDDH>GGDGDGCDDGDDDDGDCHCGGFCCFCCFCCFCCFHHHHFFBBGCFFFHCHFFFFCFCCCCFFCCFCHCCCCEFFFCCCFHHCCHFBECCFCGFAA9C=@;AB	T	74	C	60
19	14161547	A	69	AAGAAGAGgAGaGaAGGGAGGAaGgGAaaaAAAaAagAgaaAgGAaGgAaGAaAAgaaAAGGgaGaaGa	?DFFFGFFFFGEGEF8GGDGGCEGFGFFFFEFEFFEFFFFBEGFEFFFEFEEFEEFFCEEFFFFF@CG@	A	42	G	27
19	14208782	C	30	CtttccttcccccccctctctcccttTttc	??BCDCEEDDDDDDDDEDEEAEEEFFFFDC	C	17	T	13
19	14231325	C	132	CCGCCCGGGGGGGCCCGCCGCGCCCGCCGCGGGCgcCGCcGGCgCgCCcgGCGgcgCGcggggGGCCccCggGGGGgCGcCcCCGccgGGCGCGCCCCGGCGGCGGCcGcCCGgCGGCCgGCCCgGGgGGcg	>@?@GFDEEEEEE?FEEGGEGEFFDDGFEFEEEGAEFEFEEEGFGEFGDFAFEGBFGEEGGFGEDFEEEFGGDDDCEEDEEEFFDEEFDDFD>DEEFFDDEDDFDDFECDEEDFFADDFEDDAA>AA:??BB	G	68	C	64
19	14231330	A	142	AAGGGGGGGAAAGGAAGAGAAAGAAGAGGGAgaAGAaGGAgAgAAagGAGgagAGaggggGGAAaaAgagGGGGgAGaAaAAGagGGAGAGAAAAGGAGGAGGAaGaAAGgAGGAAgGAAAgGGgGGagGAGgGgAGGGgAa	B=GGGGGGGDFFGGDFGFGFFEGFFGFGGGFCGFGFGGGFDCDEFGDFDGCFCFGGDDDCGGEEGEFDGDFFFECEFGEGDEFGDFEED=FEEEEFFEFFEFFEGFGEEDDEFFEEDFEDDDEECCFDCDDD@D?B?AB8?D	G	77	A	65
19	14277727	T	32	TTGTGGGttGTTTGtTTTGGTGtTTGTGTGTT	=><EHFH?GHEEEHG<EEFE<F>DDFAADE=A	T	20	G	12
19	14512489	G	125	GaaaGAaagAAAAaaAaaGgGAGAAgaGaaGAGaaGAgaaagGgAaAgaggaggGaGggGGagGaagaGAGaggaaGagAGAagAaaaAggAgAgGGgAaggaggagGagAgaaagGaAgGggGa	9BDCBFGECHHGHFFFFFCCCHCHHCFDFFDFCFFCFCGFFCCCHGHCFCCFCB=GADDBCGDCGFDGCHAFDDFGCGD@BHGDGGGGGDBGDED8BDGGDDGADDCBGDFDGGGCBF@C@?<CD	A	65	G	60
19	14677175	G	42	ggTgttggggtggtgttgtgttggggttttttttgtTtgtTt	AC?CCC=FFFDFDDBDEEEFCDGFFGEEE6BDDEGEEEEEEE	T	24	G	18
19	14682804	G	42	ccCGcCcgCcGCcgCcGGCcGCggGGgcggCCGGCccgCggg	?A9CBFBC?AD?BDDCEEF@EFDDDDDBDDEFD9FACDFBB<	C	22	G	20
19	14717791	A	67	GGAGgAaGAGGAGGGGAaGgagggGaGaGggaAAGaaggAAAAaggaGggGAgggAagggAagAaaa	BCDEFFEBFGFFBGGGFFGFFFFFEFGFGFFFFFFGGGGEDFDGGGFGGGGFGGGEGGGGEG@EG9?	G	37	A	30
19	14974930	G	155	aAGGGAggagGAgAAGAGGGGAGgAGGAGaAGaGGGgGgGgGGGAGgAggGAGaaAAaGAgAGGGGGAaaGgAGaggGaAgAAGGggAAGAaGAAAGGGAAAGGAGaAAaAGgggAAaAAGgaAAGAAgAAgGAAaGgaggaaAGgAGaggaAGA	C?EFFDEDDDHEEEEHCGHDHEHF;HHEHEDGEHAHFHFGEHAEEHECFFHEHEFDECGEEDAHHHHEFEGFEHEFFGEDGDCHGGEDDGDFGADAGGGDDDGGDGEDDEDGGFFDDDDDGFFDDG:DGBDGGDDFFGFAFEEEGDAECCD>?DA	G	82	A	73
19	15133926	C	61	cccaacaaacaacaaaccccacccacacccccacAccacccacacacccaAaacaaaaaca	AC?ACC?BCDFEDEEDDDDDEDDDEDDDDADDEDHDDEDDDF@FEFEDDFHFFEFFFBFEF	C	32	A	29
19	15222428	A	107	AAGGGGAGAaAaAAGggggGGAAAAAAAGGAGggGaGaAGAgAGAAgaGgAaGAgaaAgGAaAagAagAGgAGaAgaGAAgagaGgaaGagAgaAGagaagagagGa	<AB6EEFEEEFE?FDFEFEDFFEFFFDFCEE:FFEFEFDEFGFEFF?EEGFFDFGFFEFEEE?BGEBGEDGEDFEGFDEEG?FECFFFDFFDGFEDEFE?@@=@>@>	A	58	G	49
19	15338537	T	112	CtttttttTTtttCCtttttttTtCtttttCttCtCtttttTCTtTtCtttttttttTtttttCTttttCttttCtttttttttttttttttTTTtttTTtttttTttTtTT	;??@CEHFD<GGGCDGFGAFGG6G9GGGGG8GG9C>GHHG<79=H:HDGHGGHDHH;D=HHHH=DCHHH@HHHH@HGGH;CGFHFGHGHHHHEEFHHHFFGHGGHGGDEECD	T	100	C	12
19	15582863	C	46	ttCCcCTTctctCccTTCcttCCtcttccCCCCcTtttTccccccc	?B?BADGGBEBGDBBGFCBGFDDEBGG;BDDDDBGHHHGC?CCCCC	C	28	T	18
19	15872036	A	75	AATTaTaaAtAaATtatatAaTtaaaTtatATtTttAAATTATTAAtTaATatAtaATTAATTATTATTTttaTA	AA@>DFFFHEHFHGEFAGFHFEFGGGGFGFGGFGFC9G<FFHFFGGFFEGFFFGFFGFFGGFFGFFFEFFDFBD?	T	39	A	36
19	15918380	C	153	CtccccctCtcTCCcTcttTcTccccTtcCTCtcctcctCcTTCCCtCcTCTTTtTcTCcCcCTTTttCTTcccttTCTTcCTCtccTCTtttctcccctccTctccCcTTCCCcTTctttcctTCttCTctcctCTCCCcTtcctcTCccct	=B@B@ACDFBDEGGC<CEDEDEDDDDEEDDFGEDDEDDEFDEEGEGEGDFFFEBDEDEGDGDGEEDEEFEEEEDEDEGDDEGEGFEEEGEE@DE@DEEEFDEEEEEEEDDDFGDEDDEDCEEEFDFFFFDCFEEFFCFFFED7ECCABC>>=B	C	85	T	68
19	16136923	T	154	CccTTTTcttcCCcCcTCttCctCTTcCTCccttTTCtctTtCcTTttTCCTCcctCttcccctTTcttCcttcCCcttcTtttTtccctTTTtcccctcCtccccCCttctcccctttTCtcTctCCcttcTccctctcttTccttCccTctt	AC6BBA>>D>==>@BBACFFDAGDGGB;GDBBFGGGDGBG?GDBGGGGGDDADBBGDHHBBBBCFGBG7D@GHBDDCHHCGHHHBHCB?AFGGHCCCCHCDHCBCCDDGHCHCACCHHHFDHAFBCCCCHHCFCCCHCHCHHFCCHGCCCFBA@	C	79	T	75
19	16275655	C	222	CcCTTttCCccctcctCtcttttTcttcTTcctCtCCcCTTCtCcttCCCtcttTTTCcTTTTCCTCcctcTtTCCCCtttCTCtcTTcTctcCcccTTcccctcTTTCCTtTCTCCtcCTTccccctTttctctctctccTCctttcctTTttccCttCtTttTtCTtCTtctTttTcCcttccTTctCCttcCtCTCTTtTTCCTTccCtCTTctTtcTc	A?<BBB=BDDCDECCEDDDDDDDGDEED<HDDEDECCDDGADEDDDDDDDEDEEEDDDDG>GGDD?DE@EDGEGDDDDE;EDGDD9GFC?DEE<DEDFGDEEEFEGGGDCFFECGD9FE>GGEEEEE7GEFDEEBDFECB@GDEFEDECFAFFFEEDFFCF=BFFA@FCCFFDFFEEEFCE>DEEFFEECCF9ECBCFCFFCFFCCFFEECFCFFC@<@;AB	T	117	C	105
19	16320075	C	38	ccCgGgcccgggggcgccggccgcggcccccccgcggc	?>?BBCABACCACCBCBCDD@CDCDDCCCCCCCD8DDC	C	21	G	17
19	16436262	T	25	cCCccTtttCtctCTCCtcTCcCtc	C=CBBGGGGDHCHDGDDBCFCCDG>	C	15	T	10
19	16593415	G	73	gaAaGagAAgGgaagAGggAaggGaggaGGAggAgAaaGaGaggaggaaaaAaaaAgagaagGAagGaAGaGa	CA>EBFCD>CDCFFBFECCFFCCEFCCFE:ECCFCBEDEGEDDDGDCGGGGEFECEDGDFGDDDGDDGEDD@@	A	39	G	34
19	16612011	T	129	CCCctTtcCTCTtCtTTCCTTtTtcCtccctTTcTTTCTTCCTTCtcTcCTTTTCTcCCtTCCCTTTCTTTtTCTTTcTttcTcCCctTtTttCcTCtTTtcCttctcCCcctCCttTCTTCcCTtCCt	AAA?@@E@@F@GFDGGGDDGEGEGBCGBBBGGGAGGGDGGDDGFDDBFCDGGGGDG?DDHFCDCEFFDFFFHFCFFECFHI;FCCCCHFGFGGCBFCHFFGBCHAACBCBBCGDDGGDACDB>@AAC?B	T	72	C	57
19	16631322	T	76	tCtTcCTTTCtcccttTCTccCtctCtcttctctcctcttTcttcccccctcttcCttctCttctctcttCccctc	C>B=?D8@EFGBBBGGEGFBBGGBGGGBGGCGBGCCHA@HFCHHCCCC@CHBCHCGH@CHFHHCHCHDCHDCCBF=	C	39	T	37
19	16641561	C	114	cTTcctTccTCTTctccCCcCTTTccTcTCcccTtTtTtTcCCCttCCtCTcCTCtTCTCTTtCtCTtTtTTCTTTCtCCTCcctCCTTcctCTcTTTcCCTTTCcttCctcCT	CBA@8GFABGDGGBGABDDBDGFGB?AAGDB@BGGGGGGGCDDDHHDCGAGCDFDH<DFC>EHCHCFAFHFFCFFECHCCFCCAHCCFFCBHCFCEEECDCFEEB>B<@>@<CA	T	58	C	56
19	16666101	G	95	gCCgcGcCgccCGGgCCGGGGggcgCcggGgGgcGcCggGgggGCgGcGgGgcgccCccGCgcccggccCCcgGcCGggCGgcgcgggcccGCGC	C>AA?DAE>BBGEDCGGDE;ECCBCGBCCFCEC8EBGDCECCDEGDECEDEDCD9CGCCEGC@CC:DCCFEC=DCEDDDEDDCDBDADCCBDDD@	G	52	C	43
19	17107825	G	75	AAAAAGAGGAGGAgGAAGGGAAGGGAGAGAGAaGgGaAAAGGaAGAGGGGgGAGAGGAGGgGAAAGGAAAAAaGG	FEHGFCGCCGCCHFCHHCBBHHCCBGBFBEBCGBEBGGGGBBFGBGBBBBEBEBGBBEBBGBGGGBAFHDCE?AC	G	39	A	36
19	17107910	C	147	TTtTCCTTCCCCcTTCTTtccCctTttTCtcTCCTTTCtTctcCcTTTtCCTTTtCCccTTTCcccTtcCTttTCTttTctCttcCtcCCtttcTTCTCTccttCTTCTtTTtcTctcCCtTCtcCCTtccTCcCtTtctccTTcct	CDBB?@CGBDDDDGGDGG9DCDDEGEEGDEDGDDGGGDFGEEEDEGGGDDDGGGFCBEEGFGDEE?GFEDGFFEDFFFCEFDFFECFEDD:DFEFFCFCF?E?FCFECEFFCFFFAFECCEFC?ECCFFDBFAEC?EDBB:@CB>B?	T	80	C	67
19	17169758	G	77	GGgGGCCccgGccCCcgCcgGCGcgCGCGCgGgcGGgCCcCCCgCgccCGCcgGgcccgcccgGgccggggccgggg	@DGCEGFGGFEGGFFGFGGDEGDGFFAGEGDEFGEEGGFG;EFGFGHHGEFHGDGHGGGHHHGDGGHGBFGHGFB@?	C	39	G	38
19	17212992	C	328	TCtctTCTtTttTtCcttCCTTctCttCCccttcTCTTctTTtcccCTcccCcCCTCTTTTcCTTccttttCTccCTtctcTTCTCcccCTCtCctTTCtcCtCCCTTtTCttCTTCTCcctCCCCCCCCCtcctttccCTCtCctcTtTTCcctTCTCCCCcCTcctCtTcTCttccTTCTCTTTTCTTcttTctccctctctcTTCTctttTtCCtcttcCTccTccccccCcttTTTtcTTcctctttCctTTCCCCTCTCTctTCttTTCTCcCtCcCTCtTtCCcccccCctctTtTCttctTCtctcCCctTCTctcTcctt	DACC@B>ADACCCDCBHF9DFGBFDDGDDABFG?GDGGBGHGGBB>DGBBBDADDGDDG<GBDGEBBGGEGDGBBDGGBFBGHDGD7BBDGDGDBGEGDG=DEDDDGGGGDGG@?GDGDCBGCDCDDADDAHC?HHHBCDGCHAAGBGHGGC;CGGDGDDDCCDGCCHDGGCA@GGB<GGDF@GDDEDGGCHHECGCCCHCHCB@FGDFCDHHC=DCHCHBCCF=CFCC:BBBCCGGFFFHBFFCCHCHHHCCHFFCC9CFCFDFCHFCHHFFCFCCCHCBCFCHFHCCCA=C<CCHCHFHEBHHCAECGBBBCC@ECA5=B<C8>@;	C	167	T	161
19	17301880	T	127	tCtTTtCttCtCTCCCTctTTccTCcttCcCCTCtTCtttTccccttctTCCCcCCCtTTTTCCTctttTCtcCTTCCtTtTtTttcCTTTccctcTTtTtCtctccCCcctTCtCcttTCcTCctt	?@B@DDGEEFEGEGGGCFEEEFFEHF=EGEGGEGEEGEEEEGGFGEFGEDGGGGGFBEEEEEGGCGF?FEGFGGBEDGFEECEDFE@FDDDGGGFGDC?DFFBG<GFFFGGEDFFFGFFCEFBD>@A	T	68	C	59
19	17306031	T	77	ctctcccCTTtCtcCTttCCcCTTCtCTccTtcctttCtcTTctCTtCTcctcctcTtCtCTCCtTCTCTTTttCCc	?EBG<A@D<?GDGBDGGFDDBD<BDHD<CCGHCBHGHDFCDGBHCFGCF:CHCCHCEFCFCFCCDFCFCFEF;CC?@	T	39	C	38
19	17394504	A	237	ACCAAcacCCAAcaAAaCAACAcacAcCCcccacAACcccAACCacacaCCAAACaaaCccACAaACCAcaCAcAACCCACAACACAaaACCCCcACcACACACaACaACCccAAAccaAACCCACACCAAcCAACaaAAaAcacACcCaccaAacAaccaccacCCaaCcaccCAAaaACaccAacacaCaCcaAAACACaaacacaCAAAAcCAAACAAaaaAAAAccCCCcCAc	@@B9ABB@>FD;ADDEEGFFEF@EDFDGGADDE@EFEDDD=FGGDCEDEGFFF?E>A>ADDFGFBFBDFDEGFDFFAGGEFBDGEG:EEFGGGGEFGEEDFGF7FEFFEGGEEFFEEEEFFGDGF=EGGFF98EFEFFDFFEEFEFGEF=DE;EFEEEEEFEAFEFE@EFEEEEFEEFFEFEEDE=EEEFFEFEFDEEFEFFCBEFDFEDDEEEEEDFFCCBBACCCC;?@9A<>B=	A	123	C	114
19	17435884	T	142	ccctTCtTtCTtctctTtcCtcTttCccCTCttTTtCtctCTcTTTcCCCCcCTtcTttcCTCtccTctTcCCCTTTtTtCTCtCCTCcttctttCTtTCTTCCtttTCtTcCcttCtcTtcTccTtcCCcCTctTcTTttt	C@?CB<DCFBEGBFBFGEBCGBFGGDBBDG@GGEFFDGBBDGBGGDCDDDDB?GGBGGHBCGCHCCGCEGCD7DGGFGGHDGDHDDGCCGFAHHHCFHFCFFCCHHHFCHECCCH><GBFHCFBCFHCCCCCFCHFBEEFB@	T	78	C	64
19	17533126	A	63	aGAGGAAGAAAGGGAAGAGAAGAGAGGAAAAAGgaGGAGGAAgAAAGGgaGAAGAGAGGgAAA	CG5DCEEH7E:A=H;EHBHCEHEGDG<:>DDCFFFGGDGGDDBDDDGGG<GDBFBF@EDA>A?	A	34	G	29
19	17547292	A	37	GAGGGGGAGGGGAGGGaGAGgAgAAAAAAaAagggAG	BFDDACCHCCBCGCBCBCGBGGG?GGGFGGGEFEDD<	G	21	A	16
19	17615609	T	60	TccttTcCTTctTTCttCTcCcCcTccttCtCTTCtcccttCttTccccccctttccctt	D@=CCB@DEGBGGGDGGDGBDBDBGBBGGDFDGFDHCCCHHDHHDCCCCCCCHHHBBBH=	C	31	T	29
19	17837090	C	106	ctttCtTtTCtttcccttTtctTccccttcTtccttcctTTccctttcccCTttCcttcctcTcCTccCtcCTctcCcTtctTCtcTctCCTtCtTcCTCTCttcc	AC@@=CBDCBFFGAABFGG8BGFBBBBGGBGFBBGGBBGHHB>BGHG=BBDGHH?CGF>CHCGCCGCCDHCDG<FCCCFH@HFCHCFAGCCFGCHECBDCE=A:>@	T	54	C	52
19	17844325	T	66	CCcCCTcTTttcTtcttctccccTCTcctttcTtcctcTtccTccctttctcctcctTctcccttc	AD?B?;A?<AA>BEDEEDEDDDD@FE9DEEEDEEDEBDEFEEDEEEE9FEF?C=EEDDEFEEDFB@	C	35	T	31
19	17937429	A	39	AAAGAGAAAGAGAAaGGGAGAGaAGGGGAAGAAGGAGAA	GIH@HCHHFCHCGHC@CBGBGBGGBBBBGGBGFBBGBBB	A	22	G	17
19	17941294	T	37	CCTTCTTTTTCTTTCCCTCTTTTtctTCtTtCttTCC	DDDDDGFGGGDGGG9DCFCFFEFFEFFCFFFBC=CC?	T	24	C	13
19	18184317	G	62	ggGGGGAGGGAGGGGAggAAGGgAAAGAAGgAAAGGaAAGGAAGGAAGGAAgAGGAAAGGGG	=F?CGGDGGGE=GFGFGEEFCFGFEFFFDF7EEEFEF:EFFCEFEDEFFEDGEFEDCDD:?B	G	36	A	26
19	18322095	G	35	ggaGggGagggGgaggggaagaaaggaGgagaagg	?@EACCCEB?CDCFCCCCFFCFFFCDGEDGDGD>8	G	23	A	12
19	18359037	G	62	aggAGAgaAGgaAGaAaagaGggagaGagggaGgaaaAgGgaaAgaaGgggaagggagaggg	C@@ABCDEAEBFDEF@6FCFDCCFCFECCCAFECFFDEDCDGEEDGG9DDCG?DDDGDGDC=	G	33	A	29
19	18377647	G	106	cggGcgCcGcgcgccccgggCccccCCgcgcgCggcgGCccgcGacCcgCccgcggcgGcggcccCcgccgCcgggcggGcccgcgCgCGcgCcGGgccgCgggCC	ACA=CBCBFEGEFEEDDDEDGDDCDGFFDEDFGFFCEG@DDDCGEDGDEGDDFDFFDEGDEEEEDGEGEDEGD6CFE@FGD@E@DFGGFF>GFEFFEEEGFF8GA>	C	58	G	47
19	18466840	C	108	tcCTccCtcccCttctcTtcctCcctTtcTttctTtctcccCTctcctttcttttTCttcCCtctcctttcttctttttttttcccttcttctttttttttccttttc	?@@A::>B?@BFGFBGBFGBBGCBBGE8BCGGAGFGBG<BBGFBGBBGGGBGHHGBFGGCGGGCHACHGHCHHCHGCHFHHCGCCC>HCHHCHHHHHG7HHCCAC>=@	T	64	C	44
19	18684563	C	118	CTCTcTCtTCCtCTTcCcTTCttTtccCCTCTCCTCTTCCTTTtCCCCTTTCTtCTTTttCtTCCctcccCTTtctCCTcCCTTcctCtTCTcTtCccctCctccccttTTtctctCC	CGDFBGDGHDEGAGG6DBGGDHHGGCCDDDDGDCGDFFDDFGGH>DDBEG?DGH=GFFHGDFFCCCH>CCCFFGCH@CFCCBFF>AH@HECF8F7CC6<HCCHC=ABHFDF?:B=@CC	C	60	T	58
19	18700047	A	207	aAgGAagAGAGAGGgGGAGaagGAGaAAAGgGGaggGgGAaaagGgaAAaaAAGAAGaaggaGAGAAaGGGGaGGgaAAgggGaaAGGAgGAAAgggGaAGgGAAAGGgGAAAgAGgAGGGGGgGGaAagAAAGAAAAAaagAGgGAGAGGGaGAAGGgAaaAaGAGaGaagagGAaaaaAGgAGgAAAGaAAAAAgagAggaGaaa	<:6A=CBBEEGFGGDGGFGDDFGAFDFFFGFHGDFDFAGFDDDFGFD9EEEFFG?FGEEGEEFEGDEEGFGGAGGGEFEGEGGE9FGGFGGFF7GEGGEFGGFFEFGGG>FEEGF5GEFFFE5GFFEEEE<EBFBEEEDFBGEFGFDFEFDFEFEEFFGEEEEEFEFE?EEGDFFEEEEEDF@EFGEDEGDCDDDCB?=A@9=A=BA	A	108	G	99
19	18709175	C	37	CcTTCCTTCTCtTTCCTCTTCCTCCCCCCTCCCCTTc	@CGGGGGG=FGFFGGFGFFFFFFFDFFF@DFEDBB?@	C	22	T	15
19	18989859	G	168	agaaAaggAGGgAGaaGgAaaaaGAAgaGggGggGGAaagggggAGaaGagGGAgAgggAAGGgaggagaaGAAAagggGGGggGaagaaGggGaAagggaaaaAAgAGgGgAgAggaggGGgGaaagaAgaaGggGagAGAAAAaggggGAgGGGgAGaGgGgaGag	C=CB?DBBDCCBEDFFEBFFFE?AFF6FECCECCEDEFFCCCC?BEFEEFCEEECF?CCFFEBCFC>ACFFEFFFDCCCEEDCCEGFCFGECDEFFCDDDGGGGFFCEDDEAFDEAAGCDEEDEGE<DGEDGFDDDDGDEDEEE=HCCDDDDDDDDDECGDDCDEC@?	G	96	A	72
19	19030689	C	168	gcCCCGcCCCGCCCgcGGcGgGGGGGGCgGCgcCGggGCCCGgGGGGcGGGCGgCCGGccCGgccgGcGCCGCCgCGggGCgccgcGcgGgcCcgGCggCggcggCcGGGGGggccCgcgcgGCCcgCgccGggcGgCCcgccGgccGccgCgcgggcgcggCgCCgc	C?;<<=B>=?=ABDFD7BDCEBBCCCCDB;CFDD:FECDDDCFCCCCD=CCD@GDBB?DDCBEDEFCEC@DCDDA>BFFCDGEDEECE@CGCDEFCDGGCFFEFDCEBCCBBGFEECGEFEGBCCEFCGEDBGGEBFCCEGEEBGEE9EDFCGEGGCEFEGECECA>B	G	91	C	77
19	19033089	G	53	GgGgaAGAaAAGGGAGgGGAgGAggGGAgAGaGgAAAGAAAgGGAaAggAggG	@?6CFHCH@H@CCCFBDBBCDCHDDCBGDGBGBDGGGBGGGBBBGGF@@C??:	G	31	A	22
19	19824850	T	64	TGGTTTTGTTTGGTTGTGGgTGGTGTTGTTTGTGTGTGTTTTGtGTGgttTGtGTggGtTggtg	=GHEAEDDE=E;GEEHEGHEEGHEGEEGCDCGDGCGDGADDDGGGDGFFEDG>GCGEEBC@>?>	T	35	G	29
19	20067507	G	35	TtGgTtTGGgtgtggGGtgGGGtTtGTgTgtTTGt	?EDBEGFE9CGCGC@@EHDEDDHEHDEBEDHDDDD	G	18	T	17
19	20150075	A	31	GGGAAAGGaAAaAAGAAaGaAgaAGAGaAAG	CACHHGBCGHHEHGBGFGBFGDGGBG>A@BC	A	20	G	11
19	20349058	C	66	cTTTTtTTCctttttttTtCCTcCctCCCtTTCTCCTtccCTTCctTcCCTtCttTtttcctcTtc	>?CFGDGGEDE>EEEEEGECDGDDAFD@BEGGDG9DEE<ECFFCEFFECDFFCGFF<<D@EFDFED	T	39	C	27
19	20359815	G	25	GGGGAGAAGGaAAAAAAaAGAGaAg	HEHHEHEEGGDDDDDADD:GAD=AD	A	15	G	10
19	21477431	T	60	TCcCTctCTCccCccCCCcCcccCccCccttctcctttCtctcCctcCccctcCtctTtc	BDEFCFDEEGGGGGGGGGGGGHH?HGGHH7EHEHGDDDGEHEHFHDHF;HHDHFDGECDC	C	42	T	18
19	23406742	T	41	TgTTGtTgtGGGggttGGGgtggGgttTGtTGGggGgTTtg	>FDEHEEFEHG;FFFEHHGGFFGFGF?DGFAGGGAGGDDE?	G	24	T	17
19	23414167	T	71	TgtgggtgggtggtgttgtGtggTtTgggGtgttgtGtTttgtggttgtTtGGttggtggttgtgggggtg	BCC>BBB@ABCFCFFEEFDEEFFFEFFF=EEFEEFEEEFEEFFGFEEGEFDDDFDDGFGFFFGFGBGGGDG	G	38	T	33
19	29567134	T	65	CTTTcTTCtTCtTTtCcTTCCCtTCTctCTCcttccTCctTtcTCcttTcctttCCCctccTttc	GEEFFEEGE?GEED>GFEEGGGFEGEGEGEFGFFGFDFGF;FGDFG?FCGHEFFFFFGFGGD@:B	T	35	C	30
19	33137322	A	31	AAGAAAAGAAGAAAAAGGgGGGGaaGGgAAa	GHCHHGHCHGBGGGCDBB:BBBBGGAAGFFB	A	18	G	13
19	33140719	C	97	gCgccgGggcggGCccgcCggccCgGggccGggGggccggGCCcGcgcGgccccCcgcgggcggcGccggcgggggccgccgcgCcggcgccgccgg	C>AD@DCGEGFFEFGGFGFFFGGGFEFFGFCFFEFFGGFF8FHGEGFGEGGHGGGHGHGGDBGGHDHHGGHGGAG<GHGG=EHGFCFGHFHHFFGE=	G	52	C	45
19	33293948	G	67	gGgGAagGggGGaaGagAaaAGGaaGAGaagAGAgGGggaAaAgAgggAAGaAAaAggGaAaaaAaa	CCFCHDECEFACEEAEFHBEHCCEFCHBFFFHCHGCCDGEFFHFHFGEGGBFGCFGGFBFGEEFG=C	A	36	G	31
19	33370161	A	187	ACAAACAACCACaCACACAAACCCAACAACAaACACCACACCAAcCACCaAAAAAAAAAACaAAAaAACCAcaAACCACaaCAaacAAAaCCcaaCACACAAACcACCCAacacACACcCCaAACCaAacCcCACCacAcACaAAcaaAACaCCAcCCCcccccaCaACAacaCccCaaAcAacaaA	CA@B;<AD@BGBDDHD9DCHH?DDGHEFFDFDHDHCDHDHDDHHGDGDDDHH6HHCHHHHDEH<EEHHDDHHEHH=DHDEEDGEE:GGHECDHEED;BFCGGACHGDCCGAHEH?CGCHCCEGGCCDGBHCHC>CCEGGHGCEGGHEDGGCECCGGCCCHHHGHEBEGC@E5BCFGCD>DEC@B>>;	A	104	C	83
19	33390693	T	41	TAATTTATAATTAATAATATTTATTtTATATTAaAttaAAA	EEEEEDEDDDEDDDDDDDDDDDDCDEDDDDCCDECCCBAAC	T	21	A	20
19	34710807	A	34	AcccaAccaaAaaCccaaaacccccaccaaaaca	AEEFFEFFFFEFFGFFGEEGGGEFFGGGGGDC??	A	18	C	16
19	35597729	C	89	TtctcCcTctCTtcTCTTCTcCTTCCTcctcTcttTTCttTctcctttcctctttccccCcccTTcCTtcttttttTtcctTtTcctct	DACA<ABGBGDGGAGDGGDGADGGDDG@BGBGBGGGDDHGGCGBAHH<CCHCHHH=BC@DBCCFF?CFHCGHHIIIFGACHFHFBCH>@	T	49	C	40
19	35597790	G	37	gTTgGTtgttttttTtggtTtTggtgtGTttttgtgg	@FEGFEDFCDDDDDGDFFDEDEFFDGDGFEE>EEEFA	T	24	G	13
19	35602014	T	144	CTTCTTTCCTCCCTTTTTTTCCCCCTTTTtccctCCCtTCccCTCcTTcTCTCCttcccCCTCttcCCCCtTTTTCTTCCCCTcTCTttTCTTcTTcTtCTCCtCTCcctcTcTCcctcTTTtttTTcTTtcCttcCTTtcTcc	??@@EGEAGGGGGEGEGGGGGGGGGGFGGGBBBGGGFHAGCCEGGCGDC8GGDGHHCBCGEGGHH=GCGFGFGGGFEFFFFGFCEFFDHFFGECF;CFHFFFFHDEFCCH>F=FFCCHCFFFHHHBFCFEHCEHHBFF:A<A7=	T	74	C	70
19	35612168	T	42	TataTTaaTtTtTttattATAAtATATaTAAAtTTtAaaaaT	CAEFDGFF5EGEGEEFEEHGDGFHDBGCFGHGFFFFGGGFEA	T	23	A	19
19	35633601	C	100	CTTCTcCTTCTCcTCCCTTTtcCttTCtCTtCCtTCCTTTCCtcCCTcTTtTTcCCCCCTttTTTTcCCTCCCtccCTCCcctCctCctccctcTTCTtt	:CFBGDDGDCGDDHEDDGGG9?DDFGBECFBDDFGDDGGGDDFDBDGEEFFFF=DCDCCFFAFFFFBCCFCCBFEECF5CEEECAF9EBED@EDFAA??B	C	52	T	48
19	35843371	G	27	gGgagaaAaaGaaaaAagaggggaGaa	?ECFCFFFFFEF@FFFFDGCDCDGDGG	A	16	G	11
19	36017928	G	234	CGCGgcgCcGGGGggGGGCcGccggGgGGGGcGGGGGGgccgGCgCcGCcgGCcGCGGgcCcCCCCCgGGGccCCgccGCCCccCGGGCGcggcCCCCcgGGCGCgcCcCgGGcgggggGccGGggCccGcgCGGCGCggggCcGcCggGcgggGCcCGCGccCggGCgCggGCCGgCCgCCggcGcgGCcCGGggCGGcgCGCcGCGGggggcggcGcgcGgccCcccCGGgC	A>A;>>@==>>>><B?@?CD>CDEDAFBCCCDCACCCCFADEBDEDDBDDECBD:DCCFDDD6DDEDFA=DDDDDFDDCDDDDEDCBCDCE=GECADDEFC=DBDGADECF=CEFC9F:BEDCCGFDDECDGDCCDBCGGGFCECECFGCEGEFBCEDBC?AECGCBC>CEGBCCBFCCDCCBFEBEEBCECBBGACBBEFC=CDBCBBFGEGAGGE7DF?@DABB@>??:><C	G	127	C	107
19	36051556	T	45	tttTtTTTtttTTttttttTTTTTTTTTTtTgTgTgtgggggggT	AC?<C5:?CADDDGGGFG@=FFDE@FFFD;D:DDED9A;CD977?	T	35	G	10
19	36104890	C	130	ccCctcTTttctctCcTcTTTTcCCTTcttctcttccTttttcCttTCTCCtctcTttctcCcctTTTttcTTCTCTtCttTtttctTTTcTTctTtcTcCTcCtctttctttTTcCttcTccttttCtt	CC>ACA@CCDDDBCCDADFGGGCDDDDDEEDEDEEDDGEEEDDDEEGDGDADEF7GF@EFEAEEFFGEFFEGGDGDGEDFFFEFEEDGGFEFFEFFFEFECFECFEFFFDEFFEFECE;DD?@A;>>C@B	T	80	C	50
19	36105908	G	100	AAAgAGGGaAAGAGGGagAGAGaaAGaAGGAAaGaAaAGAGAGgAGAGAGGAAAAAAAAAGAaaAAGAAaGAgAggGAAGGAgAGAGGAAgAGggaGgga	@9HFGCCCCHFCHC6C;GHCHBEEGCEHCCHHBCEHEGBGAFBGHBGBGBBGGGGEGGGGBGFDGGBGGDBGBGGGBGG@BGGFAGBAGHEE?BA=<@BB	A	57	G	43
19	36134208	G	66	GGGGGGgGGAGgAAaGGGGGggggggggagaagAgaggggGGAgAaGgaAAgaAGaGagagAAggg	ABEDEEFE;EEFAFC9EEBEDFFFGFGEEGEEGEGEGGG;?DFGEEDBCFEGEEDADCG>GE?A;C	G	44	A	22
19	36223111	C	80	aAaaCCAAcCccCCcaAacCAACAAcCcCacAaAAcaacACAaAAcCCcccaAcAACCACcAaaAccccAcaaCccAaaA	@DDDDDHHGDGGDDGDHEHDBHD;GHDHDEGHEHHGEEFFCHEHGBCC;HDEHHGGCCGCFGEEEHH=EGHE>BDDD=@C	A	41	C	39
19	36223747	A	107	GGAggAgGaagGGgAAGAGagaAgGggagagggaaGGAgGGGAAAGGgaAGggaGgAAAaGAaggaAGGgAgAaGAGgaGGGggGGGGaggAAaGAAGggAGggAgG	>=ABC>CCFECC>CHACHCFCFICCCCFCFCCCFFCCHCACC@HHBBDGACDDGCDGGG6BGG?CHGBBDGDE?BGBDGBBBDDBBBBGCCGGG7GBB9C@A@>C<?	G	65	A	42
19	36228667	C	82	TCttCtcCcCcCcCTtTCccCtcccCcCtTtttCtCctcCcTCcctttTCtTTCccTTTctCCTCccccTCcttTCtTCCtT	=EGFFGBFBFBGBGDF;FBBGGBBCBBDHBH9<EGGAGBGBDGCBGH=F@HAEDCCDA@CIFFDFBCCCEFCHHD>D@ABCA	C	46	T	36
19	36255847	C	98	tTCTCTCtttTTtctTTtttTCcTcctctCTTcTTTttCCcTTCCctcCCcccCCtcTtCTTTTTcCCtTCtcTcTTCtTtccccCttttTTtTTCct	CBBBABBCCEFGDDDEGEEEGGDGDDEEEGFGDGFFEFEGEGDDGEFEFGE7BEBFEGFGGGGEGDFFFFFFEFEFF=FFFEEDAFFFFDGCBBBC@B	T	57	C	41
19	36273230	C	42	GCGgCGCGGCGGGGCCCGCGCCCCGCGGCGcGGCGGGGCgGG	DFEFGEGEEGEECDDFDDEDFEEFDBDDDDEBDEDCDCCDB@	G	25	C	17
19	36276403	T	73	tggtTttGttttGggtgtGTttTtGGtGggtgtgttgggggtgtTGgtggtgggtggtTgttgttggtggtGg	?@ABBEEGDEEEGFFEFEGFEEEEGGEGGFEFFFEDGFGEGFGFFGGFFGDGFGDGGFEGFEGFFFGEGBCCD	G	38	T	35
19	36317556	C	64	caACAAaCccCAaACCCcaACCcaacAcccCaaaCaccCaAcCaCacaccaccAcacccaccac	DB@E?FDFGGGFCFFGFGDFFGGDCHFGHHFEECGEGHFEEHEEEBHEHHEHEEHEHEGCBB?E	C	37	A	27
19	36321910	G	94	gGGGggAaAaAAagAgAaGgaAAAaGGaGAGAGGGgaAGAgaaAAGAGAgAGGAaAaaaAAgaaAaggAgGgaaAaaGGGagggaaaGggGgga	@<BABCHEGFHBFCHCBFDBFHHHFCCFCHCGCC6DG5=HDGFHH>HCHDGCCHFHGGEHGDGGGGDDG@BA8EGGGBBBGD@DGGGBDD??=C	A	51	G	43
19	36564449	A	46	CaaaaaaaCaaaaaCaaaaaaaaCaCaaCaaaaCaaaaaAAaaAaA	@CC?=D7C:EEBDDAABE?DD=;8A=5;8E7E=@=F5BE@F;>@>C	A	39	C	7
19	36581263	G	56	CCCgCGGGGGGGCCCGGCGgGcGGgGGgGGCcGGGGGGGGCCgGGCCgCCGGGCCG	BFFC?EEEEBEE>EGDEGEDE?EEDEEDDDEADDDDDDDDEFDDDEF7ECCBCAAC	G	37	C	19
19	37465414	A	91	AAGaaggGAGaGggagAgagAAAGgaaaAaGagaaAggagggaggagAggGAaaGaggagaGggaagagaaagagGaaagaagaagaaaag	EC>CDBCBDBECBCFCHCFCHHHBC@FFHFCFCFFHCCFCCCFCCFCHC=CH@ECFCC<DGCD@GGCG@GGGDGDBGFBEHGDGGDFGG?A	A	49	G	42
19	37482068	T	133	GGTgGGTGGTGGTGGtGTTGTTGGTTtTGTGtTTTgGTgtGTTgGTgGTGGGtGTTgGGTtGtTgtggggTgTGGTTTGgTGTTGTgGGGGGtGTTGGTGGTGTTGgGggTTttTtTTTGGGTggTgTTTgTg	@>EFHFEHHEHHEI@EHD<GDDDHEEFEHEGFB9DG;EGFGEEGHEEHEHGGFHCDGGGEB?FDCFDGAGDGDGGDDDFHDGDDGDGGGG?GFGDDGGDGGDGDDGGGGGDDFFDFDA>FFE>>AB@@>@??@	G	70	T	63
19	37482772	G	37	gaaGgaGAAAGGggaGaagAgagagagggagagagAg	BEEECFEFCFEE8DFEGFCFDGDGDGDDD>DGEGDE@	G	20	A	17
19	38040076	C	65	cccccctcctcctcCccttctccccccctccttcttcccctcCtttcctctCccctctctccttt	?BA>B>BBCEDCECGDDE?DEDDDDD@DEDDEEDEEDDDDC>FEFFDEEE9G@EEFEFEFEEFFF	C	42	T	23
19	38314767	A	73	AgaaGaAGGAGAGGGggGAAaGGAgaAAGGGgaGgAAGaaaAGgAaggGgGGaaGaggAGaaAgGAaAaGAgg	ACCADDDGGFGDFGGFFFFFDGGFGCEEFEFGEGGFEEEEAEFGFEGGFDCCFFFEGGEFEEEGFEEDEEBBB	G	38	A	35
19	38652993	C	79	ctCCtttcCtctccCCccttccTcctTtcctttcccTTTcTttCTtcCCtCTtCctcctctttcccccTCcctTttctc	C?<>>CDECECDDDDDDDEEDDGDDEGEDDDE?DADAGGAGEFDFFED@FDGFDEFEEFED:FE;EEBFCEDFGEDDCB	C	42	T	37
19	38709552	C	178	TTTTCtcTtCCCTCCtTCTTCCCTTCCCtTTTTTCCTCCCTTccTTtTcCCTccCtCTCCTCcCTCCTTTCCCCcCTcCCCCCTCctCTTCcTCTCTcTCTCTtTctcCCCctCCCTttCTCCCTCCCCtcTTTTCCtcTTtCTCCctcCCctCTtccccCCCtcCCTctCttttCcc	@@??BECEEG>GEGGEEEEEG?GFFGGGFEEBCEGGEGGEE6EEECFDD<GBEEGFGEGEEGEGEGGBEEGFGFEGCCGGFFGDFEFEDDFEDFDFD<DFDFCFD:EDFFFEFFFFDFFDDFFADFFFFFEDDDADFFEDD=DDFFEFEEEEFFCFDEEEEFE@DGCCBB>A?<@?BB	C	102	T	76
19	38826947	T	46	cTtCCcccTTCTtttTcccCtctcCTCcCctCtTCcCtttttcctc	B?A?EFFFEEEBEEEEFFFF=CEFGEBFGGF>FEEFGFE>FFG:A9	C	25	T	21
19	38912597	G	35	AgGaAAAGAAAGGgAAAAAGaGGGAaAAAGGggaA	@DGDEFFGFFFGGGEEDEEFEFFFEEEEDFC=B=?	A	21	G	14
19	38912764	A	105	GAGAgGggAGaAGAAggGGGGGGGgaGaAGaAAGggAgaGAGGGggGAGAAaAGAGggGGGGAGaAAgGGGGGgaGaaGAAGGgAaGGGaGGGgGGGagggGagg	ADHEFGFFEHFCHEEFFHHGHGHGGGHFEFGCEHGGEGGHEGGGGGGDGDDFDHEGGGGDGGDGGDDGGGGGGGEGGEGDDGGGDGFFF<FFFEGGDAB??C<?B	G	69	A	36
19	38949904	C	80	CCTTCcTCCTTTCTCTCtCCTCcCTCTtCTTTTtTcTccTtTCtttCctctCtTCCctcTctTCcCTTcctCTTttcccc	DCGGCBGDDGFCDFDGEGEEFC6DGDGGDGFGGGGCGC;GHGDHHG?CH@HDHGCCBHCFCGF<CCFFC=HCFDC==>;;	T	41	C	39
19	38950947	C	33	CTTTCTTTCCCTTTCTCTtTCTTCCtTTttCtt	FEBEGEEEGGGEE:GC=DECFDDFFFDDDEC<@	T	22	C	11
19	39068774	G	71	CgggGgggGggggggggggCggCGCgGCGgggCGggggGCGgGggggGGgGggGgggggGgggggGGGgGG	<CDD;EEECFFEFFFE:FFDGGA;>G;>>FFG7AEGFF>C=FBHGFFB@GBFFBGFFFFB@:BF@B@=??C	G	64	C	7
19	39196736	G	110	AgAGAGGGAGAAGAGGGAGAAAaAGaAAgAGGgaaaGGAGaaagaGAagAGAAAaaAAGGAaGAAGAGgaAAaAgaGaAAGgaAagAgggGaGgGAAaaaGAGaaggaGg	C?B=A@=CHCHHCHCCCHAIIBFHCFHDF5CCGFFGC5ECGGGGGCHD@HCHFHFFHHABGGCGHBGBFGGGB?GGBGGGBGFGGGGGGFBFBGBGGGGAAG?B@@?@CD	A	63	G	47
19	39226249	G	31	gaAGgagaggggggaaGgggaaaaggaaagg	?DBDBECFCCCCCCFFECCCF>GGDDGGGED	G	18	A	13
19	39334830	C	41	cTctCtttCttttcTTctCTctccCctctttctccTccccc	DAD:FDDDEDDDDGEFGDFFGDHHGHEHDEEGEHEDHHHDF	C	21	T	20
19	39338125	G	109	AgaGaGaagAGaGagAaGGGAaGggGaAgGAgAgAAAaGAAGgGgAAAgagAgGGgggGggGAAgagAGGAGAAGGaaagaAAaGagaaGaGagaagaagaGAgggAAg	ABD8ECEEEHCECCEHEBC@HECFFCEHDCEFHFHAHEBHHACCFGHH<FGGFCCGGGCFF=FHGFGHCBGCHFABFFFGFCGFBFGFFBFAG@FFGFFGCBGDGEECA	G	55	A	54
19	39360720	G	57	gaGagggaggagaggggGggaGgaggAgaAaggAaAGAAaaGgagggGgAagagaaA	=D?GDBCFBB>CFCCCCDCCF@@FCCF7FFFCDFDFE8FGGEDFDDDDDEGBGDG?C	G	32	A	25
19	39589189	C	88	tTCCTcTTCCCTTCTTcCTcTTTCcTtTCCtCtccCTcCCCTCcCCtTTtccCCTCTcccCCttTtTCTcTttttCCTtctCctCCcT	7EDBGDGGDDDFGDGGDDGEGGFAEGEFDCFDB@E@GEDDDGD@CCFFFFEACCFCFEDECCCFFFFCFEFFFBFCCEFE?CDCBA=D	C	46	T	42
19	39915758	C	70	GcCGGCCCCCgcggCCgGGCgGGGCcGCgcgCcCgcGgGCgcCgCCCCgCccGCGGCccCGgGGGGCggc	<DDC@DDDDDFDDFDDFCCDG?CBDECDFEF@EDG@CFCDFDDFCCCCFCEEBCBBC<ECBFBAA=BBBB	C	36	G	34
19	39991237	C	140	gGGcGcgCCCGCCGCcCcGCGGgGCcCCCCGGGGgGCgGcGGcGcgcgCgccCgCcCCggGCcgCCCgCggccCCggcgcGCggGGCCgcGcCccCGgGggcgGgCGCGgccgggccccgCCGGgccgCCCCggcCCcGG	A:;A<BB?@CACBCDEDFCDCCFCDF?DDD>CCDECD@CFCCG9FFFGDDFACGDGADGGBDGFDDB>DGG5GDCGGDGGBDGGCACCGGBGCGGCBG@EGGFBGCBC=EGGGGGGGGGGCC9AGGFGBCCBFFFBAB=>	C	73	G	67
19	40224901	G	30	AGAGAAAgAAGAAAGAGAaGaAAGAAAGGA	HAHCHCHDFHAGCGBGB?GBGGGBGFF@C?	A	20	G	10
19	40360845	C	119	TtTCTctTCTTCTTTtCCTTTcCtcTCCTTcCCtCctTTCtcCTTtccTTCTCCtTtTCtTCCCtctctttTcCttTTtcTCccCTCcCctccCtcTtctcTTTCCttccctcttttct	CC<@?<BCAEEGEFFEGFFCFDFECFEFFE?FF6FDDBEFEE8DFEDEFFDFFEFFCFFF@FGFEEEEFF<EBGDEECFEEEEEFEEE?FDDDBFEEEEDE7EEEFEFEEE9EFEF<A<	T	65	C	54
19	40424269	C	256	TCCCCcCtttCCCCTCtCtTTCCCTTTCttCCctCCTCctTTCccTcCTTCTCtTtCCcCcTCCcCCccTTTCccTCCtcCCTTCTCTTttCcCccTCCtCcctCCctCTTtccTCctTcctcTtCccTcctcCcCTTCCTTccTCCCCTtCccCTccTTCCcTTTTctcttcCctCttCtcctcctTCTctCcCTcttTCtttTCTCctCCTcCtcTTctccTCctTctTcccTTTctCcctttctcTCttCccc	A:><<BCEEDBDDCEDD?EGEDDCGGGDBEDDDEDDG@DEFGDDDGDEGHDG@BGEDDD>DGDCEDDDDGGG<DDGDDECDDCFCFDDGEEDECEEDD7FCEEDCCEFCGFFE>GDEEGEDADGEDCEGEEFEDEDGGDDGGEEFDDDDFFBDECFEEFFCDEBFAGE:EEFDCEFCBFCFEEEEEFFCFEFCECFEFFECBFEDCFCEFCCFECFEFFEFEAFCEFFEFFEEEFEEEFCD7CABAA?BA>?A>=@	C	145	T	111
19	40739721	G	105	GGTTTGTTGGGTGGGTTTGGTTTgGtgGgttgTGGGGttTGGtggggTtGtTgGgggTgGGgtTTggTGTtTgGTTTtGGTTtGTTgtGGTgtTTGtTttTGgtt	@??EFEFCEEEFEEEFBFEEEFEFE;EEGDE>FEEEEEE?EED>F;>DEDDEGD@FGCGDCEAE6GGEC>EEGDAEEEDDEEEDECEECC7FEECCBC<?AAB;@	T	53	G	52
19	40883844	A	164	AccACcacAaacaaccCCcaCCcaAcaacAaacAacaCAaAaCcCcAcAaAAaAAaaAcaAACAaCaaCACacaACAACACAAAAACCAAACACCacaAaaCAaCCAcaCCcCCaaAAaAAaacAaacacaACaCCaACcaaAccAaAccAACAcACCaaAAAa	BC?A>>ECHFFBFFBBDD<FDCBFHBFFBEFFBHFBF>HFHEDADBHBHG>HGGGGFH:GHEAEGCGGDHDF;GHDHHDHDHGGHHDCGGHCHBBFCEGGGCG>?CGCGCCCCCGGFGGGGGGCGEG@E5GGCGCCGGC=GGD8CGDHBBEEBD>B??B?AC?D	A	100	C	64
19	40884160	G	47	GaggggagaggggagggggaGAAgaaaaaaagaAgGgaaAgAaggag	>B>CCGCEEEEEDDFEFEEECGGFEEEEBDEGFGFBGEDGG?FGGCF	G	25	A	22
19	41117754	C	86	AcCaCAAcacACaCACAcaACCaaaCCCAaCAACaAAaAAAacaCACCccCcacCaacAcACCACCCACACACACCAAcACCCcaa	>CCEDH<FFF=DCD9DGFFHDDGFECDCHGDAHDGHHDHGGGGFABCCGGCHFGCEGFGGGCCFCCCGCGCFBGCCGGDCAAA<BB	A	43	C	43
19	41255500	C	35	gGggcccggcgcCGCgcgGgcgCcGgcCcgcGgGC	DECCABBCCBCBFGGCBCGCCDGCGDCFCEAFDFB	G	19	C	16
19	41257176	G	33	GGGGCCCCGCcGCCCGGCCCGcgCCcGGCGCgC	=HGHGGGGHGEHGGGHAGFFFEEFFEGFFGC8C	C	19	G	14
19	41759637	C	45	CccAcCccttccTctTCCtctttcttttttctccTcctcttttcc	A>A5BBDCEEDDGDEGCDEDDEEDFDCEEFDEEEFEEBEBFCFD=	C	22	T	22
19	41762347	A	121	CACCCAAAAAAAACcAAACaaaCAACACAcAcAAAccAaCACaAACCCAcAaACCCAACACaACCACaACCaAAaCCcaaCCACACAcCCaCCaAAACaCAAACAAAccacCacacAaCac	DC?AA>FFDFEFEGFFFFHDE<GFFG<DFFFFFED>GFGFEGFFFGGGFGFG?GGGFFGDGGFFGFEEFFGGFDGDFGF=FFDFECEGFFGFFGEDEFFFEEEADDDGFFGFFFBB>;B:D	A	68	C	53
19	42753020	G	128	gagaagAggGaaGAaGGAaGAGagAggGaaGgggGaaAGGAGAgggGaGAgGgggAgGgGaGgggAGaaggAagaagaAAgggAgaagagGaaGAggaGgGAGAaAaAaggGAgggAggGGaaaAGGG	AC@B>A;CCAFFBGDCCHEBHCEFGFFCAECFEEBECHC@BCHDF<A?CDECFGFHFCFBFCEFGHCFBGFHFGEFFFHEFFGG=FFGEECDFBGFFDBGBGBGFGFGEFGBGGG<GGGB=<A?AC??	G	73	A	55
19	44005804	G	87	AGAAGGGGGAGAGGAGGAGGGAGGAAAAGgGGGGGAgGGGAGggAGGGGAgAAGAAagAGgaAaggagGGGaggGgGGGgggggGgg	=<;CACCCCGCHCDIACBCBCGCCEGHHCDC=CCCGDCCCHCDCH?CCBADHHBFHGDG?DGGGDDHDBBBHDDBDBBACBD>9>AA	G	60	A	27
19	44050966	T	124	TcCTCCTTTtTCTcCTCCttTCTTTcCttTTCCCCCCcTCTtCTctCCTCTTTTtCTtCttttCCCtTCtTcTCtTctCtcTctCcCTctTTCccccCCTTCctCCCTCcCCcTcCtccTccCt	BC?>EFBEBEAE8FEEAGEEEFFEEE@EEEEGGGGGGGEE6B@EGFGGEGEE;;AEE@GFF@FFFGFDG:DGCFFDG:FGGDGFFGFBGBDDFGGGB<FDDFGFFFFCFGFFGDGDEEC>AAC@	C	65	T	59
19	44081288	A	27	GGAAAGgAAGAgaaAGGGAgGGAGAaa	<?;HFCGHHCHGFFGBB@GGBBFBG?A	A	14	G	13
19	44130453	G	104	ggaaAgaaaaggGagagaaggaAGggAaggAggggAAggagaggaagAggaaaAaagAAagGagaaaggaaagAggggagaaagaagggagagggaGgaaaaga	?CC?GCFFFFCCCFCECFFCCFCCCCHF@CFACCCFICCECCCCFGDAACGDDHGFCHGBDCGDGGGDDGGGDHDDDDGDGGGDGGDDD6DGDDCGBDGAGGDF	A	54	G	50
19	44156472	T	85	TCTCCTTTTtCTTtCCCCctcTTTTtCcCCTTTCTctcTcTCTTcCCcCCCtTtttCcTCctCCctCctTcccTTtCCcttctCt	D@FD@>FGGEDGFEEDDDFEFGDGGEDGDCGGGDGGEEGGGDGGF=DGCCDFFFFEDGFCFECCGECGFFGGEFFDBCF@CB@AC	C	43	T	42
19	44663805	G	30	gGaGAGgGaAGaAAgaagAGAggaGAaaga	A@DGFGFE5FGDFFGFFFEGFFFFFAF=B;	A	16	G	14
19	45213701	C	70	TCCTCTCCCTCTCTTcTTTTCTtCTTTcCTCTTCTTCTCCTCTCcTCttCCCTTCCTCCCCTTtTTCTTT	D?@AFDGFGEGFEFFDFFFFEEDFEEEHFEEEEEEEFEEFEE>DHEEEDEDDEDDEAEDFEFF7DDCC?C	T	38	C	32
19	45396144	C	52	CCCTTTTCTCCCCcTTTTCTCCCTTTTCTCCTtcTCCCCCTcCTCtCCCCTC	FGGEEEE?BDGFGCEEEAFEFFFADDCFDFDDHBDFFFDFDCFCFHF=CACC	C	30	T	22
19	45451656	T	86	TGGGTGGGGTGGtGTGTGTTGtGTGGGTGGGTtgGGGGGTgTgGGGtTGGTTTGTtTGTgTGGGgtGTgGgGGGGTGtgGgTttTg	FEEEEEEEEEEEHEFDAEFFEGEFEE@FDDDEHDEDDDDEDEDDDDHEDDE;EDEHEDEDDDBCDHDBEDDCCCDCDC><<B=@C;	G	53	T	33
19	45493635	C	57	GGCGCgCCcCGGGCGCGCGGCGCCGcCCCGGGGGGCGCGcCCgGcgGGCcCgCgCCC	BCDCBFDCCBCCCDCDBDCCDCDD<E9CCCBB@BBCBCBECC;BEFABB@B@8?A@?	C	29	G	28
19	45528799	T	63	ccttcCctttccttcCccTctttctCTtcCttTTCTTCTtCTTTtttTCCcCTTtCTcCCTTt	EGEEFFFEEEF=CEFFFF?FEEEFEGFCFGFF@ACF;DDFEDEE7EDE=EGEC>FEBBEEEA=	T	36	C	27
19	45574113	T	39	gGgtgggTgtggTggTTtgGGTtTTtGgTTTTtTTttGg	@=A@CCCEBGCCCCCAEGCEBFGDFGECFEFEHFF@HDD	T	21	G	18
19	46032841	G	44	cccggccgccGcgggggcgcGgggcggcgggccccggccgGcgc	CA@BCCBCAACBC?CCCBCBCCCCBDDCDDDCCCB@DCBEBCDC	G	24	C	20
19	46119867	C	64	acacCccCAcAccaccacCaCAACaacaCAcacaaaacacacacAcaaacccaccccCAcacaC	C?CB?ABC:CDDDD@DECAEGEEGDEDEHDDECEEEED=EFEFD6EEFFDEEFEEEEFBECE>B	C	35	A	29
19	46124950	C	81	gGCGCcCcCCgGGGcCcCGGGGCcCCccCCCGCGcCgggGcGGGcgggGgcGcccCGcggcggggccGccccgGgGggggc	C><=9A>DCBDBCBDDDBCCC@DDDDDDDDDCDCDDGFECECCCCFFECGECBEEDCEGFEFFFFDEBDEEEEBEBEFGGE	G	42	C	39
19	46142053	C	30	CTcCCCCTTtCTTTTcTTTTTtcCcTtCtt	:EGFEDA:EECEED;HDD@DDEHF?B>?BB	T	18	C	12
19	46274972	A	122	cCccCCCAcacCCaacaCAcCCAAaaCcccaAaaccCAaaAccaaCAaaAAccAcCacaCCaCCCaaaccaacAcCaaaaaCcaAcAAAccAcCCCacaAAACAACAAcaCaCACaAaAcac	BB:C=@@;>GFEFFFFEAFFGEEFFFGFFFFFFFFFBFFFDFFFFD@FFFEFFEFGGGGGGG<GFGGEGGGGGFDEGEEGDFDGEGEEEGFEGFFFGGG9EEFEEEEEG@EGDDEEDAA@@D	A	63	C	59
19	46289503	C	139	CTCtTTcctttCcCCttctcCcTCcctcccTcCCTctctTcCcTttTccttCCcttTCtttcCTCCctcTCTtCTCCctCTCTCCTTTcTttTctTccTTttcccctttcctctcTTtcttcCtcttTctTccccCctc	B?@CBBA6HHF=AGEFFBGBFAFFBBGBB<EBEFFBGBGFBGBFHGE9BHGFGBG8EFHHH<GFFFCHCED;EGBFGC:GFGFFFDFFCFHF=CHDBCECHCCCC=H@HCCHCHDBD=CHHCEHCHHECHDC;@?B<C:	C	71	T	68
19	46289509	G	138	gAaAAggagaAaGAaagaaaGaAAGagagGaAaGggGaaggAAaggGAgggaAGAAagaGAGgAGAAagAGAGAAGGGaGggGagGaaGGggaaaagggaagGagaGGgaggaAgaggGagGaaaaAagaAggaggag	A;ACBBBDFEGDCHDDFDDECEGHCEFEECEHECFECEBFDHHEEECHEEFEHCH;FDECCCFH8HEEGGBGCHH<CCECF67EFCDFCBGFFB@EGGFFFG=FGF6B><CGFGGCFEBFFBECBFG>FEGEDCB@>B	A	70	G	68
19	46417429	G	38	AGAGAAAAAAAGGaAGaAAAaAGAGGgagAAGaAAAGa	DEFEF>E@FEFEE>EDGEEBGEDDDDDGDEDDFDCA?C	A	26	G	12
19	46518682	G	36	GGGGaGGGggAgggaaAggAGgGgagGGagGggggg	C@B;ACFGCCACCCGEFBDEFDGDGDGGGDGEEDDB	G	28	A	8
19	46520026	A	43	ggggagggAgaaagaagaaaGAaggaaAaaagaAGGAaggaaa	A@CCFCCCHCFFFCFFCFFFCHFCCFFHGFGDGHBBGGDDGE@	A	25	G	18
19	46521526	A	211	GGGAgGaAAaAgGGAAGGGAagAGGaGGAGAAAGGgAAGaGGaGGAAGGAaGGgGGGaggagaAGgAGGagAAAAGgAaGaggAAAAAGgaaggGAAAgaAGaggGAAgaGgGGAGgaGGGGaAaaaAGaaaAAgaGaGgggagAgAAAAAaaAaaGgAaGggaAGAGAAggggggagaGAGgaggaaaaggAAAGGGAAAgAAAaAaGga	<;;@B>CEEGGFCCHHCCCHFFHCCFACGCHHHC@FEHCEADFCCHHCBGFCCGCCCFFFFDFGBFHCCFFHHHHCFGGCGFFHHHHHCGGGGGC9HHDGHCGGGCDG<FCFC@GCGGCCC?FHFGGHCGGFGGGGBG?>GGEGGGGEGGGGGDFG@HGEAGHGGBGBEGFFFCGCGGFBG<CGGFCEFGGGEFGABBGFFEEDDBC@:@@	A	108	G	103
19	46890247	G	29	GCCGGGGCCCGCCGGCCGCCCGCCCGCCG	?FB;EEFBF9DFDDDDFE@EEDEEFCBAA	C	17	G	12
19	47282162	G	208	GaAAGAAGaagAGgAagAAgGGAAaggaGGgaaGAggAaGaAaagagaGGGGaaaaGGAAAgaaaAaaGGGaAGGaaAggaGgaaAAggGaGgGAagAAAggggggagaaAaAggaAaaaGGAagaGaagggAGAaaGAGgAagAagaaGGggaggGGgaaggGGgggaaGaGggAagggAAaaaaGaagAagggaGaagaagaGaaa	@CC@>CB?DGFF@EHDEAHECCHHFFFFCCFFFCEFFHCAFHFFFDFFCCACEFFFCC<HHFFFCEFFC>CFH>CFE5FFFCGGFHGGGCFCF<AFGHHHCGCGGGGGGG=GGGGGHGGGCCHGGFCGEGGFHCHGFCHCFHGGHGGFFCC?GGGCABGGGGGBBGEGFFB=BFCGGFFGGGDGGGBGGGGGGGGGBGFDFDBB<:?D	A	110	G	98
19	47588500	A	39	aaaaaaaaaaaaaaaaaaaaCCaaaCaaaCCCaAAAAAA	DEFDEEEEEEDDEBEEEFBE9DFDD9FFF?8?FFHEB@C	A	33	C	6
19	47876807	C	34	GGCCGCGGCCCGCCCCGggCGGGCGGgCGggccg	@HGGHGHHGFFHGGFFGGFFGGGFGGGFG?FC@@	G	19	C	15
19	47882957	T	57	CCTCCtcCCCTCCCTtcTtTTcTTTTTTcTccCTCctTcTCCCTCcTtCCcctCTCT	@@GDEEADD8GDDD:FEDFGGEGGGGGFEFEECFCEAFEFC9CFCEFFCCEEDAC?A	C	31	T	26
19	47918260	T	27	TTTTTTTTTTTTTTttgTgtggtggtg	=7F=CFE:F?FEEE;D9D7A<C9@>=A	T	20	G	7
19	48184547	G	74	AGAAgggAAAgGaaGagAGagGgggaaggGGGAgAGggaAGggGggGagggagGggaggagGaaaaGaggGggg	B@A>BCCB@ECEFFFFCFBFCECCCEFCCEEDFC@EDDGEEDDDDDEFDDCEDEDDGDAGDAGGGFAHDDDDD=	G	48	A	26
19	48198796	C	48	GCcgcggGccCCcGggGgCGCGCgcgcgggcGCccGcgGCGcCggcgG	AFGBEFFEFFEGFBFFEFG;FEEGGGGGG?GDFBFDGEDFDGFGGD>A	G	26	C	22
19	48254392	T	62	cCCtCttcttcccCcttCtTccttttCccttttCctccccctcccctcttcccttctccctT	C??FGGGBGGBBBGBGGGGGBBG8GCHBAGE<GGCGCCCCCGCC5BHCGHCCCHHBHCBCCB	C	35	T	27
19	48260079	T	42	tCcttttCtcCctcccctTttccccccttccCctctcctCTt	C<DEDDEGEDGDED<DDDDEEDDDEDDFFAD9EFEFEEFFDF	C	24	T	18
19	48305357	G	88	AAagGAGGgAGGgAGGAAagAaGAGAGGAaaGaggGGaagaaaAaaGGggaaggAgGGGAGAAgagagGaAAAggGGAaagAGgaGga	DGECCGACCFB@BHCBHHFDHFCHCHCCBFGCGDDCCGGDGGGEGFBBDDGG?DGD?B>GBGGDGEGDBGGGFDDAAFFFB>>>AC?<	G	45	A	43
19	48337897	G	29	gaagaaggaaaaaaagagggggggggaag	CACDCFEFEEEEEEEFE:EFEEGEFAFFF	G	15	A	14
19	48622545	A	30	GAGaAgAAggaaGaaAAaaaaAaAggagga	5@;BGFHHEE7ECEDFEEBCB:BGFGBFGA	A	20	G	10
19	49170468	C	29	aACAAAAAAACCCAAAACaCCCAACCCAA	DEGEEEEEDBFFFCDDDFFFFFDDFDCA@	A	18	C	11
19	49377242	G	78	cCggCCCcGcGCcCCcgcGCccGCccGCGCCcccGgCgCcgggGGCCCCCCgGccGccGgCgcGGCGcGcGgGCggCg	?<CCDDDFCGCEGDDGGHCDHH=DBHBDBDDHFG@GDGDHEGECBCC@CCDGBHABIGBGCFHBBCBHBHB==A>BCD	C	45	G	33
19	49424381	C	38	AAACAACCcAACCCAAAAcACaaaaACCaCACcCAcCc	FEFFFFGFDFFFFFDEFEEEFAFFGEFEFFEEEFEED>	A	20	C	18
19	49447713	G	126	AAAAAGGAGAGgAggGaGAGGGAGAAGAAAaGAgaGAGgaAGgGgaGagAAAgGGagAGGgAGGaAAAAAAGagggagGAAaaGAaAaagaAAgAGagGaAgagGaGGaaaaGgaAaaagagaGgg	AEHHHCCHC?CCICBCFAHCCCACGHCHHGFCACFCHBDEHBDBDECGDHHHDCBGDHCADFCBAHGHGHHCFDDDGDBGGGGBGGGGHDHGGDGBFDBGGDGDBDBBBGFFACFCABA=><?AAA	A	68	G	58
19	49485719	G	26	ttGTtGgTgtggttgtttgttttgTt	GFG>GHC@CGCCGGCGGGDHHHGDDE	T	17	G	9
19	49513349	C	119	gccgccggcCcCcCgcgCCCgGCgCCcgcccGggGcgcgggccgcGCGcccGggGcCcgCgcCGcgGCGGcccGCGggccccggGCgcgcGggcGgGgGGGCgggcccccCcCCgcCCg	ABC@CB?AB6EDFCEEEDDCFCDFDD;FFFFCCFBFEFFF=FFGFCDC?GGBGGBGDGGDCGDCGGCDCCGFGC=CFGGGFGGGBCAGGFBGGGBGBEBBBCGGGGGEB=BGBBF??@D	C	63	G	56
19	49513730	A	31	CaCCCCCACCCCCaACCCcaACaCaaaaaaa	@C9CAD>;@9D>DD?DC?8;;?F8B?=E;@@	C	17	A	14
19	49632079	C	209	AcCAaCACCCCACCcCcAccCCAAACcACCAAAacCCCaaCcccaCacaAacAAACCCCAAaACCACCACCACcCcaAAAaCAcccAcACCCaCcaAAcAaaCCAAcCACaCcCcCAaccacaccaccACaaCaccAACCacaacCaCCacACacCAAaaCAAcCCcccAacaAcaccacCACccaCcaCCaaAccacAaAaacAAacc	:>CGEDG?DDDH;DFCFHFF8DHHFCFFDDHGGFFDD?AEACFE:DDFFHFFAFHDDDDHHFH>DCDDH@DHDFDBEH=HGDHFG;EGCDDDG>GFFHFDGFDDHHGDHDGDFDFDH=GAGGGF<GFGHDGFCGGGGGCCGGGEGCHCC>GGCGHCGGEGCGGGCCGGEFGGFGFGGGFGCGAGGFCGGBBGGGFEFDECCB=?C?DC?	C	114	A	95
19	49632772	C	29	tttCcccCttTtTcctttcttTtttccTC	?;@CBAAGGGGGGBBGGHAFHGHHHB;FF	T	18	C	11
19	49640002	G	49	GTTGTGTGgTGtTGGTGTtgGtTgTTtggggGGGTtggTGgGTGTtGGt	BEEG=EEHGEGAEHHDGCFBG>DEDDFFBFGGGGDFGFCGFGCGCDE?>	G	27	T	22
19	49838891	C	160	aaacaAaCAcaCacCaCaCaAcaaaccaCAaaAACcaacaaAaACaAaCAacACcccCCcAaAAacaACaacAAAcCCCAaaacaAcCcCACaacaacCaaCAacCacccACAAcaCCCaCAACcACcAaCcCACAccAcACcCacAcCAaAaAcAAAac	CACB=BCEECDEDDEEF@FEFDEEEDDEEEEEFFFDEEDEEDDFHEFEGFEDEGDDBEFDFEFFFEEFFFFCFFFEGFGFFEEEDFEGEGDFFFEEFEFCFGFEEFFEE;FGEEEFFFFFCDDFAEEEEFEEFE=EEEEEAEEE;EEEFEEEDD;?BCAC	A	88	C	72
19	49965131	G	70	GGaaaggggGaAGaaaGaGgGgggagaAGaagggGGagAAGAGGgAAAaggGaGGaggaAaaGggGAGGG	?=EDDACCCEEBEEDEEEECECBBBCE@BEE@CDEEFD?EEBEEDDDFFDDDFDDFDDB=AFDDDCDDEC	G	41	A	29
19	49965132	G	70	GGcccggggGcCGcccGcGgGgggcgcCGcccggGGcgCCGCGGgCCCcggGcGGcggcCccGggGCGGG	9>BAB9CCCEBGEBBBEBECECCCB<BEDCBBCDEDCDGFDEEEDG@GBDDDCDDBDDC@CBDDDCFDDD	G	40	C	30
19	49967808	C	107	CcTCttccctcTtcctttCTccCCttctCCTCCCCCTTTTTTcctcCtTCCTtTCTTTTTTTTTTCTTtCCCCTTtTTTTcCcTCtcTctTtCtTCctTcTccTtct	A=DCB@D;CDD?EDD<DEDGCD@BEEDEE@DCD>DDG@GGBGDEFEDFG>DGEGDGG@DGGGDDGDE>F9DB@FFFFFFFECDFCFEFEEFFCFECE>E?FA@C<@A	T	60	C	47
19	50169020	T	30	CTTTTCCTTTCTTcTCTtcCcttCCTtCTC	FEEEE@GEDEGECCDFDDCFCHHFFDHFDC	T	17	C	13
19	50305492	G	43	gggGgCCCgCCCgGGgggggggggggggggGGgggGGGGgGGg	DDF:FDD@F7>@F5<FGFAFFGGFGGFGEFAAGFE?@A??CC7	G	37	C	6
19	50399352	G	74	gagGaAGgaaaGagaGggaGggaggaagaagGGGaGGggaGggGGaGAgaAaAgaaAgggGgGAaaGGAAgGGA	@CCBFACCFFFCFCFCCCE8CCGCDGGDGGDCBCGCCDDGCC>C9GCHDGGGGDGGE8DDBDBGGFBBFH9>AA	G	43	A	31
19	50868754	A	41	AGgGGgGgGgAaaAaAaggAAgagagGgAaGGAaGAagAaA	?CFGGFGFGFFDDFDFDFFFFGEGCEGGFEFF9DFEEGEEE	A	21	G	20
19	50983930	C	158	ccctCCCtTCCTcctctTcCCTcttTCTTCtCtTTCctTCCTcTttccTTTccTTCCTCctTTCctCTctttTTtCCtcCCCCCctCCctcTtCttttTCtTcTCCTCCttcTCtCcccCctTTTtTTCccCCCttTTcttCccttTcctCTTttttt	C>@=BCCG@DDGB<GBCF@DDGBGGGDGGCG6GGGDBGGDDFBGGG?CGGGACGFCDGDCGGGDBHDGCH@FFGHDCHCCDDDD5HD@CGCFHDHFHFGCHGCFCCFCCHHCCCHCCCCCC9FFFHFFCCCCCCDHFF=HHCCCHGFC@HBCDCC@B>	T	82	C	76
19	51192569	T	86	TtTTTTTtTTTTTTTtTTTTTTTTTTTTTTTTTTTTTTTTTTTTTTTTTTTTTTTTgTTTTTTTTTtTTgggggTTTTgTTgggTg	:CDEEEF@F@FFEFF?=FDB6FDFEE:EFFFBEE;DFEDEE:FFEEDE=EEEEAD;>EAEAEEE>E5EED?DDBDCE@@AA;=>?A	T	75	G	11
19	51358333	C	56	aaccccCaaaccacCAcaCcAcaaaccaaaaaaaccAAacccacacaaaaacaaaA	?D>EFFDDDDGGDGDHGDDG@FDDDGGDDDDCDEGFHHEHHH=:EHEDEEEH7DEE	A	33	C	23
19	51376837	C	35	ggcCccgcCgcgCcggCggggcGgccgcgggcccg	@CFDEFFFDFFFDFFEDF;EFGCAGGGBBG?GFGG	G	18	C	17
19	51413802	G	51	GCCgGCCCGGGCGCCCGCCCCCCGGGCCCGcCGCgCGgGGGcGcGCCCGcC	@FFAEF?EBEEGEFFGEFGD6FFDDDEFEDCEDEDEDDCDDCDCDDFDB=>	C	29	G	22
19	51466516	A	31	GGAGGAAaGGAAAGGGaagAgAAAAAAaGAA	DFDGF?DGFFFEEF=FFG;EDEAEEEDEBBB	A	19	G	12
19	51503524	T	51	TtTTtCCtctTttTcctcttcctctctcccccttcctcctCtTcCTtttcc	=CCEGCCGAFFGGEBBGBGGBAD8GBG=BBBCGHCCHBCHEHECGEHHGAA	T	27	C	24
19	51522286	C	25	CTTTCCttCccCtctTTCCTtTCcT	:FCEB7FFGEE>FEFDE?FEEDDDA	T	13	C	12
19	51522291	G	26	CCCCGGccGggGGcgcCCGCcCGgCC	DDEDAAHHCGFCBHAH@CBCHCBD@B	C	15	G	11
19	51629585	C	26	ccaaaaacccccacaccccaaacAcc	C>CABDECDD<DDDEDEEEE;FDGEE	C	15	A	11
19	51694100	A	36	AGAAaaGAAgggAaagAgAaaGgagaagagaaaGAa	CCAADGDEFFFFF=FFFG@EGEGFGFGGFGHGEDEG	A	23	G	13
19	51767205	C	91	TCTCTTtCcCTTTTCcTCtCCCcTTcctCTTTTTCcTCcctTTCtTtCTTTCCCctTTCTcTTCTTCCTTttcctctctctcttCttCctC	FDFDGGDDGEGGGFDGADDDDDFFGHHDDGGGGFDHGDHHDGEBEFE>FF@ACCHBFCCFGFFCFFC?FCECHGEHEHEHEGD?D@@@@6?	T	50	C	41
19	51826854	C	152	TTTCCCCTTCTTTCCTTTCCTTTTTTTTTCCCTCTCCTCcCTTCTTTCCTCCCCcTTTTCTTCTCcTTTTTTctCTCTTctTCCTTTTTCTTTCCTctcCCCttTCtttttTCctCTCCtcTcCCCCCcctCTCCttcCTTtcCCCCtCTTt	=DEGFGGEEGDFEEG<:EGGEEE<ADEBEGAAEGEFGDGCG;EEE9EGGEGGBFCEDEDGCDGDFC@D<9DDBHDCFDD@HDFFDDDDDFDDDFFDCHCDFFHH:FFHHHHDFCGFDFFH@CBEEEDECCHFEGFDF@BCCC>9A9A@AC?E	T	82	C	70
19	51844978	G	54	gTtGTgtgGtgtTgtgGgttGtGTgggTTTgtTTtgttGTgGGTGgTtTtgGtt	C>B@BCFCDECG=CGCECEE?GDFCCBFFFDHEDHDHHDEDDDECDEFC>><C:	T	29	G	25
19	51869346	G	38	GAAAAGgGAAGGAGGGAGaAAAaAAGGGAgAGAaAGAa	EEB@FEGEEDCDEDCDEDEEEEEEECCDDG>CA?A??B	A	22	G	16
19	52220351	G	177	agGAGAgGAAGgAAggaAaGaaAagGaGaGgaaaagaaagGGAaAggaAaGGggaGaagAAGGgAGaAGAGaAaAagagggggGAAgaGAGgGAGggAagAgGaaaagggAagagaGagGAGgAgGaaGgaggAGgAGgAGgGagaaGgggGGGaaggaggagaAaaGGGaAaaagG	A?>@<BA>@B=BDDDFGFECFFHDF@EC>CFBFFFFDFFFCCHFHFFFHF=CFFCCFFFHHABDHCFH<GBFHGHEFDCFFFFCHHEECHCGCHCFEHG?H>:GGGDGFGFGGGGGCGGCHCGHGAGECGGDEGCGGBGGBBBD@B7BHDEBBA6GFGGFG@GGGGGAABEFBB?;?	G	92	A	85
19	52223180	A	35	AGAgaAaGagagGggGagaGaaGgGAggGaGaAAg	BBGFEGFC>FGFCGFBCGGCGGCGBGGGBE@GGGA	G	19	A	16
19	52693298	A	40	GAAAaAGaGGaAGGAaGagAGgAGAAGAGAGGAgGGgGag	CEA@FH9CA:=FBBGFAEGGBGG>GGBGBGAAAF@>?<;@	G	21	A	19
19	52719011	C	40	CcGGCGGGCCCCCCCGCCCGGGGGCGGGgCGCGGCcccGc	D>CBDCCBDDDDDDDBDDBCBBBACBBBGCBCBACC::<B	C	21	G	19
19	52719190	A	157	GAgAGAGaGgggAgagaGaAAAGaAAaGagAAgaGGAAAAAaGGGaaAGAGGGGGaGGGAAAGGaAaGaGGAGgAAaGGgaGaAAAagaAAGggGGAggagaggAAGAGgAAGGAGGAAaGggAaGaggGgGaAGGAgaAAAGGAagAAaaGAAgAG	@C@@=A<DAFFFFEDCDADHHHBDHHDBDFHAFDCCFHHHED@DCDDHCHCCCCCC6BCHHHCCDHECE@CHCGHG8=CGDCDHHHEFAHHAGGBBFEGECEGGCGBG>GGGBBGBAGGEBGDGEBEGGBGBEGBBGBEGGGAAFEGEFDC@EDA@?	A	81	G	76
19	52800516	C	50	cCCAAAAcCaACACAcaCcaaaaCacaAcacaccacaacaccccccacac	CCFDEDFEGDEEFGFFEGF@FDFGEFDDEFGDGCDGDGGGEGAGEG?GA=	C	26	A	24
19	52909303	C	125	CTCCCTcTTCtcCTTctCCCCTcTtTCCCTCCtcCCCcCTCcCCtTtTTcCTccTTcTtccTCtccTCttTTCCccCcctTCtCCtCCccTccttTTTTcTTtTCTTCctttccTcccttcctcc	>B??AFFGFDEFCGGFEDDDCHFHEGDDAGDDE@BDDF8GDGDDEGFGGGCBGGFGFGFGGFCFGGFCFEFFCCGDCGFFFCFCCFCCGGFGGDFFFFFGFFDFCFFCGEFDBGEFEDBBB>?;?	C	69	T	56
19	52941171	T	49	ttTtTcttCTccTtcCttTCCtctcTCtTtcTttttttcCCCtCtTtCC	?@?BBCED?EDDEEDFEEEFD?DEDEGEEDDCEEFFFF@FFFFFFDEEF	T	30	C	19
19	53345414	T	159	attTAATaaaATatttttaatTTATTtATAaatTaatattaataAatattAttATtaaAattaaAtAATatAtaAaAaAttaaaAtttaatTAaatatattaATtaatttaatataAttAaaaatattaaaaaaaatttaatttaatattttaaaattt	?AC@?>?DCFCDE=EDEEFFEEEDEEECDEFFEEFFEFEEEFEFDFEFEEEEEEFEFFEFEEFFEEEEEFEEEFEEEEEFEFFEEEFFGGFCEGGFFEFFFGECFFGFEEFFFGFGEFFEGGGGEGFFGGGGGGGGFFFGEFEFGFFGFFFFFGGEE<>	A	86	T	73
19	53573187	T	203	ggttgTGTtGtGTGGGGTTTTtGTTgGgtTttGTtTGTTgtgGGttGtGgggtTTggTTggGGgGTGgtgtTTTgTgTGGgTggTGtTGttTTgtttTGGGtGTtTgGTGTgtgTtggTtGGtgTGGtTgGttGGTTtttGgGGtgttTGGtTTtTTttGGgtGgtTGGttgTggTGTtgTgGgtGtgtGTGTgGtgggGtTt	CC?:?@C?BDDGDHHFGEDDEEHEEFFFEED6>EEEHEEFEFGHEEGEGFFFEFDFFEDFEHHFGEHFDFEEEEFEFD<HGEF7DHEEGFFBEGFDFDHHHFE>FE@HCHEGFFEFGFDFFGFGDHGFAGGFFGBCDFFFGGG<@GFFDC;FDDFDDFEGC=FGGEDGGFFFDGGDFCEACGFFFGEEDECEDBC@?@:@>AC	T	105	G	98
19	53804011	A	51	AaCCcCCCCAAACACaAcCcAcaCaaCcaCccaCAcacAAcAacAAacaCA	:<FFGGEGFFFCGFGFFGGHFHGGGFGGGFHHGFE@GHEEHEGGEEGGGGB	C	26	A	25
19	53804012	G	53	GgAAaAAAAGGGAGAagGaAaGagAggAagAaagAGagaGGaGgaGGgagAGg	@>EHDHHHHGCFHGFAFGDFEGEAHGGGAEGEEGGF:FBFFEFGDFFFDFGDD	A	27	G	26
19	53818603	G	72	aAGGGgAgggggGAAgAGAagAaaaGAGGAgAgGaAGaaGaAgaAGAGgaaaGaGaGGAGgAGGGgAgGAGG	?<ACEBFFFFFFEFDFEEBFFFFF5DFEEFGFGEFFEGGDGFGGFDEEGGHFDGDGDDDDGEDDDFDDB@A<	G	39	A	33
19	53884412	G	108	GggAAAGgAGGGgaGagGaAaaAAAGaAAAaaGGggagagAgAAAGGgGaGAAAGgGGGaggagagGgggaagAagaggaAgaAAaaGaggAaagAGAGGGAGggAAA	BC@?BCEEEDEEFDEDFEDFDDFEFEDFDFDDEEFFDFDA>FFFEEEGEDAFEFCGBDEEGDDGEGEEGGEECDEGEGFEEGEEEEDDEGGEEEGEDDCDDCDB?A>A	A	54	G	54
19	54080144	A	60	AAgGgGgAagagAaAAAGGaaAAGgGaaAgAAAAagaAGgaGaAAgGaaAaaGgAAAgAg	EFFEFEEFDFEFFEEBFEEFFFDEADFFFFFFFDEGFEDFCDFEDGDFFEFEDFEEEGEB	A	37	G	23
19	54209381	T	29	gGTTGGTTgTtTTTTTtTGTgTGGgTGTG	FEE:EEFDG:FDEEEEFEEEGEDDFECCB	T	17	G	12
19	54308554	C	80	TCCTCcTTTCCCTTTTcTTTCTtCCCtTtCCCttCCCTTTTCCCTCTCCTTttTCCcTCttTtCTcCtCCTTCccTcTTt	FDGG@FF?FDGGGFGBFFF<@?FGGGFGFGGFF:GFGEGGBFDFBFF7CF=FFFCFFFFFFFFFFEFFFFEEEGA6;BBB	T	43	C	37
19	54385820	C	52	cTtcctcccctcttCTctTCCTtTtttcttctTccctctccctcCCCtctTt	ADADCDDD?DEDDEDGDEGDDG@GDFFEFEEFGEEEFEFEFEFECCCFEFF?	C	26	T	26
19	54653572	C	49	ttttcTcctCcctttctttctcTCCctcccCcCtCttctctttcttccc	?A?BB??EDCFFEEDE5EEFEFGBDFEFFFD>DEDFFGFFFGGGEEGGE	C	25	T	24
19	54676763	C	76	ccttctttCttTCCTtCTctTcctttcCttctTTTcccTccttTTccTTtctccCctccTttTtttctttTtccct	CADDDDDEDDEG?DGE:FDEGDDDDE=EEDAEGGGEDCGDDEEFGEDFGFEFEEDEEDEGF5FFDFEFFFFEDCC@	T	45	C	31
19	54720896	A	64	AAGGAGAAGAAAAAGGAGAGAAGGAaGAGGAAGGAGGgAGGGGGgAGGaAgGaAaGGgggAAGG	@BA=HCHHCAH;HHCCHCEBGHCCHGCFCBHGBCG@B@GBBBBBDGABFGCBFGGBAB7ADD>?	G	35	A	29
19	54932733	C	28	cttccTcccccctccttCcctttctctt	CCB??CA@C=B@G=BGGDBCGH?CHCHG	C	16	T	12
19	55451890	T	105	ccTtCttcttcCtcCctctcctcttcCCcttttTCtctcttcctccCtcTctTcttttctccttctcCttcTtcTccttcctttctttctTTctctccttcctcc	CC?CBBBCDDDFEGEEDFEDFEFEEFGDFEEEEGGDFEFEEFFEEFFEFEFEGEEEEDFEFFEFFEFGF>FFFFGGG>FGGFFFGFFF6EGFGFGDGGFFGG:G:	T	55	C	50
19	55453134	G	75	aggAGagaGgggAGGAgagggagAAgaggaGGGAgGgAAAAGaGgGaGgggAgAAgGagGGgagaaggaggggaA	DFFFADDDEFFFFEFGFADFFDFFEFDFDDEBEFF;GF:FFEEE?E9EGGGEGFEGDEHD>GEFCDGGEFGFGEA	G	46	A	29
19	55501866	G	117	CGGCGCCcGCGCGGCGCCgCcGCGCGGCCCgGCGGGGGCCCGGGCggggGCGGCCGGGGGCgCGGGCcggggcGgGcCGgcCgcGCCGgGCcGcgGcgccgGGcgcGGGcgCGGCgC	B=AFBEEFHFHDHIGGGGFGGHEHGHHGGDGCFGHGHHGGGHHHGFFGGHGFFGFGGGGHFGFGGFFGGHHFGGGGGDGGGFGGFFFGFG=GGGCFFGGFGGGGGGGFGFFCECBBB	G	68	C	49
19	55512137	C	146	CACAcCcaccCAAacCAccCaAaacaaaaCCcaaacAAAcAcCcaACAaacccCaaaCaaAAcacAacacCAccAaaccacACCCCAaCacaaAAACAACaCCCcCCCaAcaaaaAacCaaAcCCacaCAccCCaaCcCAccacAa	@@@AAEBGBBGECEBGDA@FFCFFBFFFFGGBFFFBEEEBEBABFEF=FFAABGFFFGFFEDBFBEFBFCAEBCEGGCCF5EFGGGCGGGCGGEEEGEEGGGGGC>GGGECGGGGDGCFGGD@FFGCFFDCBFFBGFCFDCCF9AA	A	75	C	71
19	55529936	A	53	AAGGGAGaGgaAGGAGAaAGGAGGAAAAGAAGAGGgGAAaGaAAAgaAAgAGA	EEFGHEHDHFDEHH:HECEHHDGGDDDDGDDGDGGGGDDEGEBCDF5CCFB>C	A	30	G	23
19	55574412	G	29	tTtTGGGTGgtGtTgttTGggggttTtgg	?CBCCAEEEFDEDFFDDEEFFFFDDDEF>	T	15	G	14
19	55593837	G	116	GCggCggGgccggCGccCGGCgcggggGGccCcGgggCCCGCgcCgCGCGcCgggCCCgCGGCccGggCgcGCGcgCcgCgGCGcgcGCGCCCcggcGCCgcCcGCGcccgggGgg	B@@;@BAACAAB9G;BBECEDCBCCCCEEBBGBEBBCGGGECCBFBGEGEBGDCDCFDDGEDFCCEDDEDCEFECDFBCFDDFDCDCDEAFEECDDCDFEDCECDFDC=?:>>>?>	G	60	C	56
19	55658167	G	35	CggCCCGCCccCggcgggccggggcccggccgcgG	>BBDDDCDDBBDCCBCDDCC>DDDC?CDDCCDCB=	C	18	G	17
19	55690612	G	90	cGGccgCccCccgccGggCcCCgcCgggCcccGccCcgCgcCgGcCcCGcgcccgcccgccgcggcCGgCCgCGccccGcGgcccgcgcg	C<:<=@BA:7BACBBBCCFBGFCBBCCCG@@BABAEBCCCCGDECGC>ECDCCC?ACCDCCDBDDCGEDGFAEDCB?CDCDDAC?B:A<A	C	57	G	33
19	55715467	C	26	tctccccctccttcccctctttttct	D?FAABBBGBBGGBB?@EBGGGFHCH	C	14	T	12
19	55791091	C	87	tcCtttCCTtctTtcCcttccctttcctctttccctccctCccccCtttTCTttcCTccccTcctcTTctTccccttctctcttcct	CC?<@ADFDEFCEDFGGDDGGGDDDGGDGDDDGGGDGGGDGGGGGGD>DEGEEDHGEHHHH=HHEHE=HEDGHGHEEHEGDGEEHH@	C	46	T	41
19	55805412	G	36	AAAGgGGGAGGAAaAGAgGGGggAgGGaGgaAGGaa	@E6CFHHGEGHDEFD?DHGGGGEDFGGFFGFDGFE@	G	21	A	15
19	55816678	C	41	CCCTCCTcTCCCTTCtcCctCtcCtCccTcTCcTcCTCCTT	>?GEGGDDBG:GEEFE<GDFGFDFCGEEDEDFDDEECFFCC	C	26	T	15
19	55832427	T	111	GgtGTgtTGGTgttgtgtgTttTGGTGtgttggtgggGtTgGGTTggTgtGTgtgtTTgGgtgttgggttggGgtttTTgtTgtggttggtgtgtttttttgtttgtttgg	CC?@@>BBBB<BBBCCEDDFDEGGGDFEFEEEEDFEEFEEEGGF:9EF?EGAFDFEGGEHEEFEEFEGFEFFGGFEEGGFDDEFEDFAGEFF5FFF<FFFFBFFEFFFEB?	T	59	G	52
19	55865350	G	25	AGaaGaaaaGAggagagaaaagggg	@BFFEDFFEEFFFFGGGEBFD@GE:	A	14	G	11
19	55872531	C	49	gGcGCGGcccgcgggggGcCgGccccCGGcgGGcggcCgGCCCGGGcCc	CAACDCCBBBCBCCCC@ABDCCBC@CCBCBDACBDDCDDACCCBBBCA;	G	26	C	23
19	55879872	C	57	ccTtttCCttcTtTccctTCcTTtcttttCctCCctctcTTttTcctTCtttCttcc	CC;CFFDB:GBBGG?BAGGDBGGHCAHHADCHDCCHC;BGFGHFCCHFCHH;CHFB@	T	33	C	24
19	55966332	T	90	cTcCccccttCtCcTCTtTTccTctCTTTTCTTCTCTCCttTTttTTtTctCCCCCtCCCCTCCCTcCttccTtCTTttTtcTTtCTttC	?9<BAB<BGGFG9BEGFGEFBB<BHGEFEBFDBFEEBFGA;FFF;FE7FCHGFFEE:GEFEEFFFD7CF?@<BHEADCHD6=D@>CC:=?	T	49	C	41
19	56688669	A	51	ggGAAAgaagaAgGgaGaggggggaaaagagAaagaaaGGgggaagaAggg	C??=@DCEFBFFCFCFGFCCCCCCFFFFDFDFGGDGGGEGDDDGD@GEDCB	G	27	A	24
19	56719822	G	89	GTTTGtGTttgGgGttTTGgTgtttttGttTGGGgTgggTgttGTttgTgGTGTtGGttGgGGggtgGTgGGGGggtgGTggTgggtgg	><?FE9EFGGCECEGGEEECACCGGGFEHGFEEDDBCDDADHGCDHHDF6EEEFHEEHHCDEDDDHDEDDDDDDD@GEDEDDEDDDH?=	G	50	T	39
19	56719853	C	78	CaaACCCcAcccAcaaCAaacCACAaCCaaCcCCccacCAcCCCCccacCAccAccacaaCCCCCaccccCCcccCcc	=BBBBC?GHGGGHGDDDGDDGDHDHDDDDDBGDDGGDG@GDDDDDHCCHDHHHHGHEHEECCCCCFBHHHCCHGDCCC	C	54	A	24
19	57029837	T	49	TTGGTTGTTTGGTGgTGTgTGTgGTGTGTTGGgTTGGGTGggGTGGGtT	EEHDCEHEEDCHECGDGDGDGDGGDGDGDDGFGDDGGGCGGFGDGGHBB	G	27	T	22
19	57176304	T	155	TttgGTtttgTtttgTgTtgGTttTGGgGtttTTtgtTgTtTTTtgggTgggTTTTGTGTGGgGTTtTgTTttTtGgGttGGgGTGgtGTTTTTGTgGGtGGTTtTTGTgGTTgGTtGGGGTGtTgtgtgttTtGGGTGGTTTGtTGTTTTTGGg	;CAB:DCDCDGDEEFHEFEFCEEEFCCECEEED=EFEGEFEGGGEDFDGFGFEGGG?ABDB=F=GGFGFGFFFFECGCCA?CFCFBFFCFFGEFBFBB>FB=FFDEFBFHBFFGB@FBBBBFBFFGDG5FCFFEB>AEAAFFFAAFCDDDACA?C	T	90	G	65
19	57176482	C	185	TtCCcccttcCttCTtCcctccctCttCccTccTCcttctcTCtCccctCTCctttCTtctccctctttTTcttTTTCCctCctcCccCtcTCCccTTccccCTTtcttctCcctctTcCCctTtCCcccccTTTCcTCTCcCTTCccTCCtCTCCtTTCtcttttccCTCTcTTTccCTcccCC	BC;@ABABBA?DDEDCFCDECDDEGEEGDDEDDEEDAEDDDEEEGDDDEGFGDEEEHEBDEDDAEDFEEEEDEEEEEGFDFGEEEEEEFFEBGGEADDEEEDGEEFEFFEFGEE@EFDEFDAF<FFFEEDEEDDDFEDFDFEFDDFEDDFFFFDFFFDDFFE5EFFEEFCFDEDD<DDFC=@=C?	C	105	T	80
19	57654065	T	107	tCCTTCTCtCctCCCtCTTCTCTCTCcCTTCtttCctTTCCTTcCCCctTccCccTtTctTCctcTcccCctcTcTtcCTTttttctcTcctTcctttctcTctCct	A@?DEEFGGEAGGGFEGGGGEGHGHGBGFGGGGGGCHGGGGGFBGGGBGG@BGCCGHGCFG8CGCGCCCFCHCCCGDCDFGH6HCCHCFC?GFACHGHCHCECHFBG	C	55	T	52
19	57654104	T	68	cTtTctTCctcTcccCctcTcTtcCTTttttctcTcctTcctttctcTctCctTTcctCttcctCctc	?ACDFDCFFEFFFFFGFDFBFFFFFFEEEEEFEFEGGFEGFFFFGEFFGFFGFE>GAFEFEGGFFEAD	T	35	C	33
19	57678738	A	66	AAAAAgaAGAAAGGAGAGgGGaAGGGAGAAaaGGGAAGaAGGaagaggaAGgGgaaagagagAAgA	AEEEDEECCEEEHCCHEHFHHEEHHHEHEEFFCHHDDGFEGGFFGBGGFDGDGGFEFFFGEDBB@C	A	36	G	30
19	58216449	T	92	ATaaatAtAtAAataAtaTTtAtaaatttttTattattaaAAtaTtaTataTtTtaAaaAAtaTtaatataatataAatttatAaaAaatTa	C?B>?ABCFF9FDBBHDED<ECDDBDEEDEEHE;DEADBDHHEBGDEGEEFGEGEFFFDCGFAGFFFFEEFFFF>=GCF8CFFGFEGDFEFF	A	50	T	42
19	58514715	C	32	gCcccccggccgcggccggcgccgcccgggcc	C@EFFFFFFFFFFEDFFGFFC9FGFGG:GHGG	C	19	G	13
20	238507	A	45	AAAAAaaAaaAacaCaAaAAAcACaaAaAAAaaaaCacAaaccaa	CA=BCEEFEEFECFGBFFBEFEEGBFFEFFFEEFEFEDEEFEE?A	A	37	C	8
20	377226	C	120	cctCcCtctcTCCtCTtCtctCtTCCTCCctctTCccCccCccCCTccTcTCCCcCCCttTTCtcTCcTTCCCcCTcCTTtctcccCCTCCTCCtCtCTCCcccTCCcTctcccCTTCtT	A=C@CCEDDDGDDEDFE?DDDDEHDDGDDDEDDGDDDDDDCEADDGEDGDFDC@EC>DBEGEDFEGCDGGCCCECFECFF?EEEAECCFCCFCCFCECFCCEEEFCCCFBB@;9?CCA>C	C	77	T	43
20	656181	G	56	aaaGaaaAAAgGGAgAGGGGgGGgaGAGaAAGaAAGgAaAGgAgCaagggaGgagg	?CAADFEDFFFEEFEFCDEEDEEA;DFEFFF8FFFBGEDEDEEGFFFGEBFDEFB?	G	28	A	27
20	860296	G	31	CGCGGCgCCGCGGGCGGGGGcCGCCgcGGGG	AAEEEEDFFEGDEDFDCDDDCFDFEDBDC=@	G	19	C	12
20	861743	C	29	GGCCGCGCCgCCCCGGcCCGCCGGCGGCg	EEGFEGEFFDFFFEDD>AECEBCCBA>B8	C	16	G	13
20	870730	G	41	GAAAGAAGGGAAAAGAGAaAAAAAAGgAgAgAAaAgGGAGA	FFFFEFFEEEEEEDEEDEGEEEEEEDDEDCDDDGECBABA?	A	26	G	15
20	1285933	G	105	AGgGGAaGGGGGgGGAgAgggggAggGGGGAGAaaAGGAaGgaGGaagaaGAAGGgGgGAGaggGGgaAAgagAgGGgGGAAgAAGGAGAggaAaAGAaaAGGgA	?=@@DEFDDEEECEAECECCCCCFCCDEEEFEE6GEBE@G?AGEDGG>GGEFEDEDDCEDEGDDDDDBEEDGDEDDDDDDEEDEEDDEDE?DGEGDDDCC=@@<C	G	63	A	42
20	1552457	G	221	AGgAgAggaAAGAGaaAaggGaGgggAgaGgaAGGGAaaGAGGAGGGGGGGagaAGAAGGagGagGAGgAgAaaGAagGgAGGGGGgagAAAAGaGAAaAGgaggGAGAagGGaaaGaGgaggagggGAgGgGGgGgaAGagGGAggagggaaGggagaGAaaaaaggGgggggGgaaGgaaGAAAGGgaggAAGagaaagGaagaAagAggaaGagAggg	E=CBACABBCC=D?CEGFGCCEAFFFHFFCFFFCCB=EECHCCHCCCCACCFFFHCHHCDFDAFFAHCFHFH:F?GFF@FHCCCCBGFGHHHGCECHHGGBGFGG?G?HGGCCGGECF>GGDGFGGGCHGCGCABCGGGCDECAHGGF=GG@7CDGFGFCGGGDCGGGBGGCEGBGFEBGDGBGGGBBGEGFGGBGGGGGBBCFG=GGGGFFFGCC<FA8?	G	125	A	96
20	1600524	T	95	CtCTcCTTttCTCCccTCtCctcTcTttcTCcCCTctCTtccccCCctTTtCcCcTTctTcTTtcccCCCtcTCctCtcTtTttctcTCtCTttc	<ABFDDF@:ECHDDDDG8F?DADG;GEEEGD?D@FEF8GFEEEEDDDDGGFDBDCFFE<EBGF>EE>CC@FFFCEFCFBFDFFFEEDECC@C><@	C	50	T	45
20	1615883	A	42	AGGAGAGGGGgGAGgAgAGGGAGGgGaGGAGgGagAGGgaGA	FECFEEDEEEGEEDGFFFDADEDCGDFDDEDGCEECCABAA?	G	29	A	13
20	1629604	A	47	CACAAACCCACAACCACCACAAACCACACCCcaaCCaccCCCCAcaA	AFDFFFGGGFEFFDFEDFFGFEEGDFFEFFBHEEFCEH@FFFGED@B	C	27	A	20
20	1629606	A	47	AGAAAGGGAGAAGGAGGAGAAAGGAGAGGGgaaGGagGGGGAgaAAg	B@FFFHGGFGFFCFCFGFGF=DGEFGEFFFGGEFFGGFFEFDEFDBD	G	26	A	21
20	1666989	C	37	aCCACcaAaAcCaACaCAacCccaCcaccacaaccCa	DCDHCBFHFHBDDHDGD@GCCC;GCCC?CFBGGCBCC	C	20	A	17
20	1895714	G	78	GGGGGGGGGGgGGGGGGgGGGgGgGAGGaGGaaGGgagGagAaGgGgGGaGgGggGGgGGgGGgggGGGGGGGGGGgg	BEHHHHGHFGFHG>HHDGHGGGHGHEGGE6GEEGGGEGGEGEEGFGGGGDGGGEGGG@GEGGFEGGGFFF<EC?DC@D	G	69	A	9
20	2413125	C	32	CCtCCCCCTTTTTTCTCTCTTCCCCCCCccCC	DDEDDDDD8EGGGFDFCECFFCCCCCCCF@AA	C	21	T	11
20	2443116	G	83	GaGagggagAgGgaGGAGAgGAgAgggagggGaAAAagGaaggGgGagAGAAggAaGggGaGGgAAAGaaaaGagGGgaAaAa	EACECDCECFCGCFFGFGFCFACFC8CFCCDGGFEEGCBGGDAFDGG>FGEEDDEGFDDFFFECEEEFGFGGFGDEECGEFED	G	46	A	37
20	2451451	G	97	ttgggGtTgtGTGgtgGgGGttgttGtgGggtgTGTgtGggtgtggggttgTTtgtggtGgTgTttTTgtgGttgGgtTttGtggggtggttgggGt	BDGFDHDEFDHEHFEEHFHHEDFEEHEFHEFD7FHDEEHCEDE=FDEFEEEE9EGEFBDGEEGDBDEEGFGHFFBGGADFFGEGGGGFFGB;FFGF=	G	54	T	43
20	2451503	G	38	gaAggaAagGggAgaaaagaaggaaaAgagaagaggga	CB>CDEDEFEFFF=EEBFFEEC@FFE9GFGEFGFEGGF	A	21	G	17
20	2451504	C	36	cttcCctTttCtcccctccttcccCtctcctctttc	@BCDFDEFEEG?DDDDEDDFBDDDAEDF=DFEGEFE	C	20	T	16
20	2552805	T	39	TAaTaTAATTTATTTTAATAaAAAttTttAtAtAtAAtt	CEFECEEFEEEEEEEEDEEEFE5CFDDFFD6DED@CEED	T	21	A	18
20	2552926	T	40	CcCCcccTCTTcttCctcccTtctTCctccctttttcccc	BAF@BBBFFE:B>GGBGBBCFHBHFGCHBC@A9GHH=BC<	C	24	T	16
20	2593006	A	47	AGAaaAaagAaAgaGaaGGgaaggGagGagGaGGGGgGaggGAgAgg	=FDCDEDDFEDEFDHCDHHGECGGHEGDEGHEGG>G?GDFGGDGDGG	G	26	A	21
20	2597073	T	34	tTGTgtgttggTttgtgtGttgtGtgtgtTGgtg	A<?BCFFDEEFDEEFAFDEEFGDDFGEGF@EGED	T	19	G	15
20	2996589	G	55	gGTgtttgGgtGGtgttgGGggTGgGtgTggttttggggggtgtggtgtggggtt	A?@BDD;EEDEEEEFEEFEEFFFEFEFFEFGFFFEGGGGGGFEFGGFGFFGFGEC	G	34	T	21
20	3002889	A	101	AACACacccCAAccccccCcaccaccaaccACCacaccacCcaccAaAacccaaCaccaaaaccccccAccaaaaaacccaaacaaacccacacaccaacc	BAD;ACA@B@ABCDCDCAGCDDCDDDDEDDE?BEDEDDEDGDE5DEEEEDDDEBEECDFFFFEEEBEEEEEFFFFFAEEEECDEEFFEEEFEFEFEEFEA=	C	57	A	44
20	3026238	G	39	GGTTGtTGTTTGGGTGGGGGGGGGGTGTGTttgGgGgGG	HHFEH7EG6EEHHHEHGHHGGGGGGDGDGD6CCF@C=?C	G	26	T	13
20	3202636	G	56	gaaGagggAgGAagAaagagaaagGaaaggagggaagagaagagaagaagagggaa	CBB<>CCCFEBGED@EBEEEEEDFCEEEF<EEFDFDFFGF@GFFBFAE?EDFGGB<	A	30	G	26
20	3211304	G	80	aGgAGGGGGgGGAagAAGGAagAAAGgGAGGagAgGgggaAAGggAaaGAGggAagGGgagAAggGGgGAGAGAaaAAaa	DACFDEEEDCDEFFCEFE?FFCFEFDCEFEEFCEBEDDDGFEDDDFFGEFEDDDGDDDDGDEEDEDDDCEDEDEGFC@??	G	45	A	35
20	3211719	T	166	TGgGtGTGtgtGTgttggTGTGGttttgtTGggggtgGGTtTtttTggtTTTTGTtTgggttGTttGTTGtgtgTGGGtTTTgTgTgtgGtGgGtGttTTgTgTGtTtGGgtgtTTtgTGtgttGTgttGTtgTTTtTGGttGgTTgggTgttGTTtggTGtTGTt	CD=@D@?CFCGGEBGFCCGGGGGGGGGCGEGCCCCGC@?CGGGG@CCCGCGGDCFH:CDCGHCDHHGB:CCCHCBCGGHGFG>DDF9GDECGDGHGHHF<DEDDGGGG:FDCD;DFHDFFIEHHFFDEHFFHDFF8GFFEHHFDFCDECEDHGFEE?:B?CB=BC@	T	94	G	72
20	3214322	C	100	AaaacaaaacccccacccAccacaAaaacaCCCcaaaacacacacacaaacAcaaacccaaacccaacaacaccaacccaaccaaCaacccAcaccaacc	@???@CBBBBABBCEDDDHDDEDEHEEEDEDDDDEDEEAEDBDEDECEEEDIDDBEDDDEEE9EDEEEEECEAEF:EEEBFEEFFCFF?E;GEFEEFF?B	A	52	C	48
20	3214324	A	91	aaaagaaaGaagagGgggagAAAaggggagagagagagggaGagggaaagggaaaggaggagaaggaaaggaaggAggaaaGagaaggaaa	CACFDFFFAFFCCCCCCCFCHFHFCCCA?CF9FCFCFCCCFCFCCBFECCCC@FFDDFDCFCFGDDGFGCDBFDDGDDGGGBGDGGCDD?C	A	47	G	44
20	3605059	A	145	GGGGAAAGGAGAAGGGAGGGGAAAGAAGAAGGGGAAAGaAGGGGGGGAAGAGAGGAAGGAAGAAgAAGAAGAGAGGGAAGGGAGGAAgGAAgAAAAGGGGAAGGAGGAAGaGAGAgAAAGGGgaGAgAGGGAAgGAAaAgAAGGa	ACEGFFFFGFC>FGGGFFGGGFEFGF@GFFFGGGFFFCGEGFFGFFFEDFEEEFFEEFFEDCEEHEEFEEFEFDFFFEEFFFEFFEEGFEEGEEEEFFFFEEEFEFFEEFGEDFEGEDEEFEEGEFECDDBBCACAAAABCA?CD	G	76	A	69
20	3650234	A	40	AAAAGAaaAGAAGAAGgGGAaAGaaGAGAGGGGAaGGAGG	GHGHCH@ECCHHBGHBDCCGGGB?GBGBGBBBBGE?AD@C	A	22	G	18
20	3651742	C	44	GGgCGGCcCCCCCGCCCGCcCcGcggcGCgGgGgCCcGggCCCg	BCEDC6DDDDDCCBBDDCDDDEB9GFEBCHBGBFCCEBF@CAA@	C	24	G	20
20	3653149	C	127	aAAAAaAAACCAACCCCCACaAACaCACAAAaACaCCCAAaCAAAaaACCCAaCccCCaccCAcCACCAAaCAaacAaAccAACAaaCCccCAaaccCCAaAAcccaACaACCAACAcCCcaaccAa	DHHHFE5@HDDGGCDDEE9DEGHDF9HDGHHFGDFDDCHHFDHHGEFHDDDHFDDEDCFEEBHECGCCCGFCAFFEHEGEEDGCGFECCEECGFFEECCGFGGEEDFGCFGBBFFCFBA@=;>>>??	A	69	C	58
20	3654433	C	107	CCCcCCCTCTCCCTTTTcTTccTCctTTTCTCtTCtTCTctccCTCTTCtCCTCCTTTcccttTTCCCcTCCTTtcCTtCCTCCCTtctTTTTTcTTtTtttcCCtC	D<>DEGFFGFFGFEFFFD;FDDEGEDFFDFDGFFG?EFFEFDEFEEEDEFFFEEGEEEEEEC7EEEDFFEEEEEEEFEEFEEFFEEFEECEDDDEDBDEEDDB=A<A	T	55	C	52
20	3657803	A	51	AAAaaaagggaGaaagaaaaaagaaaAaaaAaAgagagaAaagaggaAaGa	B;>DDEEFFFFGFFFFDC<FFFFFFEFDG:DGEAFFFGGEGF:FEG?EGEG	A	38	G	13
20	3657804	T	49	TTttttaaatAtttaTttttttatttTtttTtTtatatTttttaaTtAt	=BDDFGFEF?:GGGFFCG?GGHFHFGFGHAFHGGFGGHGHG@CGGFGDH	T	38	A	11
20	3682149	G	180	aaaaAaaaGAagGAAgAaagGgagGGggaaAGGagaAAggAGGgAAGaAgggAaaaGgaAaGGaAaGAGagaggGAGggGAaGGGgggaAGgGgGGagAaggAAgaAaGAggggaaaaaaAggggaGAGGgGAAGgaGgaGagAgagAGgGGaGagagaAGAggaGagaaaaggaGaaaG	CCCD>DECC<DCBGBCGFFCCBFB@CCC9FACAFCFHHCCHCCCIE<FHCCCHFFFCCFHF@CGGFCFCGCE>CAFB=DCGGBCCDDDGH=BBDCCG@HGCDHHDGHGCADDDDGDGGDGGCDDDECGABDBGGBDGBDGBGDGDGDGBDBBGBG?GDGGA:DDDBGCGE;GCDG@CCD9	G	92	A	88
20	3684729	T	91	cccttctcctcccccttTtttccctttccccctcctctttttctctctctcctCttttccttttctccctctTttcccctctttctttccc	?AC=CDDFFEEFFEFDEGEEEFFFEEEFFFFCEFFEFAEEEEFEFEFFFEFFDDE>DEFGFEFBGFGGGFGFGFFGGGGF@FDAGFF@ABD	T	46	C	45
20	3686979	C	232	TTTTTCTCTTCCTTTTCCcCTCCCTTCCTTCCTCCCTTCCTTTTCTCCCCTCCCCCcCTCCCTTTTTTTCtcCCCTCTTtTTCCTTCTTCTTtttCccCtTCCCCcTCctCtCCCTcCcTCTccttCTCCCtTCTtctTTCTCcCTTCttTTTCTTTCCccTTCCtCCCCTCTCCCTtCTTcTTCTTTCCCTCTTTcccCtccCTCTTCttcTttcCTtttcTTTCCTTCTT	?CFEEDDDGGDDGGGG6DFEHDEDFEDDGGDDGDCDGFDDCGGGDGDDDAGDDDDDHD>DDDFGGGGGGDEHDDDFBGGEFFCBFFCFGCGFECECHHCEFCCCCHFC9ECE@CCF<CGFCFHHD@CF?CCEBCFBHEFFCFCCCFFCEDFFFCFFFCCGHFFCCECCCCFCFCCCAECEFCEEBEEEBCCFBFFFHGGD6FFBDBFEBA@CE6@C@?@98<ACC@@DDCCC	T	117	C	115
20	3730524	G	97	gGgGagggAAagAgaggaAgAGgAgaagggAAagaAGgaggGGagGaGGagAGAgGAaGAAaaggAaGggaAagAgagaaAGaAagGaaAggGAgaa	@>BAEBCBEGEBDCECBFHCHCCHCFFCCCHH?CFICCFCCCCGCAFCCFCH<HBCAGCHHGGD@HGCDDDHFBGCEDFGGBGGFCAGHGDBBG@?=	G	49	A	48
20	3731622	C	57	CttCttTctcctTCtCtCCttCccTtTctctcccCttTTtcCTccctTcCcctTCtc	@CC;?@CGCG@DGCDDDDC;DD:F=EGHDHEHHECEBGF6HCFGHDEFHCHHEFCEG	C	29	T	28
20	3785402	T	90	TtttttttttttttttttttttttttttttttttttTTTTTTTTTTTTTTTTTTTTTTTTTTTTTTTTTTTTTTTTTgggggggTTTTTT	BCCCA??C?BBBBBB?CCDGFG9GFFDGGEGAEE<GFF?FFGFFFFFFFFF;EBF>FDDD7EEEEEEEEEEEDEEDCDC977BDECBAB?	T	83	G	7
20	3870124	G	45	GGCgggcggccggccCccCccGcgggcgCgcgcccgcgcGcGccg	?@BDCCBCCBBCCBB@BBFBBEBCDCCDFD@@A8CDCDCD;DB@>	C	24	G	21
20	4162700	G	128	AaaGagaaAGGGGgGAagagaAgGGagaAagAaGagAGaGagagAaaaGGgAAaGGgGGAaagGGaaGaGGgAGgaaGggGAgAgaAagaaggAGggagGaGGGaggAaggGaggagGaaAGagGaAG	E<A;<ACB?BABADA9FCFCFHCCCFCFE7CIFCFCFCFCCCFCHGFGCCCHHGCCDCCHGGCCCGGCGBBDGBDGGBDDBGDGDGE6DEGEDEBDDGDBFBBBGDDGGDDBGCDGDB8FFAFC>>BA	G	68	A	60
20	4843370	C	45	CTCTCtCTTTCctcTTTtTccCCTTTCTCcttCCtCtTCcctTTT	?GEGGEGGGGCDEEGGGDGEEGGFDEGFFEE<FF:FDFFEEDCB?	T	25	C	20
20	5903323	G	57	GaGAaggAGGAAAAGggAaaGggGaaGgaaGaAGGGAaGAgAgAGaagGaGAAGGaG	@DCHDFFHBCHHHGC>@HEECGGCCECGEEBEGBCBCEBGGGGGBAFGAEAGF=>=?	G	29	A	28
20	5903848	C	66	gGggGcGCcgcgGGcGcccGcCgGCggCGCCCCGcgGcccgCCGggcGcGGgcgcCCGGGGcGCgg	CDFFEDDFDFDFFEAECDDEEFGEF=FFDFGE<EEFEEEEGFFDB@FD=DDGCF@FEDCDDDDCB@	G	36	C	30
20	6064635	G	64	GAGGAAAaGgAGaGGAaAGGAAGGAAGAGGAAAAGGGAAGggAGGGaaAAgGGGGaaGAAGAAg	FFGGFEFEGDCGDEGEBFGGEFGFEEFEFFDEEEFFFEEF@GEFFFFDEEGFDEEF9ECCAAC<	A	32	G	32
20	6065729	C	96	TCTTCTcCCcCTTCTTCCCCtCTCTCTCTTTCTCTCTtCtCCtCCCtCCtCTCCcCTccCCTttTtcTTtTCCCttTCccCccCTTTTTctCTcCc	DGEEGEFEGFGEEGEEGDG7FGE?EGDFEDEGEGEGEFFFFFFADFEFFFFDF?FFAGGFECGEDFGDDFDFFFFFDFFFFGEFDDDDCGFDCFC?	C	52	T	44
20	6065731	T	99	CTCCTCtTTtTCCTCCTTTTcTCTCTCTCCCTCTCTCcTcTTcTTTcTTcTCTTTCttTTCccCctCCcCTTTccCCTttTttTCCCCCtcTCtTtTtt	?EFGEGEEEEEGHDGGEEE<FEG<GEGEFDGEGEGEGFDGCEGDDDADDGDFDCDFFFDDFFFFHGFFFFDDCGG@FDEFDFADFFFFFFGDEBE<ACC	T	54	C	45
20	6759115	A	186	TTTtaaATtataaAATTAATaTATtttAaATTTTTtttatattTtaTATAtaATttAAAAaTTAatttAATTaAaaAAAtTaAaatTTATTTTaTttTaAtttTAAAtattTAtatATTtaATTtTaTtAAAATaAtttAtaTAAAttTAatTattAattTaTaTaatAtTAAaaaAtttaattta	@@BC8A@BCDCEEFFEFDFFBEEFEEEFEFEF?FFEEEEED=DEEEEF@FEEFCDCFDCFFCBEEFFEBE=DFFFFEFFF=DDFBFFFFEFFFEEFFFDBEEFDEEFEFFFEEFFFFDEFFDEEFEFCEEE?EEDEEDEEFFB9EEFFEEFGEFFFEFFFDEEFEFFFEFEEEFEFDFBD<>?>;C	T	100	A	86
20	7967980	G	66	GCGgGCCCGgGgcGGgGCGCCggGCgGCcgggcgcgCggcCccgggcgccccgcgcgGGgcgCcgg	=A?EGGGGGFGFGFFFGGGGGAGGGGGDHGGG;FHEGGGHEHHGGGHGHHEHGHGG<EFGFFF><E	G	38	C	28
20	7980390	C	91	TTTTcCCCCCcCCcCtccTTccTTtCttccCTTttttCtccccCccTcttTcTtCtTccCCcCctTtcTTCccTtCTCcTCCcttCCCTCC	CCCEBDDDC?BCD@DGB?GGBBEGGDHGBBDGGHGEHDHCBCAD?CBCDHDCGGDHGCCCCCBBHFHCFFCC?FHCFCCFCCCHFB;ACA@	C	52	T	39
20	8707927	C	29	CTTTTTcCCcCTTCCCCCTCTTTtTcTCC	DHFGGGBC>CDGFCCCCCFCFFFFE@C=@	C	15	T	14
20	10603326	A	44	GGAAAGAGAGGAGGaGGGGgAAgAGAagAGgaagaGAgAAAAgA	GGFFFGFGFEGEGGEG>FFGEEGEFEEGEFFEEGEFEFDDDEAC	A	22	G	22
20	13090745	G	27	CGGGGCCgCGggCCGgCcCCgCGCCcc	EHHGHEGDGG@EFEGDFCFF@EE9A9<	C	15	G	12
20	15480548	T	40	TaatttaaTatttttttAAAaaAaatttaatatatatata	BACBBCDDFFD>EEDEEFFFBFGFFEEE:@FGFFEGEGF?	A	20	T	20
20	17602028	T	49	CCCCCTCTTCTCCCCCCTCCTTCCTTTtCTcTTTcccCCCccCTcCCCT	CDEDCGDGFCDCCCDDDGDDFGCCFFFHCFCFFECCCCCCBCBFCDDCA	C	32	T	17
20	18022171	C	299	TCCccCCccTcTCTTCTTTcTCCCTCCTCTcTTTTCtTCCCTCCctCCTTTccccCCCCTcTCCCccTTCCTcttccCTTTCtctTTCTTcccTTCtcCTTtcCtCTTCTTCCTcccCCTTttcCcttTCCTccTTTctttctccTcttcTTTtCTCCCCCTtCTTtcccccTCcCctccTTTTTCccTttCCCCtTTCcTtCTcCtcCTTTcttttTCcttTCTtCctCccttcTTttcCtCTccTttCtccccccTCctTCTcttctctccccTCCCtCCTtTtttttcTcccTtct	CA@C?=??=A:DBEFCEEFBFDCCGDDGDG>FGGGDGGDBBFCCBGDDGGGBBBBEEDEHBF>D>BBGGDDGBGGBBDGGGDHBGGDDFGBBBGGDH>DGGGBDGDGGDEGDCACCCADGGHHCCCHGGDDGCCGGGCCHHBHCCGCHHCGGDH7GDD8DCGGDGGHCCCCCEDCCCHCCGGGGGCC8FHCCCCCHFFCCFG>FCCFCCGFG7HHHHFCCHHCCCHCCI@>CH>CFFHHCCHCFC=FHHCHCC?CCCFCCHFCFAGC=HCH<BACEBBBFCCFDCCAB?C;D>:;AA@E	C	155	T	144
20	18118829	A	29	ttTaaaATttAatATatatTaatattata	CEGEEAF?EDHEBHEAFFFGAC9BDFEEE	T	15	A	14
20	18448079	C	54	AACACAACAAACCACCCacCCaCAAcaACACCcCCCCccaACCCCaCcACCACC	ACGEGEEEAEEEGA:GCFDFFFFDDEEDFDFFEFFFFEDFDEDEFEDDEFCAB>	C	33	A	21
20	20493222	G	107	gGgAaGAagGGGAGAGAAAGgaGaAAggggggggaAAGAAAaggGAaGAgGggAaaGgaaAaAAGGggagAagGGgAaGAGAaGAgGGAGggGAgGGGAAAAGGGAG	;?ACFDEECDEDEDEEFFEACFAFAFCCCCCCDCFEFEEFEGDDEFGEFCDCD>GGEDGGEGEEDDDDGDEFDDCDEGDEDEGDEDDDEB>DEB>>>@>BBCAAAAA	G	59	A	48
20	21142813	T	217	ctCTCCttTtTTCtCCCCCCctCcTCcccCCTCCccCTCCtTccCCTTTTctCTCcttTCcctTCTCttTCtccCTcCTtcCCtCCcTCCtCCTTTCTTTttTcttTTtcttTCtcCCTcTCcccTTCTctTTCTcCtCTCcTTTtttTcTtccttcctctcTCccCTcccttccCtccctttctCTcTTtCtttCtctCCtttttctttcCCtTCc	?B@BB?DC;EAFFFDGGGGGBGDBGGBBBGGGE;@BGGGGGGBB=GFGGGBGGGGBGGGGBBGCGGGDBGGGBBGGBGFGBGGGGGBF6EGGGGGGEFGGBHGCHHGFHCHHGGHCFGFCFGCCBGFDGCHGGGG@GGGGFCGGEHG=GCFGCCHHCCHCHCFFCCFF?CCDHCAFHCCCHHH:HFFCFFHFHHHFHCBFDAGGFGBDB=<@B@CC@	C	110	T	107
20	21362758	T	44	GgttGtttggTggGgggTggtgtttttggggtgtttgttgggtg	@AAC@BABGEBFFEFCFFFFEFEFEEEFFFF>GEFFGFFGGGFC	G	24	T	20
20	21687042	C	122	CCcgGCGcCGCgCGGCCCcCCGGcGCccccgCCccCCCgggcCGGCGCCcCcgGCcGggGcGcccCCCGGcCCcGGGgCccCCgGCGCcGCcCGcCGCcGCCcgCCGcgCCcccGCcCggCG	A;ADACCDDCDFDCCDDDDDED@DCCDDDCFDDDDDDDEFFDDCCCCDDECEFCDECFECDCEDECD@BBECCEBBBFCEFBCGBCBCEBCECBECBCDBCCAGBCBDFAB???>@=A>>CC	C	78	G	44
20	23065342	A	163	gAGAgGgAAAAAGagaagAGgaaAaggGGAaagggaAaGGaaGGGaAaaaAaGAagagaGaggaaGAgAaAAgaAAAaaAggaagagaaagAAAagaGGGAgaaaggagggaagAagaGGaAgAAaGAaGggAgAaAgggAgaaGaaggggAaAagAAaGGag	A@5@>=BC@DGFBDDEDE9CFDDGEEBABCEEFFEEHECBEE=CCEGEEEHEAHEEEFBCEEFEECHEHEDHFEHHHFEEE=FEFEGFFFGHHBFGFCCCHFFFFGGFGFGFGGGEFF@AFGFDGFBGFBGGGGGFGEGFGGFFBFFDFGFEB@?:@B9CCAA	A	94	G	69
20	23472391	A	82	aGAAGGGGGGGGgGAGGGGaAGaAAGAAAAaAggGggaAAAGGaGaaGagAAAGAAgAgAGgaAgaaGAgAGAaagAgAGAG	6>FH;C>BCCCCCCHCCC@GHCGHHCFHFHBADDBDDFGGGBBGBGFBFDGGGBGGDGDGBDGGDHFAFDEBDBB?@<AC??	A	42	G	40
20	24987438	C	41	CTCCTTTCCTTTTCCcCCTCCCTTcCCCcCTCCCCCtttCC	8?DDEHEDDGGGGDDCCDGDDCFFDCCCCCFCCCCCAGFAA	C	26	T	15
20	25038372	G	96	AGGaAGGGAGGAAAAGGgGAGGAgGAAAGAgGagGGAgAAGgGGGGAaAAAGaGAGAaGAAGgAaGGAgaAaGGAAGAGagaAGgAGAagAggAgG	EHHFEGHHEGI<EEEHFDHDFGEDHCEEHEDHGBGGDDEEHDGGGGDGDDDGHGDGDHGDDGDDGGGDDGCFGGDDGDGGDGCFDBGD>@B9>;<?	G	50	A	46
20	25062001	T	76	TTttTTTTTTAatTATTatttTtTtAAATAtAAtATATAtTAAaTTaTATAATTTtTtATAAtTATaAAATTTaAt	;A7GGEGGGGFFHEFGFGGGFGGAHEFFGFHFFHE=EFEGFEEGFFGFEFEDFFFHEFEFEEHDEFGEEDECDBBC	T	46	A	30
20	30193538	A	65	AgagAaAGgggaaagGAgagaAagaaaaaaaaagaggAGagGGaAgggagGaGAGAgGAAGaGGg	BC>C><A?BDCDDBEEEFDFDFDFDDDCDDDEDDDGFFDEDBEEEGG8EGDBDEDEEDED><9AB	A	34	G	31
20	30195166	C	52	gggggGCggCggcggcgcggcgcCCggcCggcggccgggccggccccggggc	CC@@BA?FEGFFFFFFFFFFFFFGGFAGEGGFGGDGCEFGFGGGF=FGDEEE	G	31	C	21
20	30451844	C	46	ccccTTcTCcTTTCCTTtTttttTtCcTtCtctTtcttttctcttt	AA??A@9??CEFFEDGGGGGGCGGGDBEHDHCHFHCHCH=@FCHHB	T	30	C	16
20	30618787	T	52	TTTCTTTCCTCTCCCCTTCTCTttCTTTCTtTTcttTtTTCCTttCTTttTC	GGGG:FCGAFFGFGGGGGGFGGHHGGGFFFHCECHCFGFFEFEH>BCDCCBA	T	35	C	17
20	30946654	G	32	agAGaggagaaaaaaaGGagggAgAAaaAgag	CCEDECCFCFFFFFFFEEFCCCFCFFFGFD<E	A	19	G	13
20	31017119	T	57	tCCTTCccTCTtTCcccccctCTCCtTtCCCTctTTcTtCCTCtTTctttCtttccC	BCFEDGFFDGEECFFFFFFFEGEEGFBECFEEGFEDGEFFEDFFCDBFFFFA@A@@C	C	29	T	28
20	31238627	C	100	CcttctTTTTtTTcTcCCtCCtTtCtcTCCTTttctTtTCTTCcCTCCTtTtTTCcCCCTcccCctcTCCcCCtCCcTCTTttCtTcCTtCtCTTCtTTT	<CC>BGGFHGFGGBGBBDEDDFGADHCG7DGGGGBHF=GDFECCDECDFHFHFFCCCCCFCC;CCIDFCCCCCHCCAFCFFHHCCFCCEHCGCCFBEDCC	T	54	C	46
20	31374259	C	59	TTCTTTCCCTTTTCCCTCCTcTTTCCTtTTCTcTTcTCtTCCTTTTCtcTTTTCccTCt	EG@FGFCDDGGGGDDDFCDGHFFFCCFEFFCFGFFGFCEFCCFFFACCHFFGECDBDCA	T	35	C	24
20	31383530	C	26	ttCccttccCcccCttcttccCccct	?B>FFDEFFDFFFDFEGFEGFCAGFE	C	17	T	9
20	31387954	C	58	CCCGGCGCCGGCCCGGGCGGGCGGgGCcCCCCGCGcCGGCcGgcGCCGcCGCGCgGGG	>DCCCCCDDCCDDDCCCDCCC7CAGBDHCCCCB@BICB9CGB;HABBAGDB?=A@AC?	C	29	G	29
20	31494915	G	54	CcgcCgGcccgcggcgcgggggggGcccggcccgcgcgcgcccgcgcccgcccg	B=A>DCEC9BBBBCBCBCCCCCCCEBBBCCBC>ACDBDCDBCCDCDCCCDCCB@	C	29	G	25
20	31505292	C	275	TCCccttccccTCTTCccTTTCttTTtcttttttctTtcttCCCttTTCcccCctccttCCTctcCCtcCTCttTCctTCCcCCCCtTCCtTtTcCtcttcTcTCcCTTttCTttctCtcccCctttTTTttcttCtttccTttCtcCtttctctctttcccCTccCCctTTCttccTtccTCtcTCttTTcctcCttTccTctttttttctctttcTTctttccTcTctctcctccctcttcttcctttCcttcTTtCtttcCctcTCtctCtc	BADC?BB>>>?@A??A@>B;ACDFDCGBGGDFFGAG<GBGGBGGGG>DGBBBGBCBBBGGGCBGBGGGAGEGGCEGB<EGGBGGGGGEGGGEGEBHGBGFACBEGCGCEEGGBGGBHGCBBB<BG;HEEDGGCGGE?GGB;<FHGHBGHGGCHCHCGHGCCCBDCCGGCHEEGHHCCEC=CEGBCCGEHEC@BHCFHHECCDCHHHCGHHCHCHHHCEECHHHCCC=DCHCHACFCBCHCGHCGHCCEGGDCCH;DD:FHHFCECHBECD?DBB6	T	148	C	127
20	31573528	A	64	CAACCACACAAAAAAaAaAAACCCcACACAAcacaaAAaAAAAAcCCACAaaCacaACACAACC	DHHDDHDHDHGHHH>FHGHHADDDCHDHDGGCGDGGGGGGGBFG?CCGCGGGCGCGFCFBE@C?	A	41	C	23
20	32212690	C	89	TTcctTTTccCTTtcTcctctcTTtCctcccctcCTttTTCCCTTTCTTCTtTTTCttCtTcctTcttTtttTTTtTCCTTttTTTCCc	DBCC@CEGABDEGGBGBBGBGBGGGABGBBCCHBD@HHEFDDDGGGDFFDGCGFFD==CHFCCCFBHHFHH<FFFHFCCEFHGGDC=@A	T	56	C	33
20	33867697	A	47	AaGaaGGAGAAGAAAAAAAGGAAAAAGGGaGgGaaGGgaAGggAGGG	ADADDCBHCGHCH:GHHFHCCHGHHGBBBCBGB>EABGEFBFFCA?C	A	25	G	22
20	33972053	C	34	tTcttTcctttCccCccTcccttctttccttttt	C?=CEE?BFGFDB@DBBHBBAGFBHGHCCGIHHG	T	19	C	15
20	34090519	G	81	aAaaGGggAGaGagaaGagagAAgaaAggaGaaAgggGaGaggAAAGaAgAGGAaAGAAGgaaGGAGaGAGAgaGgGAaGG	C@CB8CCCHCFCFC:FCFCDCHHCFFHDDG?GGHDCDCGCGDDFGHBGGDGBBGFDBGGADGGBBGBGBGBGDFCB?CAC?	A	42	G	39
20	34167382	G	73	GAgaggaggaaGgaaGgGgaggGaggagggagAaagGaaaAAgaagaaggagaagaggggaaaggaaggaaaa	@?=C@ADCBFFEBEFECDCF@CEFCCFCCCFCFFFC@FFGFFDGGDGGDDGDFGDBDDDDGGBADGGADG@DB	G	37	A	36
20	34205035	G	70	AGGagAaaGaAagaGggGaaAGaaAGAgagagGgGgagaggAaaagaggAgagGAgAagAaggAaAgAgg	>CDEG>FFGEFFFFGFFGFEEGFFFGFFEFGGFGGGGGFGGFFAFGFCGE?DGFEAEGGEAG<EGEDEDA	A	36	G	34
20	34218673	G	108	cGGgCccGGCCGGGCCcCcGCGGCgGcCGcGgGCCGGGCcGGGgGGCGCgCcGCgCCggCCGGCccCGGGGggCCCcGCCGCGgGGCGgCcccgCCcCccCgGGcggg	:BGBG>BGFGGGEHFGBGBGGGGGCGBGGBGBG?FGGGGCDGGDGGEFGDGCGGDGGDCGFFEF=CFFFFFDDFCFCFDFFFFDFFAFDFACCDFFCEC;FCEE8>?<	G	55	C	53
20	34312658	A	89	aGGaagagaggggaaGAggAggaagGAAggGgagGagAGagaAAgGgaggAaaaaaaggagagaggaaGagaagaaagggggagaaagg	C;>CEEEF?EEEEE5CHFEGEDEEECHHFFCFEGBEFHCEFFHHGBFFEGHFFFFFFEFEFFGEFDFFBFFFF>FEFFGFEFFFDFEGG	G	46	A	43
20	34596371	C	34	CTccCtCtTttttTCCTctcTctCtttcttccTc	@FDDCEDE<EFEFGDDGEFBGEFCFFFE@EA@GA	T	19	C	15
20	36932551	G	82	GCGcGCgGcgGgCCGCgCGGGCGGgGggCGcGCcGggGcGcggGcGCGGGGGGCGGGcGCcGGGgggGCCgccCgcgGgGcg	DDGD=GFFD>GEHGGGDGEGGGGBG:G?GGEGGEGGFGCGEF>FD:GFFFFDFF:FEEFFEFFFFGGFFFFEAFFEFD@B@B	G	54	C	28
20	40079787	G	71	gTttgGggtgTgtgtttgTggggttttTtGtGgtttgGgTggGTtTTgttgttgttgtgtgtGggggttgt	C9B@@@ABEA?CFCFGECFCCCCGGGGFGEGECGGG@ECGCCECGFFCGGDHGDHHDHDHDEDDD<DHHDB	T	37	G	34
20	40714539	C	37	TttCCCCTTtccctctTCCccccccTccctttccctt	>BGGFEGFEGBBBGBGCFFCBCACCFCCCEHHBBE@B	C	22	T	15
20	40979430	C	31	cctccccTtTcTtcttcccttttttTccttc	C?C?BBBGGGBGEAGGBCCHCHHFHGCCHGC	T	17	C	14
20	43043051	C	28	GGcCGcGgCCCGCGCCGgGCCGCGGGCC	@;AACDCDDCC@CACCBGBCCAC;??@C	C	14	G	14
20	43251434	C	149	TTCCCTTTCtctCcTCCTCCCCTccCTtTttTTtCcCCtTTCTCTTCTTTCtTTtTTtcCccTtCtTTCcTCtTTtcTtTCcTTCTCTcttTCtttCTTtTTCCTCcCCTCCtTctCcTCttTCTCTCTtTCtttTCccCCctCcCTTT	BCBCBGDFCEBG;BGDDHDD?DGC7@GGFHFGGGDADDEFGDGCEGD7GFDHDGHGGHC@C=GHDGFFC>GCHFFHCFHFC@FFCFCFCHGFC9HHCFFDEF<CFCCC8FCCHFCHCCFCHFECDBECEGFC5DEDA==@@=@@;AAC?	T	84	C	65
20	43348735	C	110	AaccacAACaaaaaaACACaaCCaaAcaCAcCcacACAACAcACacaAAcAaAAaAaAccCCAaCAaCaCCcAcAAcACCAaAACCAAaAACaaaAAaaCCaaaCCAaCc	?CBEDDFBGEEEEEEDGFCEEGGEE:CEGEDFEFEFEFBEFEFGFDEFDDFFFFFDEEE@FDEF6EFFFF@AEEECEE?FEFEEEE;E;BDEFEFEEDF>FDDAAA??A@	A	68	C	42
20	43356156	C	61	CcCctcctctcccCCtctcccCCctccctttcctctctccctTcctctcctcctcccCtcc	<>>AA?ADEF>ECBDDCEDDDDDCEDDDEEEDDEDEDFDEEFGD;FEEEBEEEFEEECFD@	C	42	T	19
20	43379264	A	28	AcaaaaacaaccccCcccccaaAaccAC	B>CEDEDDEEDDDDDDDDE@FEHEEED@	C	15	A	13
20	43379454	T	58	TcTTCCCtCcTttTCTTtTTcCtCCCcTTCTCtTtCttCcCTTTTTtTTcctccCctc	DEFGD:EECFEEEDD7GEGGGDFDDCGGGDECEFFCFEC<9CFFFFDFFGFFGEC?9B	T	32	C	26
20	43538733	T	38	CCTTTTTCTTCCCTCTCCCCTTTTTTtTTTCTTTTCtC	ADGHGGGDGGD8DGD<CDDCFGFFFFHFFFCFFFEC5A	T	24	C	14
20	43566863	G	41	agAagaaAaaagagaAagagaagaagggAgaaggaaAaaag	ABBEFDDHDCDFDFDHDFDFDEFECEDEGGEE@G9EGCEEG	A	27	G	14
20	43588833	G	41	GAGAAAAAGAaAagGgGAAAGGAGAGGgGGGAAAaGAaaGG	BF@FFEFEEFGE@DEDDEEEDDADEDDDDCDEDDFEDCAA?	A	22	G	19
20	43835683	T	97	AaTTAaAaaAattAtattAATTTAttTTaATAaaTtAtatATTtATaAAAAaATaAatAAAaatTatataaTatTTTtAaTATtTattttTAaTAaa	8A?ACGEFEEEEEEEFEEEEBEFDDEE;FEAEGGBEBEFFEDEFE=FEEEEFEEGEGEECDFGECFFG9GG9HFDDAFDE@DDFDFFFEFDBFED><	A	52	T	45
20	43850143	T	46	aTttaAattTaaaaTAaaATATTTtaATTtatTtTAttAatTAatt	ADBCDEDDDEDDDDEEDDEBEEE9EE=CDEEEDEDDECDEEDDDE=	T	25	A	21
20	43850400	C	105	CcaCcacaCCaccAcaCACCAacCcCccccaccACCAAcCaacccaaACaACccCacCcCAccccCAaCCCccCcCCcaaAaccAaaccAAAAcccaAAcCACAC	B?A<DCGDEGDFGFGCGFGGBDGGGFGGGG@HGFGGFE=GEEHHHEEFFEFEHHGEHGHGEFGHHFEEGFFGHF;FFHEEEEHHECEGHEDFEGFC@ACCAA?C?	C	65	A	40
20	43926536	G	74	ggTtTGTTTttTTGGGgGTGTgTGTtTGtTTGGTGtGTGTgTtGGtGtgGgTGGGGttggGggtGGTtTGTgtg	<BFDGFEGGEBGGGGGECDGGFEFGDFGFGGGGFGFGGGGGDFGFFFFEFAEF=FFFFGEEFGBFFFDCCCB>D	G	38	T	36
20	44141331	A	109	gaagGaAAgaaAGGGGGAAAAagAAaAGaaAAGGGGaaaagAAgaGGGaGAaGgAgaGaAGaGgAGAaGGAAggGgGGagaaaGGAGaGGAAgaAGAGaagAgaAAAGG	DDCDBCHHFDDHBC8CCHHHHDFGHDHCECHACCCCEEEEGHFGEBC5ECHECAGGBCEGBEBEGBGEB>HGGGBGBBEFFEEBBGBEBBG;CEGBGB>EGFGCGHGCC	A	59	G	50
20	44144118	C	69	tcCCCtCtTcCctcCtctttCcCTtcTCTTTTtTTtttCCttcctctcccttTccctcttttttttcCC	C@??AFBFDBEBGBDGBGGGDBD=GCCDD?ADHFFHGHDDEHCAHCHBCCCHDACCHCFHHHHHGACC@	T	38	C	31
20	44174423	G	170	GggAgagaggggGAaggGaagaaaGagagggGagaAgGagaaaAaAGGgGAggaggagggGaagGagagaaAaAggaGaaAaggAaaAAaggGgagAGggAAaagaggggaaaggGAagGgggagAggaAggggAgaGAagggaggggggagggggAggagggggaagga	@C?;A<ADBBBA?FGDDBFF@FFFCFCFCCCCFCFHC?FCFFFGFHCBCCHCCFCCCCCCCFFCCFCFCFFDFHCCFCFFHECCHFFHGFCCCDGBHBDDHHGGDGDDCDGGGDD@HGDCDDDGDGDDGGDDDDGDGBCGDEDGDDDDDD@DDCDDGDCGDBCBCCB8:@	G	98	A	72
20	44574533	C	172	CcCTCTCcTtctttcTTCccTTTCtccccTTtTTCTTCcttcCctCTttccttctTTTccccctctttTtCtCTccCCCttcCCCCttCtccCCtccctTctttCttTtCCcTttcccTCccCTttctttccCTTCctTCCCCTcTCTctcCcCCTtCctCCTctTCCCCct	>A>A=@?>>EAG5FAEFFABFFEDCABBBBEGFFFFEF7GGBGB?GFGGBBGG?GF@BBBBBAG@GGGEDEGFFBC?<GHHC>FDGHFGHCCGFHCCCHECHGEFHHEHAFCFHA<CCDF<C6FHHCHHHBCFEEECAFF@FFDB?FE7HCECEF>HF=GEED@DCCCBA>?	C	92	T	80
20	44587926	A	102	CaCCccAaAcACcACAAaCaaCACCcACaAAacaCccCAAaCaAaaCCaaCCCACcAcAaCACccCaCacCCAAACCCaCacCCTcCaCcacCCcACcACCC	ADBCACEEDAFGBFGFAF8FFGEGEBFCFBFFBFGBCDFEGGGFGGGEFGDGGFG=DCEGFEFC@FHFFCDFEEE<FFDFGCFFF6FGCAGBFG==@<CA??	C	58	A	43
20	44596545	G	119	gggGgAGggGgggaGgaaaaggGAaaaaaGAgggGAgaGAAAaggaAaAgaagagAAgagaaGgAgggGgGgaGaAAGgAaaGGGGGgAGGaagAGAgagGaaAaGAAGAAaGAAaAga	BDDEFFFDEGFEFDGFEEAEEFGEEEEEEAFFDDGFFEGEDFFGDEFFFGFCFDF@EGEFFFG6FDFFG?FGFFAEEFFEFFFFFFFGEFFFFGEFEFFAFFDDFF=EFEEFGDDABB<	G	60	A	59
20	44756891	G	67	aGGAGAGggAGAGgGAAaGgaggaaAaaaaggaaaaaaggaagggGGgagagaaaaagaaaagaGGG	C=::>CDDCFEFECEEFFECFCCFFFEGAFDDGEDGGGDCFGDDDEEDGBBDGGCGGDGFGGDGDDC	A	36	G	31
20	46288433	C	34	TTttTcTtcCCtccTttCCCTcCTtTTTCCTTTc	CGGGFBHGBFGHCBEHHGCEFCFFHFEFEEDC?;	T	20	C	14
20	47604825	G	101	GGGGAGGGGGAGAGGGGGGAGAgAAAGAAGGggAgAggGAGGAAGgAGAGGAGAGgAGAGAGAAGGGAGAGAGgAAGGGAAAaGAgAgagGAAGGgaGGgg	=<ABHCC=CBHCGC6>CBCHBBGH=HBHHCCGGHGHGGBHBBGGBGGBGBBGBGBGFBGBGBGGBBBGBGBGBGGGB=BGGGEBFGFGEGBHG?@B>CCDD	G	62	A	39
20	47682893	C	200	cCctTcCTcTCtCtCtcTCcCCccTTcCCCTTCccTCTtCTtcCTTTctcccTCCctCTTCTtTTTTTTCTTTCcTCcctCTtcCtcctcctcccCtTcTTCCtcTtcCcTTCtctttTCTcttTTTCccCCTTTTttCctTCCCCTTcCtTCCCctCttTCCCCCTCtcTCCtcCTCCTcctCCctccctTccttCctC	B?BDEGBFEGDEDDEEFGDEDDFFEFFDDDDGEFFFDGEDGDFAGGGF=EFFGDDGEDGGDEDGGGGGGCGGFDGFDGGFDFDGDEGGFGDFFGEDFGGGGCCFGFFGDFFFCBFFFFFCFGFFFFFCFG@@FFFFFFCCFFDCCCFFGCFFCCCCFCFFFCCCCCCCFGFCCFGCFC>EG@FCCEBCCCCCABA:?>@C	C	108	T	92
20	47839653	C	40	TtTTCcttccttcCttccctCccttcttcccccTTtcttt	BB?BEEEEFFEDEFEEFFEEFGGFFGFFGBGG>EEFGEEC	T	21	C	19
20	47852822	G	175	GGaGGAAGAAaaaAGgAGggaAgGGAaaaGgaAAAGGggagGgaaAgaggGAAgAGaaGgGAgAagAgaGaGGaAAAgGGAAGagAgagAAGGggGgAgggagaGAGAGGggaGGaGaagGGgaGAAagGagaagaaAGGggAaAGggGagggGaggggagaAaGAGgaaaAaGA	@@?<?GDBHHEED:=DHCDFCHCC?HDEECEEHHHABEEEDCDEEHEEFDCHHBHCFECE=EFHFGCFFCFCCFHHHCCCHHCFEHADFHHCBFFBGEFGGFFFBGBGBBGBECBFBFFDB?FFBFGEDBFGFDDEF@:BEFFFGBFFBEFGFBCAGFEEEEGD?E?7@@:@A?@	G	93	A	82
20	47865509	G	365	AAgggaaGaggGaAGGggggAggaAgAAGGGGggGaAGGGaaAGaaAAGAGAaggGGAGAAgaaAAaAggagaGAgAGGgaaAGAgggggGAAAAAaggaaaaAAAggaGGGgaGAagAgaAgAggggGGGAAAggAaAAGGGAAggGAAGggggaaaggAAAGaAGAggGGGagaggGAaaGAaGaaggAaagAggAAAaAGgaaaAAgaaggggaGaaGGaagaaAAAggAAggAaggaAgaaaaggagaaAGaaGGGaaggggAggAgggagaAaGaaAGaaGagaagaAgggaGGaagaGAAggaaaaaagaaGAggaAGaaaaagaAGaaagAAagaaaaAGggagAgGggaaggagAGa	CAC>BBA;BAA@DBBBDDCDBFGFDEFFEDEEEEEFFEEEFFFEFFFFEED@FFFEEFDDBFFFEFFFFFFFFEFFEEEFFFFEFFFFFFEFCFDDFFFFFFEGG;FFEEEEFCEFFFFFFFFFFFFFEEEEFFFFFFFEEDEFFFFEFF;GGG>GGGGFFFFEFFEFGFEECFFEEGEFGGEFEEGDGGEGGGFGGCF=GFEGGGGFEGGGGGG:FEFGEEGGGGGFFFFGDFGGEDFGGFDGGGFGGGGGGEEGGD>EF@GGGGEFGEGGGGGGEGDGGE@GGDGGG:E?EBGGF@DGGGGDDDGGFGGGGEGGGDEGGEDDGGGEEG<EDGGGBEEGGGGGFEDFGEECABBB>ABB?6??B	A	193	G	172
20	47892270	T	39	CTTCTCCTCTcCCTTTTCCCcCcTCTCCTctCCcTCtTC	?E7?D9DEGEGEECCDCDFEGDGDFDFECGFFFGC>@AC	C	23	T	16
20	47990260	G	75	AagAGggAGAgGGGAAAgaagAgaaggaagAggGgGgAGgaAGgAAGaAGAAggGAGgGAgggaAaAggGAgaGa	<DCEDBBFECCEEE9E7CFFCFCFFCCFFCEDBDCECDEDGFEDFFEGEEFECDDED6DDDDDGEGEDACB>@AB	G	41	A	34
20	48098402	G	56	GGGAGAGAGGaGAAgAAGGGAGgGAGAAAAAGGGGAGAGAGGGaGGAaAGGGgAGG	B@@?EFEFEEEDEF:EFED>FDGDEDEEEEEDDDDE:EDEDDDEDDCEECDBACA<	G	33	A	23
20	48260203	G	114	GgaAGGAggGAAggggggaggAgggAgaagaGGGGGggggGGagAGAGGgAggggaGGaGAgGaAagGAaagAAgGAAagAggAaagAgGAagaGgaaAGgagggaaGGGagGa	?BCEDDCAEDFFFFFFFFDFFFFFFFFDDFCF9EEDGFFFE@DFFEFEDCEEFGGEDDEEEGDEFEEADEDGFAGDEEEGBGGEEE@EGDEEFDDGEEEDGEGGGDEEDDCE@B	G	69	A	45
20	48429462	G	40	GGgGTGtTGTTTtggggtGGtTGgggTTggggtGtgTTTt	EHBH<AGEBE5EHDDDDHHHHDGDDDDDDDDDHDCDCDCC	G	22	T	18
20	48808011	C	90	TCttTCTTcCTCTTcctttCcCcttTccctctttttCTttcttcttctctttctttcccctttctttccttttctccCtccctcTttcct	BACCB<??@BFDGFABGEFD@EBGGBBBBGBGGCGGDGHGBGGBGGBGBGGFCGGHBCCCGHHCHHG@BHEHH@FCCCGCC=F=FHH?7>	T	52	C	38
20	49225610	G	39	CgcCggcGgcgcGgGccCgggCcGGGCGGGgggcGCCgc	?CBECC=@CBCBCCEC=FDDDGCBDDEDDD>DDADEDBA	G	23	C	16
20	49227500	C	65	TCCtcCtTtcCccCCcctttCTccTcttTTtCTcTtttttCCttTtTcTCcTTCcttccttccCc	C<<FBDGGGBDBBDDBBGGGEGBAGBGGGGGDBCD9HHHHDDGHDGFCFCCGFCCHHCCHHCCB@	T	34	C	31
20	49232725	C	30	GCgcgcgGcggcGCgcGgCCGccgcgcccc	9BB@DBCBBCCBEFCBEDFFEBC@CDBCC7	C	16	G	14
20	50245732	G	29	gGcggggcgcccgccggcggggccggcCc	?DFFFFFFFFFFFFFFFFFEGGGDGCGFE	G	16	C	13
20	50705211	A	91	AAAgAggGAgGgGGGgagggggagaGGaGGAggggGaAaagAgagGgaGgaagAggGggagagaaaaAggagggggAggggaaAgggaGga	CCC@A??;CCFBGFFBFCCCACFCFFGFGGFCCCCGFFFFCECFCGCFDCFFCFDDF>DG>GDGGGGEDDG9CDDEEDDDDGGEDDDGFDF	G	57	A	34
20	50705584	C	54	cTcccTcccCcttcttTCtctCTcttTTCtTCTcttttctCCcctTTtcCtCtt	?<BBACDDCDDEEDEEGDEAEDGD=EGGDFGDGDFCEFBFC:EEFFFFEC=A<B	T	29	C	25
20	50769549	A	264	gGAAGgAGaAAagagGaGaggggAGAgGagGGAAAAGggAAGgaAgggGGGGagaAAagGGAaGAGagAGAgagGAGAaGgGgaaagGAaaAAAAAGaGGGgaGGaGgaAAGAaGAGGaGGgggAAGGaGggggaaaGGaaaGAaGAagaGgaAgAAaagggggGagaagAGGGaaGAAggaaaAGagAGAaGaggAAgaAggAAgagggAGGGggggGGAGGggaAAGGGGaaAgAAAaggagaaaaaaGaaagAgAGgaGAG	C>@@;@C;CC?CBEF7FCEFFFFGCCFCFFCCEHAFAFFHHCFFHFDFCCCCFDFHFFFCCAECHCFFHCGCFFC=CHFCFCFFEFFCHFEHHHHHCGBCCFEBCGBFGHFCHEBH@BECCGGF@9BCGBGDGGGEEB<@DGCEF;GDGFCGGHDGGGDGGGGGBGGG<GGCCBGFBGGAGEGGG?GBHBBGBGGGGGEEGGGGGGGDGGGBBBGGGGBBGBBGGGGDBBBBGGGFGGGBGGFFGG?DEE@DDADCAD=?<CCC	G	137	A	127
20	50808277	C	68	TctcTttTctctTCctttctcCtctTcTTCtcCtctcTCcttctTtcttTtcCtctTctccctcctct	@CABBDDEDEDEGGDEEEDEDDEDEGDDGGFDGEDEDGDEEFEEGEE9<G6EFFEFGEEEFE;EEFD@	T	38	C	30
20	54940356	T	45	TCctctTcttcTtttctctttcttCtTtcttttttctttccctcc	B><9?HGAFFBFGGG@GBGGHBGGDGCC9HFHBHHCHHGCCCH5C	T	29	C	16
20	56136536	A	130	aagaGaaaaGgAaAagaaGaGaGggagAAgaaAGaaaggaagggaaGgaaGagGAGGaaGAAGagggggaGgggagAggagAGaaaaaaAgaAgaGGgagGaGaAagaaaAaAGAagGAGaaaGgGAaGG	CA>CA=BBDHDCD>DFEEHEHEHFFEEEEFDCEHEDEFFEEEEFDDHFEFHEFHEHHEEHEEDFEGGFFFHGGGFFCFEFFEGE@FFFEEEFDFFHGGBCGFGFDFGFF?BDDGDFFGDGFBFGDEA???	A	71	G	59
20	57565943	G	102	CCGCGCcGCCCGCgCGCccGGcCgccCcCcCGCGCgGcGCGCGGGCcGCcGcGgCCcCCCcggGCgGCCCCCCGGGCCgcGgcGcCggCgCGGcgcgCCgCC	B<DFEFEE@FFE@FFEGFFEEGGFGF;GGGEEEEEGEGEEEEEEEGFEEGCGEGFFGFEGGGG<EGDFEFEF<DDA?EFGDGGDGDGGEGEDCEFEECCAAA	C	60	G	42
20	58644995	T	66	CTCCCCCCCCTCCTTTCCCCCCCTCCTTCTTTTTcCcTCTCCCCcCTcCCCCTTTccCTCCCTCCc	?FDDDDDDDDEDDGGGDCCCDDCFDCFFCFFCFFCCCF=FCCCCBCFCCCCCFFFBCBEDCBD@@@	C	45	T	21
20	60773684	C	76	TTCTCTTCCcTTCTTCTCCCTtCTTTCCCTCCCcTCtTTTCTCCTTttCTctTtcCTCcTtCCCtTCCTtCctTcc	DEGDFFFGGDEEGDEGEFGEEFGEEEGGGEGFFEDFFCCCDDFFDDDEFCEBDFEFDFDDFEFEFCFFC>B><ABB	T	39	C	37
20	60963494	C	100	CTtTtTCTtttTtTTcccttCtTCccCccCttccTttTCtTTctccttCtcTccCcttTCttcccttcccccccttcccttcTtttcccCttccctcttt	D>B?>ACADFECDEEDDDEEEEEACDGDDGEEDDFDDEGEEEDECDEEGDDEEEGEFFEGFFEDDFFE;EDEEEEFEEEFFEDFFFECEFFFEEEFEFFB	T	52	C	48
20	61039958	T	39	TCCCTCCTttCCTTCCTCcccttTccCCctTCTTttctt	CGGFE?G>GHFGDEGFDGC6DIHDBCFFCHDEDD@HBCE	C	20	T	19
20	61273640	G	51	gggccgccggccGggcCgccgcGcggcgccggcccgcggcGcccGgGcggc	C@CBBCBABCB>BCCBFCBBC?EBCCBCBBCBABCDCDDCDCCCDED5BCB	G	26	C	25
20	61288355	G	80	TtTtGggtgGgTttGTtgtgggtGgTggtGgtGtttgtGTGtGgtGggtggTTTgTtTgtGtGTTtTtGtGgTttTtGgG	CCAC?AADEE<FEEEBEDEFFFEEFEFGEEFEE>>EGDDEEFEEFEGEFFGFCEGAEEDFDFDBEFDCD@DF@?=C@A;A	T	42	G	38
20	61391367	C	107	cCAACCaCAAAACCACAAAAAACCACCCAACAAAAAACCAAACAAACAaaaAcAACCACACACAaCCAAACCCCCcAAAACCACaCCCaCACCCCCCAACACACAcc	?<=EGGDEFDFEG?FFFEEFDFFGFGEEFEFEEEEEEEFEEEFEDEFDEEFEHDEDFEEEFEEDCFAEEEFFFEEDEEEDFEDDEEECACCBBA@>>BCABCCCCDC	A	57	C	50
20	61441035	G	131	GAgaAGaaaGaAGAgAgGAagaGGgGGaaGAAaaGAaaaaaagAGagaggGagaggaAaaAGGGAaaaaaaagAggGGgaGAaGaAGGAAAaGAGAaggagaaaaAgaaaaaaagaAaaGaAagggggggg	B?C?<=CCC?C??>ACCCEGCEEDCEEEFEE=FFEEFFFFFFCEEFCFCCEFCF:CFFFFBEEEFFFFFFFFCF@CFECFD<EEFFDEFFF=EEEFDDDEDGGEFFCGBGD=EGDDE=;EGD6E8BDDDAD	A	77	G	54
20	61442996	C	32	CtCcttccttcccccccctcttcctcctcctt	A?>?GF<BGEBBBBBCACGCHHBBHCC@CCHG	C	20	T	12
20	61443547	A	66	AAGGGAGAgAgGAGgGaGgGGAAAAAGGAAGaggGAaaAAGAGGGAAgGGgGGgGgaaGGagaaAG	BHCCCHCHCHCC:CDCGCDCCHGHHHCBFH@GD?BGFGEEBG=BBEEDBBDBBDBDGFBBFBDCD:	G	37	A	29
20	61443870	C	42	cCGCGgCCCCgggGgggcGGCggCgcccccgGgcGGgCcGcG	BCCDCFDDDDFEED:EEEA>DGGDF@EAEEFBAEBBFCA<>C	G	23	C	19
20	61598899	A	30	aAAggagaGgaagagGggaagagaagaagg	?>HCCFCFCCFFCFCCCDGGDGCG=DGGCA	A	15	G	15
20	61912715	T	53	ctCcctcctttcccCCccctCtCttTTtccCCTctctTCtccctCcctccctC	CC?<@FBAGGGBABDDBBBGDGDGGGGGBBDDGCHAGEDGCCCHDCCHCCBF>	C	33	T	20
20	61950399	A	79	aaCCACaCaCCaaAAAAaCaaAaaaCaaaaaaaaaCaaaaaaaaaaaaaaaaaaaAAaaaAAaaaaAAAAAaaaAAAAa	A@;@B:DDDA>DDA5@HE>EA<AEE7EBEEEEC:E7EEEA>AEE9EEBEEEEEEECFBD@BD@@;?C@>CD?<<AAAC<	A	70	C	9
20	61956782	T	60	CCTccCCTTTtTTTCctTcTctCctcttTtcctcTCtTTTCtcCCTCtttCTttCtcctT	DD9BDGGEEB=DDCFD?EDD@BGEFEF78>9EFEEFFEEDF>EEFDFEECFDFBFDED>C	T	34	C	26
20	61959642	G	169	AAAAAAgGGGAAAAGGGGGGaAGgAAAAGAAAAGAGAgAgGGGGAAGGGAAGGGGGAgGGaAGGAagGGaAAGAGgAGGGAggAGaaAAGAagAGAgggggAGGaaAaGGAAGAGGAAAaaAGAAAAGgGGgaGGaggaaAaggaaAgAGggAAAGggGGAggAaGaGA	@<B:5HCC>C=HHHCCC?>CFIBCHHHH?HGBHC@CHCGDC?CCHGCCCEGBBCCCG6CCGH@CGFCCCFFHCHCCHCB:GDDFAGGCGBGEAG=GDDDDAHBBGGGGB?GGBGBBEGGFEGBG;GGBDBBDEBBFDDGGGBDDGFGDGBDDFFD?A@>9E>>B>>>AC	G	86	A	83
20	62038277	T	107	tGtttTggTtgtgtggggttggtGttttTTTggtggtGtTtgtTtgtgTtttgtgTtttgtttggtgtgtGtttttgtGtgtggtttttttgttgttTttgTgggtT	@=>BB?BCEEEDFEFAFFBEFFEEEEEEFFFFFEFFEDEEBFEFEF=GFFEEGEGFFEF=FEFGGFGFGF9FFFCFGFCDGCGGFEDFF@FGEFGEGDD6E=GGDEF	T	68	G	39
20	62152819	G	47	aAggagaAgagAgaaaaGGAAagaAgaAaGGGaAaAGAGAaGAAAAA	DACBFCFECFCECFEFFHHEEGDGD:GEGHFHGDGDFDGDGDDC?@A	A	31	G	16
20	62161418	G	139	CGGGGGGGgGGCCGGGGGCGGCCCgGGCGCGCGGcGGGCGCGGGCCGGCCCCGGCCCCGCCGGCCCCgCGCCGggCggCCCgCgGCGcCCgGCCgcGCcgGGgGgCgcgggGCCGGGGGCgccgGGGcCCcCgggGGgg	?BEF5GGGFF9DGG:GGGFGGG8BFGGCBGFG@GGGFCGGGGGFDGGGGGGGGGGCFGFGGGBGCFFGFFFFFGGFGGBFFGFHF?FDFFBF@FGGFFGGFFGCGCGFGGGFFFFFDEFEGAFFDDEABBBB@?ACADD	G	81	C	58
20	62161421	G	140	GGGGGGGgGGAAGGGGGAGGAAAAgGGAAGAGGaGGGAGAGGGAAGGAAAAGGAAAAGAAGGAAAAgAGAAGggAggAAgAgGAGaAAgGAAgaGAagGGgGgAgagggGAAGGGGGAgaagGGGaAAaAgggGGggGaG	B<;?DEECEADFEBEEEFEDF7D:CEE<FEDEEFDDBFEFDEEEEE@FBDFEEFFF?EFDDEFEDEDEDEEDDDEDDEEDADDEDGBE9DDD>HDEGDDDDDCEDGDDDDEEDCDDDEDGGDCCDGEDFFC@ACB>>>@?	G	82	A	58
20	62162340	T	44	TttcCtttCCtttCtcctctccctCctcttccctttcccccCtc	@CC?@DCDFFEEEBEFFEFEFCFEFBEEDDFFAEEFGFFDGF:D	C	24	T	20
20	62173925	T	81	ttGgtTGggGtttggtgtgtGTtgtTgggttgtggtTtgGtttttgggtggTTtttgtgggtggGtGgGgttgtgtgtggt	ABBFD><EFCEEA@FEDEEECEDFEGAFE=EFEFEBGBECDDEEEA>7EEDFGEDFGDFGG=E5C<BGBG?FEECF6EGFE	G	41	T	40
20	62173927	G	79	ggAgGAaaAgggaagagagAGgagGaaaggagaagGgaAgggggaaagaaGGggggaaaagaAgAgAgaggagaggaag	A=?ABEFFGCBCC=CACDCH=CFCAFFFCCFCFFCCCFHC?CCCAF5CG@ABDCDDGGCG@FFDGDGDGDEGDFDDGGD	G	42	A	37
20	62178425	C	30	tcCCCCTCCcTCTCTTTTCTTcttCCccTC	C:GGFGFGCC@EEBEEEEFEE@H5FFCCCB	C	17	T	13
20	62191558	G	26	agaGAaaGAaAAAagggaaAaaGAGg	@CFCHEGCHGHH=GDEDGEGGBAG:A	A	17	G	9
20	62192374	C	72	tctttcccTtTCcctTccCcCccCCCctTCcTttcTTTCCtCCTTTCCCTtTCTTTTTCTCTTTccCtCCTC	?>AFECDDBECEDDECDDDDDEDDDCE?DDEDEEDFFFDCBCC?FFCA=FEFCFFFFFCFCEEFCDC>BBC@	C	37	T	35
20	62195220	C	128	cctCctTctcttctctCccCtcTTcccCtcttttcCtcCtcCcttTCTCTcTTTtctCttTTTTcCTCttTcTccTTTTTcCttctCTCCCTCTcttTCCTtCtCCTTCcCTtctCCTCCCTTTcCCt	<<@=>CB?D;GHAG?FDBBDGBHGBBBDGB?GGGBDGBD?BDBGGFDEDGBGEFFBGDHHGGFGCDGA9HGCGBBGGGGFB>HHCDBFCCCACFCHGFFBFHCHCCFFCCCFH=HCCFCCBFDF9==@	T	66	C	62
20	62221766	C	106	CTttCCTttTTcTCTTtctccTTTCTTtTCtcTtCTCcTtTtcccccccCTtTCcttcTtTctTCTtTttTcCTtTtctccCtcTtTCTtcTTcTctTTTttCcCC	=BCC?>@DDFDCED=GDBGBBDEGDGGGGDEBG;>GDBGFGHBBBCCCCDGH>DAHHCGHDCHBAGHGHHF<CFCC9@HCACH>EHDCFHCFFBFCHEECF?A:C?	T	64	C	42
20	62309554	C	232	CCctcttCTtcTTTCCCCTTTTTctcCCTtCCtTctttctTTcttcctCCTTccTCTTctTtccTCctTttcTttctttcttTCttTtcccccCTCctCtccTCCctTtctCTCcTcCTctTtctTtCtctCtctcTCccCTTctccCCttTcttCtcctccTtctttcCctccTtttCtcCcccctTtctctcccccttTttttCTcctctCccccCttCtcttctttcct	ABCC?C??@B=>?A<<==BAD@D@EA?AEHDDGGAGDGBGGGBGEBBGDDBA;BGDGGBG:GBB;EAFGGGBGGGBGGGBGAGDGGG?BBBBBDCDBHCGBBFDBAGGGCHDGDBGCDFCHGFCHFHDHCHCHBHCGDC>DGGCCBCDC:HGB=HDH=BGCCGF<ACCB7CHCCFCHGCHCCCCCC>CFAGCH6CCCCHEFHHHHCFAABCFCBCCCC:HBHCHGBGFD?<C	T	120	C	112
20	62325665	A	135	AAAAaCCCACAaCAAAaaAACAAACAaAaAAaaaaaAAaAAAAaAAaaaAaaaaaAaAaaaaaaAaaaaaaaaAaaaaaaaaaaaaAaaaaaaaaaaaaaaaaaAAaaAaAaAAAaaaaAAAaAaaaaaaAaaAa	;E==D:?BA:=E@F;:EEH97CA:8;BEFB<@FEFF:;FD@G:DH@E=EAFEBFF?<HFCAEAFEE<FFFFAFCFFFFFF;?FFFF?FDFEFFCFFFFFF;EEAEGFFGFG=GFFEEEEGHHEFBAA@@@C?:?A	A	128	C	7
20	62372706	G	26	GAAGAAGgGGGgAGaGAgAAGAGGgG	?HHCHGCABBBGGBFBGGGGBF?>@C	G	16	A	10
20	62374389	C	60	TTcTttCccCTctcccTTctcCtTTttTttctCtttttcCctCcccctccttttttttcc	????:C8DDGGCEDD:A>DBDGEGDBEGEDDEGEE>F=DGDDGDEEEFEDEF:99AEFEE	T	34	C	26
20	62518729	A	28	GAAAAAAGAAAGGAAGAAGAAAAGAAAG	CFDHHGHCGGGBBGG@5G>G@FC>;DBC	A	20	G	8
20	62518766	C	60	CCCTCCCTTCCTCCTCCCCTCCCTCCCCTTCCCCTTTTCCCTTTTTCCcCtCTCTTCTCc	BFGEGGC=DFGEGGDGGGGDEGFEFFFFD<FFFFDCDDFFBDCCDDFFCE5CDCB?BC@>	C	37	T	23
20	62698188	G	27	AAAGAAGGAAGAAAAGGGAGGGGGGGA	AEFEFFEEFBDEEEEDDD6DDDBBBB?	G	14	A	13
20	62701092	A	45	AACAACcAaCCAAACaaaAaACACCCaCaCAAAcAAAAccCACcc	?BG<FGGFDFFFE?GECEFE5BEFFEEFEFEAEHEEECHFDEFCC	A	26	C	19
21	15583332	T	56	cTtcctcttTttttCCttttCccttctccccctctttcttttctccttccttcctt	C>:BCC6FEEEDEEGGEEEEGFFEEFEFFFCCEFEEEGEEFEGFGGBDGGE:GEFF	T	32	C	24
21	15599142	A	81	AAGAaGAGGGAGGGGGAGGGAGGGAGaAGAaAAAaAAGGGAgGgAGgGAaGGGAGAGAAGaAAGGgAggaAaagGAAGggG	??HE;HEHGGEHHGHHEHHHEHHHBHE;FEEEECEDDGGGDGGGDFGGDDGGGDGDGDDGEDDGFGDGGCCEEGEBBD?AC	G	44	A	37
21	15599144	T	84	CCTCcTCTTTCTTTTTCTTTCTTTCTcCTCcCCCcCCTTTtTtCTtTCcTTTCTCTcCCTcCCTTtCttcCcctTCCTttTCtt	A?FGFEGGGFGGFCGGFFFCGGFGGGGDDGGGFFGFGEEFFFFF?FEFGCFFFFFFFFFEGFFFF@FFFFFGGF@EEFBA=B?>	T	46	C	38
21	15755349	T	113	cttCCCcCCTTTTTTCCTTTcTTtTCTTCTCTctCTcCctttcTCctccCCtttCTtccTcTTtctTtCTTCCcCTtCccTTTctCCCcTTTccCtCCCTTTtCtCttTtcCc	CCB>>?@DCGGHHGDDDGGGBGHGGEGGDGDGCGDGCDBHGGAFDCH?CDDGGHDGHB?GCFDG?HFHCGFCCCCFHCCCFFFCHCCCBFF8BCCHCCCFEEHCCCFFDD=@;	T	59	C	54
21	16340289	C	136	cttTTttTTcttCCCctCtTtcCTtCccCtcTcTtTCTcTTtccTCcCTctctcCtCCtTctTtTcCtTtCccTtTTttCTCTCCCcCtccctCTTcCtTCtctccTctTCcCCCCTCTTTTCTTtTTTtTCTttc	??AABACFFDEEBDDDEGEGEDGGEGDDFEDGDFEGGGDFGEDEGGDGGDFEEEGFGGFGDFGF<EGFGEGEEFDGGFFFEFFFFFEFDBEABFFCDEEFFFEFEEFCFFFDFFFEF@EFEFFEFFEE@DCDA>>=	T	74	C	62
21	17135395	A	28	aggaaaaaagggaagaaagaagggggga	ECBFF6FEFCCBFFCEGBDGGDD9DDEG	A	15	G	13
21	19506694	T	126	TtGgTGTGTtGGTTTgtgGTgtTTGGGGGGgGTtgtgGGTttGTGgTGgtgTgggGGtTggTtTgTtTgggtgtGtGTtGgTGGggTgTggtTTgGTTGTgTggttTTtgtGgTgTggtGgtGttG	>CEGCHDHEDHGEEEFEFHEFEEEGHHHHHFIEEFEFHHEFDHEGGDHDFEEGGGHHFEFGEEE:EFCGGGFGFGEGDFGGDFGGGDGAGGGDDFGDDGDFDFFFFDDFGFGGCFDGDFGGFFFEC	G	67	T	59
21	19632678	G	56	AGGAAGGGAaggAAagGGgaagaGgggagaaagGaaagaaGAaagggaggggggag	CB?@AADEDDFEFFDFFGFFEFFGGDGGGGGGGGGGGGGGGFGGGGGGEDFECB@D	G	31	A	25
21	19756040	C	174	GCCCCCCGGGGGCGgCGGcCGCCGGGGgCGGCgcCCCGgCGgCCCCggcCGccggCgcgGGcCccCGGggGCcggGggggGGCGGCGgcgCGCccCgccCCccccgcccgCCCCCGGcccCCgcgCCggCCccgGGcGGCgCCcGcgcCcCGcCCgCGgGGGcGGcGcGcGcgg	BBCE@A?ABBEFAHFGGHBGHGGHGHGFGHHEFGDGEHFGGFGGGGFFHGGGGGEFGGGHFHGHHFHGGFHGHGGHGGGGGGDHHGHGHGGHGFHGFHHFAHHHHGHEHGFFFFFGGHEHFFEHGFFF8FFHHGGGHGGFGFFEGH@GFHFFFEEGEFFCHHEFF@EBCA@CB@	C	91	G	83
21	20618256	A	34	AAAgAgaAGgGGggAGaaaGGaGggaGagggggG	?CCCCCFDHCHHCCFHFFGHHGHC?GGGDDDDEE	G	21	A	13
21	27852724	A	120	AaGggaGgaGGagggAGAaggGGGGGGgAGGAaaAaaGAGAggAggaaAAAGaAgaGGAAgAAggAagggaaGGAgggAAaaAAgggAaGAGgaagGaGGaaggagagaGggaaaaaaaa	@<ADECGCDFGDFF<<GFDFFGGGGDGFEFGFDC?CDGEGFFFFFFDDFFFGEFCDGFFFE<FEEEAE;GEEGGFAGGFFEEEEGGGEEFECGE=GFEFFDEGGEGEGEFGGC?@;>BBA	A	60	G	60
21	28210657	T	46	cctctCTtttcctctcTttTTcttccctCtctttccccTccccCtC	ADFEDDHEEEFFEFEFGEEGGFDEFFFE?DGEFFGGGGGGGHGCFC	C	24	T	22
21	28212760	G	173	AGAaaggAgaGGGaaaaGAAAgGgaGAGAgGAAGGAGGGaAAGAgaGgGgGaAGaGggAAgaagGGgaaGGGgagaGaAAgaGAagaAGggAAGggAGGaGGaGggaggaGaaggAGAGAAGagaGGgaGgGgaagggGaGAgGAggaaGggagAgaGGAAGGgGaGgGggag	C@D?C8@BCFAACFEDFCHEHCCCFCH@HCCHHCBH<CCFHHCHCFCCCBCCHCFCDCHHDFFCCBCGFCCCDF=G@GHHDGCGGDGH:ADEHCCDHCCGCCGCDCF@DGCGGDDHBHAGGBGDGBBDG8DBDGGDDDBGBGDBGDDEEBDDHDGDFBBGG?@@?A:<?AAAB	G	100	A	73
21	28216595	C	71	gGcgCcCCcCCGGGCCCGccGGGGCGCggcGcCcCGCGcGccCCcCgcggGGCgccggGCCGGcgCcCGCg	BACFEDGFDFGEEDFGGEDDEEDDGEFFFEAE<EGEFEDDEEEGEFGEBC=DDGEDGEDEEDDCEEAAAAC	C	39	G	32
21	28216674	G	116	GcggccccCGGCCgcGgGCGcCccGgCGCCCccCGGGGcCGGCcCGGgGGGGGCCCcgcggGGgCGGGgCgCGcgCccgCggCggcgcggcGcggcccGGCCggcggGggGccCgg	:DBCGHGDDCB?DFFCFCD@GDGGAFD@DDDBGDCC>CGDCCDHDCCGCCCCCADDAGHGGCBEDCCCGD9DCAGDGG9C@DDEGCG9GGFAHEG@HHBBCCEECGEBGF@D<=BB	G	63	C	53
21	30961131	C	63	ACCACAAACACCACACAACCACCCAAAAACCAAACCCCAAcaCcAACAACCaCAAAAccaCaC	=FGDGD;EAEGGCGEGEEAGAGGGEDDDDFFDDDFDFFDDGEFHDDFDDFEC<BDDDGDBB=A	A	33	C	30
21	32492670	G	51	GAGGAGGGGGgGAGGGGGGAGGAGGaAAAAAGAGGAGGGAAGAGGGAgGGG	7HCA@CCCB@@8HCBCCCBHCBHBBGHHGGGBGBBGBABGGBH?>>D<CC?	G	34	A	17
21	33765560	C	27	CCtCTccTCCCCTCCTTCCTTCctCcc	BDCDGEEGCCCCGCCFFCCFFCEFB>C	C	18	T	9
21	34793706	C	49	TCCTCTTCTTTCTCCTTCCTCTCTTTTTTCTCtTCCTCTTcTTTCtTTT	FFDFAFFFFFFFFGGFFGGFGFEFEEEEE6EEHEEFEEDEBEDBBBCCC	T	31	C	18
21	37410633	T	70	TcttCtcttccttcttctccccCTcttttcctctcctttCctcTccccCcctttttccTtcccctcttcc	BCBBAEGFEFEEEFDEEDFFFCGEFEEEEFFEFEFFEEEGFDGEGFGFGEGFFEFF8FEFC<GFFFFEGF	C	37	T	33
21	38865507	C	52	GGgcccgGgCggggggggggccggccggggcgccgcccggcggcccgccccg	ACEEFFFHFGFFFFFFFFFFFEFFFFFGGGGGGGGGGGGGGGFGGGGGGGGG	G	30	C	22
21	40190620	C	31	GGccccggcgggGccccgCggggggccCccg	FE?CDDE<DFEFGDDDDEGFFEFFFEEGEEE	G	16	C	15
21	41297873	G	100	GAGAAAAGGAAgGAGGAGaAGGAGAAAAGAAGGGAAAGGAGAGGAGGGgGGGGAGGgGAGGAAGAAaGGGGgGGgAGgGgAaAGAAAGGGggGaaaGggg	@?@EFFFDEEF=DFEEFDF<DEFD@ECE9EDEEDF?EDDE9ECDEDDDDDCDDEDDCDEDDEEDEEEDDDDDDDDEDDCDEG;CDDDCCB>;BB??CAAA	G	59	A	41
21	43133145	A	72	AggGAgaggaaaagGagAAggaaagaGaggaAAgagaAaaggAagagaagAgaGagggaaaaGAaagGgaaa	C>@@BFCEFDDDCFGDFFCFFDADFDG<FFDFFFDEEFDDFF:EGEGD6GFGEGEGGEEEEEFEECGFGEDB	A	41	G	31
21	43161805	G	243	GGgAggGGAGAGgaggagAGAAGAgGAGGAAaGaGaAaaAAAAAGAgAAaGGAGgaagGAAAGAGgAAGgAAGaGGaGgGAGagaAAGGaaAAaGgagGgaAAGaGGaGagGAgGGaaGaAGAAAaaaAAAAagGGGAaaGGGAGGGAgggAGgGAgaGAGggGggAgaaaaaaGGgGAGggAAGAGgggAAgggaGGaaGGGAaaaAgggagGaaGAAAgaAAaggAGAgaggAaaaAgGGa	@@A@B@>8B=EAFFCFFFGCBHCHFCHCCHHFCFBFGFFHHHHHCHFHHFBCDCFFFF:HHHCHCDHH>FHHCGCCGCGCH>FFFG5<CEEHGGBGGFB<GHHCGCCGCDGCAFCCE<C<HCGHAGGGGGGGFCCABGFFCBBFBBBEGGGGBGBGGFBGBGEBG8GGGGGBGDBBGBGBGBGGBGBFGEGGGGGGBB><@BBGGGGGGGGGGAGGBGFFAEHGEDCC>CB@<ACB??C@??B	A	122	G	121
21	43224683	A	67	AgGgAGaGaaGAAAGAGgGAGaaAGGggGGgGagGGAGAaggAgGggagAgAaaaGAggAAaaggAA	BDCDGCE5FFCHHHC@CFCFCGFHBAG8@CGBGGACHCDGGGGGBGGGGGGFGFGAGDGFFAECC8B	G	36	A	31
21	43231342	C	37	cccctcccttcttctttctctccTtcttcccccccct	?CBBFEDDDEDEEDEEECEDEDEGFDEFEEDEEEEA=	C	22	T	15
21	43267379	G	35	cccGgCGGccggggCcCGGcCgcgggGggggcGcg	C@8GBGGGBBCCCCBAGGGBGBADDDFDDEDCFA?	G	21	C	14
21	43325973	A	70	aaAgggAaagGGGGgggaaGaggagaaGAgaaggagagagaagGgaaaagagggggggggagggggaaag	?A?AA<A;CEFFGEEFECDBCFFDFDDGFDDDDFDFDFDFD;FGFCEEEGEGDG5GGGGD>GGGGGEC;>	G	41	A	29
21	43327117	C	53	TCCTTTCCCCTTCCTCtCTCCTtTCCCCCctTTCCCTCCTCTccTTcTCCCCC	?GFFEFGGGEDFGGG8HCGEFEHGDFEFFBHFEFFFFFFFFFC8FFCFGAGFA	C	32	T	21
21	43338175	C	30	cCTTCCTCCCTctTCTTCCTTTtCTtcCCC	AE8GGGEGGGE5HEFGEFCFFFHFDGBBAA	C	16	T	14
21	43496381	G	123	tggTGTtgggttgtgGttTtttttttGgtTgGTTgttttTgtTGtgggtggtttttttggggGgtggtgtttggtggtttttggggTggtgGgggttttttgtgggttttgtggttggtgttg	C?@@9>;7>ACD@BBAFBEGGGGFGGDCFFCEFFCGGGFFCGEEGCCCGCCGGGGGGGCCCCECGDDHCGHGCCGDDHHHHHD7DDFDDGDDCDDACHHHHDH?DDHHFHEHD8HEDCFDHG?	T	67	G	56
21	43504228	T	88	cTCTttTTCttTcTTtCTCTTCtctCcCtccTTcctcTTTCTctTTttTcTTCTTttTCCtCTtCTTTTcTCTcTTCttTttttCctc	=ECFCHAADGFHBGGGCGDGGDGBGDBDHBBEGBBGBGGFCGADGGCHACDFDGGHHFBCECGHCFF=FCFCFCFFCAGEFFEA@>E@	T	57	C	31
21	43531848	C	79	TtcccTcctttttttCcccccccTccctccTcctcctcccctttCttctttcccctctctcccctcctCtccctttttc	D?CCBACDCAFEDDD@FFFFFEFAFFFEFFAEFEFFEFFEFEEDDEEGFFFFFFFFFFGFECGFFGFBFFHFGFFFFFB	C	45	T	34
21	43696999	C	56	TCCCCCTtTCTTTTTTCTTTTTTTCCTTTtcCtCtCtTTCCttTtTCCtctCtTTC	@DDDCDGEGEHFGGGGDGFFGDGFDDGGGEFDFCECFFFCCDEFFFCCFGECEEFC	T	36	C	20
21	43803412	T	27	ttctccctccccctcctcTtcccttcc	A??DBBAG>BBAB>BAGCFHACCFH;>	C	17	T	10
21	43896143	C	130	ttccCTttttcTCtctctccCTttTCTtcTCTTcCTCcttccTTTTtCtCTTTCcCcCtcTttcCtTttttctcTCctTtTTtTTtccTtctctccttCcctCttCtCTTTCccCtCttTttctctttcc	ACA??ADFFGAGDGBGBGBBDG@GGDGGBGCGGBDGDBGG=BGHGGGDGDGGGDB=BDGCGHHBDGG:CGCCH;GDCHGHGFDGGGCCGHCHCHC9HFCCCHCHHBHCFFFCCBCFCGHFHHAEAGGB>>	T	76	C	54
21	44182135	C	67	GGCCGGCGCCGCGGCGCGGGCGcGGCCCCGGGcCGCCGGCGGGggCCCGCGGGCgGGGGCGGGGGGG	BCDDCCCCDDCDBBCCCBCBCBCCACCCCBABCCBCCBBCBABDDCCC>CBAB5CA>@?A=:AACAC	G	42	C	25
21	44283574	C	100	TcttCcCttcCccTctcctcTCcTcTttCtTCTcCTCcCtcTtccttTTCTcttccCCTTTCTtCTTttTCcCCCCTTcTCCttTtccCttCTTttTctT	=CEDADBEDDFDDEAEDDFD=EDCE>FDDF=@BEEFEEFFEEDDEEFF:FFEFFEEDFDDEFEEFEEFEEFCEFFDEEEEFFFFEF@EFDBDCB@9B@AC	T	53	C	47
21	44324365	G	31	AgaaGgAGGGaagaGaggggagggggggagg	BEDDEFFEEEDDFD@DFFFFEGGGGFGGEF?	G	21	A	10
21	44837551	G	133	AAAAGgAGaGAgaAGAGaGGAGAAAAAAGGaGAAAgAGGGGGAGgAGGGGAAgGGGagAGAgAAGGgaAGggAAGggAGgGGGGAGAGGagAaGaaAAGAaAaGGAaggaGGAAgaAAGGGaAagGAgGaagG	B<CAACGCFCHCFHCHCFACHCAHCHH7CCGCHHHDH6BCBCHBDHCC>C@HAC<;GDGCHDGGBBDGGBCDGDBDDEBD@BBBG<G@9GDGGBGGGGBGGGGBBGGDDGBBFFDGGCBAAFF5B>C<<;;=C	G	69	A	64
21	44837555	G	143	GgAGaGAgaAAGAGaGGAGAAGAAAAGGaGAAAgAGGGGAGgAGGGGAAgGGGagAGAgAAGGgaAGggAAGggAGgGGGGAGAGGagAaGaaAAGAaAaGGAagaGGAAgaAAGGGaAagGAgGaagGGgaaGGAGAGgaag	=A?DEAFEEFFEFEEAEBEEFAFFFEEEFDFFFEEDEEEFEGFDDDEFFGEEDF9FCDFBEDCGFEBGBEEDGFFDFDDDDEDE@DFGEFDCEEEDEFEADDEFFFDDEDFFEADDDAEBFCDEEDDFDA?@>A@B>BBBACC	G	76	A	67
21	45743594	C	41	CCTCTTTCTTCCCTTCTCTCTTTTCTcCTTTTCTTCCTTCC	D?GDGGGDGFCCCFFCF=FCCEFFCFBCFFFFBEFB:EGAC	T	23	C	18
21	45825975	G	61	aAGggaagaaaGaagaaaaaGgaagggaaagggaAgggaaaaagAaggaaaggagagagag	CDCCCFFCFFFBFFCFFFFFDBFFCDCFFFCCBGGDDDGGGFFCFGDDGGEDDGDGEGDCD	A	35	G	26
21	45826434	C	48	CCCTTTTCTTtTTCTCCTTTCTTtCttCTCcCCcTTccTCtCCCTCTt	@@GEEFE9EDHEEGEEGEECGEEHFHHFDFCFFCDDCCDFHFDFCDEE	T	26	C	22
21	46233863	G	76	CgCgccCGGgCCCCGGcGGCCCGGCCCCGCCgCCCCCGgCCgcCCCCCCGGGCCgGgcCCGcCGcGcGcgCcgggc	7@GBBBGGGCAGDGGGBCGGA;FGGGGEEDGDGCGGFFDFFDBFFFFFFFCFF>EFCCFFFCFEBF7EBBC<@@>=	C	46	G	30
21	46320403	C	28	ctccctttcctcttctttcctttCttcT	CC=AAGGGBBGBFGBHHE9CHHHEHHAD	T	16	C	12
21	46705345	G	59	AAAGGAAGGGAGGggaaAgGgAgGAAgAAGAgGGGAAGAaAaaAggAGAaAaGAAGAAg	CAEDDFFEEEFEECDDGF@EDDDEFF?D;CEDDDDAEDEGEGG;DDED=GEGCEEECB>	A	32	G	27
21	46705621	G	249	aaGgGGAGgGAgaggAAgagaaGAGggGggaGGGaagAaaAagGGGgagggggagaggGGagagagggGaaGgagaGaagggaaaGgaAgaggGaggagaggGGAgggAggGggGAaAGagGaAgGAAaaaAAGAGGggaGaGAAaggagAGAGagaaagGggGggGAGgGgGgagaGAgGGAGAgaGAGAGgaggagaaaaaGgggggaAggggaAagggGgGaggGagAAaGaAAgggAGgAGagag	CC<?>=B;A>BBDAADFCFDFECFCCBBCBFACCFFCHFFEFCC=CCFCCCCCFCFCCCCFCF>FCCCCFFCCFCFCFFCCCFFFC@FHC@CCCGC:FCFCCC@HDBDHCCCCCC?GGBGDCGHDCHHGGGEECHCCDDABGCHHGACFCHBHBGDGGG:CDDCCCCG<DCDCDFDB:HDCCGB?DGAFCG:9GDDGDFGGGGBEEDDE5GDDDDGGECDDBDBGDDBGCFGGAGGGBDCGBA<?B?<<	G	148	A	101
21	46924997	C	100	TTCCCCCCCCCTTTCCtTTTCtTCTccTttTTTcTCTtCtTctcTcCCCCtCTCTtttttTcCtttctcTcTTccTttcttcctcCCCTccCCcCTtCtt	DGDDDDDDDCDGHGBDEGGGDFGDGEEGFFFGGEGCGF@FGEF9GDDDDD?CFCGF9AABGECEEFEFDFEFFEEFEEAEEEBFECCCFEECCECFA<:>	T	52	C	48
21	47401760	C	31	CGcCGCgGCCCCCGcGCCcCgGGGccCcCGc	DCGDCDGCDDDCDBHBCCHDG?BBHHCHCBC	C	20	G	11
21	47409580	C	86	ACCcAcCACCCCAAccaCAAAAcCACCCCAAcAACCcAccCaAAcCaCAAaAcAAacAAAAACAACcCACACACcaaaaCAaACCa	>@DCHFBFDDDEHDGGGDHACHG5HCCDDH9GHHDDFGGGC@GGGCHCGGDGFG9GGGGGGGCGGCGCGCEBFBE?CCCADABAAD	A	45	C	41
21	47420723	G	118	ccCCgcgGcCCGgCGcCGGGgGcGCGcCgccgcCgCGCGcgGGCcCGgcgCcgcCCcgCgcgGgggcgGCcgggcGGgcGCcGcggccccccgggcggccgcgGcggCgccgggccgc	C?B>BBCCAEFECGDBFDDE?EBEGEBGC:BCBECFEFEBCEFF>EECBCECDBGGCDFD=DBDDDCDEF<DDDCDEDADFBD>DDCBC?CB8DDCDDCCDBDDCECEDCC?DDCCDB	C	59	G	59
21	47420726	C	113	cgcCgGGGCcGCgGCCCcCgCGgGcggcgGcGCGCgcCCGgGCcgcGgcgGGgcGcgcCcccgcCGgcccgCCcCGgCgccggggggccgccggcgcggccGcggcgcggcgc	C@>AA=DFDCFECG<FGBGCBECHBCCBCHBHGGGCB;FICIGBCBHCBCHHC<HBCCGCCCDCGHBCCCDGFCGHDGDCCDDDDDDCCDCCDGC<CDDCCGCCDCDBDDCD>	G	57	C	56
21	47423133	C	68	cgcCGGgcCgCcgggGCccggcGcgccgcgCGcgCgccgggcgcGgCcCggGcgCggcGcccggggcg	AA<EFFBBGCDBC=CGDBBCCBGBCBBCBDGBCDGDCCDDDBDCGDDCFDDF<DFDDC>CCADDDCA?	G	36	C	32
21	47537882	G	100	AaaaGggGAaaggGAGAGAaGGAGAaaGGGAgAAaAGaAAggAGagGAGAGGAgAAAggGAaAgAAGAaGAGaAgGaGGgaAaAGggAGaaAGaAgaGga	?CDC>BCCHEFCCC9CHCGFCCHCHFFCCCHCHHFHCFHHCCHCGDBGCFCCH?HHHCDCHFHDGGC>GBGBGGEBG9BDGGGGBDDFAFGH?BD<>CAC	A	54	G	46
21	47544769	A	77	GGggaGGGAGgggaaAaGaGAagggGAGGAAaaaGAAAGgGAAagAaaaaaAGggaaAagGaAgaGgaaaaGGgAga	@>;>FCCAGCCCCFFHFACCHFBCDBHCCHGEGDCHHHCDBFHGDGGGGGGGCCDGGGGEBGGDGADGGFC=9<@:B	A	41	G	36
21	47552209	G	149	GggGagGGAGAaaaaagaAaGgAGgaGgAGaaGaaaGGgaAGaaggGAGgagAGGAaGAgggaGAGAGgggagAAaaAaAGAAGGAAAAGgaggGAAGAAGaGAggaggagAGaAGAgaAGAagGGGGGGAagaaGGGgAAAAAAgAgA	@AC;D=@?D@EGGGEEB@HECCHCCFCCHCFFCFFFCCCFHCFFCCBECDGDEACHGCDD=DGC@CHBDCDGDHHGFHFACHGCCHHFH?DGDDCBHC;GBEBGDDGDDGEGBHG@GDGGBGGDB;BBBAGGDFFBBBAGFEGGGCE>C	A	75	G	74
21	47572804	C	52	CCCCCCCCCCCCCCCCCCCCCCCCCCCCCCCCCCCgCCCgggggcgcCCCCC	BCEFFFECGFFGFFGEGGEFFFFFGFEFDFFEEFEEFFE::??75:7CCAAA	C	45	G	7
21	47635713	G	109	aagagaGgagaGAGaAgGGaaGGAgGgGAggagGgagAgGagAAGAAAAaGGggGAagggagGgagGGaAagAagaAAgggGagAaaAagagggggaagagagaaggaa	CAAD@EDBFBEG5HFECHHFFFGECHCFCCCECHCFCECHFCEEHDEEDGHGCCHEGDDCGDADGBHBGEFDEFDGEEDDDGGDEGGDGDGDCDDDGGDEDGDGFDBF=	G	58	A	51
21	47971539	G	46	GGGAgaggAAAGgGAAAgAAggGAGagggaGaaAGAaaaGggAGag	<CCHFBFFGGGCF=GHGGHDCG@G?GGGGGAGFFBGFGGBGGG??D	G	24	A	22
22	17956759	C	88	GcCgccGGcccCgGGGccccCCggGgcCCCCggCcgcgGCCgggcccGgggCcgcccCGCCggCggggCccccccgggccccggcgcc	@C8CCCB?EDDBEACCDDDDDDFEBFDDDD@:FDEFDEC@DEDGEDACFGADECEEEDCDD7EDFFFFDED:EDEGGFFDECFEEEDB	C	50	G	38
22	18368548	G	87	gAGAAGAAAGAAAGAAGAGAGGAGAAAGAAGAAAaGGGAAGAGGGaGGAAaaAAgaGagaaGAAaAGGgAgaGGaAAgGGGAaaAAg	CFEBFEFCEEDFFCFFEFDFEEFDEEEEFDDEFFGDDDEEDEDDDGDDEEGGAEDGDFDGDDEEGEDADEDDDCGD7DCEDDCCA?B	A	51	G	36
22	18372020	A	62	AGgaagGagGgAGGgaAgaaaGagAAgGaggggaaAgagagagagagagagaagaaggaagg	B=DFFFCEFCFHCBFFHFFFFCFFHHFCFFFGFFFHGFGGGGGGEFAAG@FFGGGFGGFGGA	G	32	A	30
22	18978304	G	45	GGGAGGGAAGGAAGGaGAAGAGGGaAaAggagGAAGaggaGAggg	BEC>EEDFEDDFFEEGEEBDEDDDG9FEDDFDDECCEDB>CC>>?	G	26	A	19
22	18979405	A	34	AcACACaACACAACAAACCCaCACaCccacaAac	FDFGEE?FFFGFFFEEEFEFFFEEFCEDDEEEA@	A	18	C	16
22	19036232	A	38	AgggGgGagaagGgaaggaaaAaagggaaggaaagggg	EA7FCFCDFDDDCFDCFEDDDHDDFFGCEGGEEAGGGG	G	21	A	17
22	19504318	G	214	GGGAAAAGGGAGAGGAAGAGGAAGAAGAAGAAGAGGAAAAAAAGGAAGAAGgGAAAAGAAaGGGAgGAGAAGGGgagAGAGGAgaGAGaGGGAGAAggaagAAGGGaAAGaggaAGGgagggggGaaagaaggggggaaagAaaGAGGaaagGGAAgGAGgaGGGAGAAAGgaagaaGGGgaaGAGGgGGagAggAGagGaaaggagAGGgGAG	>?CHH:ACCCHCHCCDBCFCCHHCHHAHCCHECHCCHHHEGGGCCHHCGHCGCCHHHCHHCCCCHECGBHHCCBGEEHBHBC=FDBGBECBBGBGGGDEEGGGBBBEGGBD?EDHBBEDCFG@DBEEABDEEGGGFFB9EE;DDBGABEFEHBBGGGBGBGCB@@GBGGGBG>EGEEBBBFDEBGBBGB<E:@F@GCCD@BA==B:A@>>?AA?	G	113	A	101
22	19506456	G	35	GTgtTgtgTttgttgggggttggggtgtggtgtgt	=@CFFCGCFGGCGGC@CCCGGCDDDHDHACH>=DH	G	19	T	16
22	19506476	C	31	CcctcctttttccttttctcttctctccTcc	BDD@DEBBDDCGFDDDDGDG@CHCHEH;DHH	T	16	C	15
22	19885548	G	47	GGTTTGTTTTGgGGTTTGTTGTTTGTTtGGGTTGgTgTTTTTTgGtT	AEFFFEFE<FEGEEEEEDEED?EEDEEEDDDEEDFEGEEEEEDD;?C	T	29	G	18
22	19902671	C	82	CCtCttCTccTCTTCTCctTCCTCTccCTCTccCTtcccTCctctCcCcTCCCCcCCCTCctTcccCTcCTCTtCCCTtCtT	BEGDGGGFBBAG@GGGBAG?GFGGGBBGDFGCCGDGCCCGG?H?AGCG=GGGGGCGEFFDAGECCCFFBFFFFHFFDBDB?A	C	51	T	31
22	19969075	A	107	GAAGAAGGAGAGAgGGaAAaGAGGaAGaAAaGGgGAGAGAgAGggggAAGaAAAggAaaGaGGgaggagggAGgaGGAAGGAGAGaaaAggaggGgAAgagaAGgAa	<C<=FHCCHBECGFCCEHHECHCCECCFFHECBFCHCHAHFH@FFGGHHC7HHHGFGEFAFB>GFFEAC@FGB5FBBGGBBGBGBFFFHFGEG=AGGGGDEADACC>	G	55	A	52
22	20020889	T	67	tcccccCctttctttttccttccctcttcctcttctcttcctccccctcccccttcctTctctcttc	CCC??@CAGGGBCGGGGBBGGB9BG<GG@BGBGGB@=HGBCGCCCCCHBCC<CHHCCDF;DCHCHH@	C	37	T	30
22	20100409	C	72	CTtCCttCTcCCTcTTccTcctCTCCtTCCTCCCTCTCTTCctccTCTtttTTCCctcCCTTcTctcCtctT	?CADDDDDG;DEGGGCHGFGGDDGCDEFDDGDDDGDGDFGCHEH@FCFEECFFCCHEHBBFFHEGCGCAC?C	C	38	T	34
22	20100928	A	26	CaCCCACCaCCaaCCCCaaCaaCaAA	:F<8>5DDCD?EFB>;?EC;DF5ECC	C	14	A	12
22	20786182	T	81	CttCtttttCtttttTttCtttttttCCttttttCCCtCttCtttttTCtttttttttTtttttttttCTtttTtttTttT	AAC:AADFE:DDEEE<?E>EEEEEEEDDDEE?DF5CCF7BFDF5D@E=@FC@FFF@AD>FBEFBFEFD=?E9ADADD@?CB	T	68	C	13
22	20795757	C	32	CTCTTcTTCTTTCTTttTTtTTCCttCTTTcc	9ACGGBGHGGFDGFGHGFFHFFFFHHEGCA>>	T	22	C	10
22	20907303	T	62	CCTTCCTcCTTcTTCtCCTCTCTtTCttCTTTTTtCTTTTTtTCCCTCtTcCtTtTTcCccc	FGFDGGFBGDBCEFFHFGEGFGFHEFBHEEEDE;HDEEEEEHEEEEEFHECFCEHDEBF??>	T	36	C	26
22	21174798	T	44	CCTTTTTCTCtCCTtTTtTCTTtTcTcTTttcCcTttctttctt	?GEE>>AHAEFFGEFECFEFEEFDGDAECBEGFGDF@GFEDFBC	T	30	C	14
22	21213416	A	157	GGGAGGGGGAAAGGAaGGGAAGAGAAGAaGAGAAGGaAGAaGAagaAagAGggagggAGGaaGAgAgaggGAGGGAgGAgaagAgAAGaaaaAGAgAAAggGGGGAGggGaaagGgGGaagGGggaAgaaAgAggaAAgaGagaaaGggaAaaAAGa	B?A>EEGGGF@EGEEDGGGFFGCGEFFEDEEAEEGGEFGFBAE;GEFEGEFGE=GEDFFGEDGFGFGEDG>5GGGEGFEEEEGFEEEFECEEEFFGEEEG5FFF>EBFBFEE=GFGFFEFGEFGFDEGEEBAEGEEEEECFEE;EEFE=;A@=?B?B	G	80	A	77
22	21377071	C	59	cCtCTTTTTtTctCttttcCtTTctCcCctCCCttctccccccCcttccttttcCccct	C???BBABAACGDDCCDCG?DGGGDDGBGDDDDDBGDHHGFGHDGDEHHEEEEHCHGHE	C	31	T	28
22	21983853	G	150	GaaAaggGgggaagaaAagAaagagAaGgAgGAgAgagGGGgaGAagggGAagagagagaGaaggggGaAgaaaggAGaaaGgGgaGgaagGaAggaaaaggaaagaaGaAaAgaagaaagGgGAgGAaGGgGGAgaAAggggAaaAaga	BCCADFDCECAFEEFDBEFFFFFFFFFEFFFEFCEFEFEEEFFEGEBFFDDFFDFFFEFFEFFFFFFACAFEGFCBFEFEGEGEGEEGGGDDFEDFFE:GCGGC:FCGCG5GEGGEG9FHGDFDEGDEGD@GDDEGGEEGGGG=GEBDBB	A	76	G	74
22	21984135	C	39	cgGcggccccgGcggggggcggcccggCCggGccgcggg	@FCFFFF>FFFCFCFFCGFFGGFFGGFDDGGBFGGBADE	G	23	C	16
22	22040713	G	106	GGAAAAGaAAGAgGAGAAAAgGAAGaGAAAAGGAGAGGAGAGAgGAGGAGaGGGAAAGGAGAGGAGAGGGGGGAagggtagGaaGAGaaAgGgGAGgggGAAAAAg	BBHHH=CFGHCHDCHC;EHHG@:H>GCHHHHCCHCH5BGBFCGGBGBBGBGBBBGCGBBFBGBBGBGBBBBBBGGDGG5GFBFGBG?GGGGBGBGCEFF?DECC?D	G	55	A	50
22	22049369	G	44	ttgtgTtgggggggtgttggttgttttGttggtgtgtgtgtgTT	C?BC?BBDDFFEDAEFEDEEEEFEEEE<EEGFFGFGBFFHDFCC	T	23	G	21
22	22058000	C	36	CGGCCCCGGCGCCGGCcCcGCCGcgCCCCCcCCCGG	FFEGGGCEEGEFG;EC5GCDFFDC?EEFGF?BBB8?	C	24	G	12
22	22550510	T	132	ggTtGggTgTTGTTtTGGttGtTgTtggtgGTtTgTTtTTgtGgGtGtTTgggggGTTttTgGtTTGttggtttttGgGGtTgGtttGgTgtTGTTttGGTTTTTTgtttggtGTGgGGTGTtgtTTTTGtt	CC@EFE<EDBEHDFEEHHEEHECEEE@EEEEFBEEEEEDDFDGFHFGEEDGFFGCHEA9FEFHFEEHB6FGF5EEFGGHFEECCFE:GADCFDGDDFFGGDDCCDDFF5FFGBFC<FFGDFEDCBCBABA<=	T	77	G	55
22	23223070	G	67	gGagGgGaaggagaaAaggaaaaggaaagagagagaggggaggggGggagggAgggggaAGAaAgga	C>CB=CBFEDEEEEDADFFEAEEEGADDFEFEGEFEFFFGBFFEGCGGFFFEHFGDFEEFBGEF@E?	G	39	A	28
22	23223261	G	105	GggTGgGGgGTGTgTtTGGtttgtGTGTGGgGGtGGGGGgTtTGTggtTGGgGTtTGgTGGgTTGGGgGTTtTtTGtttGgTTGTTTGGgtgtgGTgGggtGtgg	;ABGCFCCFCGCGFGBGCCFEEDECGCGCCGCCFBCCCCGGEGCGGG?GCBGCGDFCGFBBGGFBBBB<FFGFFFBFFEBGFFBFFFBBGFFFGAFGAEB?<>?D	G	61	T	44
22	23616022	C	26	tccttttcCCcTTcccttctcCcctt	CBEFFDED@FDFFEEE@FEFEEEEEC	C	14	T	12
22	23631823	T	118	tttTtttTTtTctCTcttcCtttctCTcTcTtTccccCctcCTTttTTcTTccTccccctcctcTtctcCctcctcctctcctttttctttctctcttttccctcttcccctcccctt	CCB>CBCDCDDADGCEDEFGDEEFEGEFEFDEEEEFFGFEFFDEEEDBFEEFFEFFGFGFG:FFDFGFGGFFGGEGFFGE:FFEFFFFFDFGEGF?FFFFGGDFGEA=GGGFGEBF>=	T	63	C	55
22	23637200	T	32	CTTTCCCTTCCTCCtTTTCCTCTCCcTtTTtt	GFEEGAGDEEGDGFCD<DFFDFDEFCCDDACE	T	18	C	14
22	24087319	A	140	CcccAaAACCAcCaaCaCCAAcAACcCaACaaAcaCAaCcAacccacCACccACaCAcAcCacaCcaACaACAAAaCAaccaacacaaAcaaccaccccAACccCcCCacAcAaaCcCcacAaaccacCCccACcaaaac	AC?D@DDDGG8GGDDGDFDBFGEFFGGDFGDDFGCDGDFGFEGGGDFGFGHFFCDFFGFHEEHEFHEFEEFGFFFEEDDHGDDHB;=DEG=DGGCHFHH:EFHCEHFEEGEFEBEEHFH5GDEEGGEHEDFGC<C>>@@E	C	74	A	66
22	24199262	G	64	ttttttttTtttTtTTGTTgGGTTGGTGGGGggggggggggggggggggggggggggggggggg	CCCBCBCDDGGGEGF<DEECHHCEHGDHGHH@D?DBD9CDDCDCCCCDBCBCCDDDCDDCCACC	G	43	T	21
22	25144912	C	226	CTccCcccttcTcctCTTtctcccTccCCCTcTCtcccccTCcTcTcttcCCttTCCctcCcTcccTTcTTTCCtTCCCTCCctTctCCctccccTctctTtcTtCTCcttCCcTttcTcTTctCcttcCCCccTTTcCCCcctcCtccttctctccctccctttcttccCCttcttctcCCtttCctCccccTccttcctttcCTTtttcTTCTtctccctcccT	ADCC;AA?ABC=BCBAA=BGD<EFDEEGDGGFGGEFFEEFGGFGFGFEEFGGEEGGGFEFGAGCFFFGEG<FEGEGGGGGFGFEGFEGGFEFFFFGFEGFGFGGDGGGGFFGGFFEBDGGFFGFGG<FGGGDGFGGGGGGGGGFFEFGGF?GFFFGGGFGGGFFFFFEGGFFFFGFEDFGFFFFGFGFFGGGGEGFFFGBF=FGFFFEFFGFFEEFGFGEFEB@<C	C	130	T	96
22	25150694	C	29	CTCTTTTTCTCCCCCCTCCttTtCTcCTC	9EEEEEEEDEFFF@FFDFFEFDFFCEC>?	C	15	T	14
22	25202550	G	28	GgTggGggtGgTgtgtgtgtggtggtGt	ACFCCFDCHEDEDGDHDGDGDDHDDCC@	G	18	T	10
22	25297755	G	33	GggagGGaAGAAGGGGGGgGGaGggggGAAGga	HEFDFHEEDHEDHHHCHHDGGEGGGGGGDDGA?	G	24	A	9
22	29915144	C	60	ttctcTttTcCCcCctctcttctccttcctctccttcttcctccttccttctccctcctt	BB=BBEDECDGGDGDEDEDBED?DDEEDDEDEDD:EDFEDDDDEF7EEFEEFEEEFEEF@	C	31	T	29
22	30188611	T	30	tcTtttctccCtcCtccTcttCcccTtcct	C<BEHGBGBBGGBGGBBGCHHGCCCFHCCH	C	16	T	14
22	30700607	T	109	GTTtTTgGTTTggTGTTgggGGttgTTtggtgTGgttGggGTGttGtgGTttGgGGgGTtttgttGgGtTtTgTTttgTgtggtgtgTgtggttgggttggtttgggtG	BA:>?ACBCBBDGDEFEFFEDEDDFCFDFFD=FEF9DE?FDFEDCEDDEFBDEFEBFEFDDDGDDEG=DFEFGFBEEGFGDGDEGEGE8CGG@EGCEEEFEEEEFFFED	T	55	G	54
22	30730711	A	104	GggggAGAGAGgGAgaGAaaAagAAGAAAGAAaGgGAgGGaGaaaagAaagGagaaagaaAAagaaggGagggaaAggggaAggagaggGaGaAggaAGgaaag	@>BBCF<GAHCFCHFFCHFEHFFHHAHGHCHGFCFCHFCCFCEFFFFHGGG@GGGGFGGGHGGFFGFGCEGGGGEGFFGGGGGGGGGGGBHBGGGGEGBGGFFD	A	54	G	50
22	30765502	G	130	AgaGGaGAGgagGaggAAAagGAAGGGGaAGGggAgAGGAaAggggagGgagAaaaaAAGaggaggAgAgAaAgaaggaAGaAaggagaAgaagaaaaGaaaaaGagAGaggagaaaAAAaaaagaggaA	C@C@@FCFCBFCCFCCHGGFCCHHCCCCFGCBCCHCFCDICFCCCCFCCCFCHFGGFHHCGCDFCCGDGDHGHDGGDDGHC8HEDDBCFGDDFC?GGGBGGG=GBG9GBGDDGDGEGGGGFHGGDGDA>A	A	73	G	57
22	30767729	A	66	AAAGaAaAaAgaGggaaagAGgAAggGaagGgAagaGaaGAAggaagAgggAagaaGgagaaaaga	CAC>DDDFGGFECCFEEFFHC7HHFFDDFFCFHFFFCGGCG=GGGGGHGGGGB=GGBGGGGFEGGF	A	38	G	28
22	31333631	T	33	TCCCcTCCtTTTTTcTCTCCTCCTTTTTCTCCC	9GEGBCGG5GGF5FCFFDFFF8FEF=FDEDDB>	T	17	C	16
22	31336149	G	50	AAAaaaaAgAAaaggagAagAagGgaaagagaagggaagAagaaggaaaA	CBC5BDCFFFECDFFDFFCFFDF:CDEEGEGEEGGEEBGEEFEAGEB>E=	A	33	G	17
22	31346333	A	80	AaCaAaCaaCCaCCCaaCaaaaCCaaaaaaaaaACCCaaCCCCaCCaaaaaCCCCaCaCCaaaaCCaaaaaaaaaaAaAa	?>>B;D?ED@>B>7?E<AE@DF:9F;EDFFE=EC@DBDBD57DFCCED?6ECCC@F?BCCEFFECCEEFA>=>EA8D??A	A	52	C	28
22	31529043	C	103	AAAcCcCCCCCCaCCCcCacAAaaaccCaaAAACAcCccCaCaaCccACAccAACCCcCcACCccccaACcaccccaccaaaACAAaacccCCccaacccccA	AECFGFGGGGAGFFGFFGFFFEFFCF<@FFDEEGEFG=FGGEGGEGGCEEGGEEEEEFGGD=FGGGAGDFGAGGGEFFGGGFDFDDFFFGGFFFE8DDBA>BC	C	64	A	39
22	31679110	G	32	cCGGCcCGGGCGCGCGGgGCGGGGCGCcgGgG	?EEDEEFDAA>:FCEADG9FDADDFDAF;@;?	G	20	C	12
22	31843567	G	50	cGCgCCGGCCCCGGcgGgcCGCccggGCCgcgCggcgCGccGggCgGCCg	AGEBAGFGGGEGGGBDFCCAGGCCDDGEAC6?GDDCDFFCCCDDFCCBA<	C	25	G	25
22	31999846	G	67	CGCCGGCGCGccggggggGCGgCcgCCgccgcccGggCgGcggcGgcgcCGgGCgCggcccccCggG	@A??CGFGGHBBCCCCCC9GHCGBDFGDCCDCCBHDDGCHBDDCGD;D=FGDGFDF6DC;CCBFD=C	G	36	C	31
22	32017296	A	56	GGgGaAAAAAAgAAAGGgAAGGGaGAGGAGGAGaAAAAGAAAAGGGAGgAAGAAAG	=HCHFDE6CEEDBEDGGDDDHGGGGDGGDGFDGGBDDDGDBDDGFGCFCCBCBC@C	A	31	G	25
22	32229977	G	68	aaggggaGaaGggAAAaagAaggggaGGGaAgGaaggaagaaAAggAagggGgGaaggaGAgAgGgGa	CDEEEEEDDDEDFFFFDEEFEFFFFDEE?FFEEEFEAFFEEFEFGFFEEGFDFDFFFEFDEH9FDEB@	G	37	A	31
22	32796247	G	93	cCCgCcgGcgcCgcgCCcCCCcgcggCCcCcgcGGggGCGcggGgCcgGgCGGcCGgCCgcccGGggggcccccgcgCGgccccgcggcgggc	?@?9BDAEEDE@FEFGEFGGGFFFFFGGFGFFFHHFF?GHGFFHFGGGGGGHHGEHGGGGGGGHHGFGGGGGCGGF?FGGGGGGEGAGGGGGD	C	49	G	44
22	35463249	C	43	CtTccctttctCTttCCctctCtTCtCcTcTcctTCcTcCtcC	A?@BCDEEEDEDDEEDDDEDED?GDEDDGEGDE5FDEFECEEB	C	23	T	20
22	35478688	C	81	cctcttTttcCCCccCctcCctcccttcttcttCttcCtctcCcccccccttccctcctcctctttttCcccttcctcctc	6?>B??AABGCCDGFDGDGDGDGGFDDGDDGDDDDDGDDGD>DGHGEHHHDEHHCEGHDHHEHEEDDECHHHDEFHEHA9A	C	49	T	32
22	36587223	G	56	GGGGTGtGtttGgGTGtgGGgTttTgTtggtGgTgTtTggggggggTGggGGGGTG	CCADAHDHDDDHEHEHBDHGEDEEEFEFEF@HFEFDEDAGGGF;FFDGFGGGFEDD	G	36	T	20
22	36587486	A	251	AAAAAAaAAGGAAaAGAggAAAaagGAggGAGaGGAgAaGGAaGGGAggAaAGGAGaGaGaaGAgagGaAAAAGagGgAaAaaaGGAAAAAgggaAAAGgaaGGGAAAGgAAaGGaaAAAggGGgaGGgggagGAaaaGGgggggGgaGaGAAaGAgGAAAaaaAAgaaaaAAaaAAggAAGGggggagAAaGgaGAAggAagagaAAAgAaaggGAGgagAGGgaGgGAaAggagGAAGAGaAAAAAGAa	BCCCCDC=?BA@@FEEDCCEFEFFBGFCCGFBEGGFCFFFCEFGFGECCFFFGGGGFDFHFFGFCFCGFFFFFFFCGC>FFEGFCGFFFFFDDDFFEFGBGGGGGEEFG=FFGEGGGFEFDDGFDFGGDDDGCGFDGFGADDDDDFDFFGFFFGGEDFEBEGGGFEDGBGGEEGGBEDDEEFFDDDDHDE?GFDGFEEDDEEDBBGEEEDEEGDDFEFDGDDFFDGECFDGED>GCGFBCBC@BACC??CD	A	140	G	111
22	36597881	G	73	gggGggtttttgttTTTgggTttgGTtGttTtTTTgttggGtgtggtGTTtgGtgttTGTGGgttGTggGGGT	C>BBGF=DEDDFEEGGGFFFGEEFCHECEEGEGGGFEFGG@>GFGGFCGGFG?FGF@FBFBBGFFBCDGA@<C	T	39	G	34
22	36598058	T	95	TTCCCCCtCTCCTTtCCCCTtctctCcctcTtcTttccTtcTtttttCcttTCtCtctcctccccccTctCttcCCCttccctcctcttcttCcc	?BD;AFEDGEGFGGEGGGGGEFEFEGFEEFHEFGEEFFEEF@DEFEDFGEFGGFGFGFGGFGFEFGEGGFFEFGFFF?FGGGGGGFGFFFF@C?D	C	51	T	44
22	36651452	A	30	AAAAGaaaaGGaagAagaaagAAAaaAaaa	FDFFCEFFFEDEFF5GGFGGGE6EGGEBFA	A	24	G	6
22	36744898	C	89	CCAACCCcCCCAAAAAACAAACCCACACAaAACAACCCCCACCCCcCCCccAACcCCCAccACCCACAACAACCCAACCcaacaaacaC	DDHHDDDFDDDG;HGGGDHHHDDDH<HDHDHGDGHDDCDDGCCCCHCCCDHGGCHCCCGGHFCCCGCGGCGGCCCGGCCGEEGEEEGAB	C	52	A	37
22	37319425	G	124	ggTtggggTGggTgtgGttgtttttttgtttGGgtTGtgTggtTtggtggtGTtttGTggttTGttgttgTggTttgGtGtgtttGGGttggtGgGttgGggggtGggGTgggtggtTgggtgt	AAA@@@AACCBCFCGCDFGBGGGFGGGAGGGFECGFFGCFCCGFGCCGCCGEEGGGBFCCHHFEHHDHH=FDDFHHDDEEHDHHHDEDGH7@HEDDEHDDCDDDFD?DDEDDDFDDHDDBB>?@	G	65	T	59
22	37319947	C	93	GgccgGgccgCGGGGcGcggCCCCCCGGcccCCgGGCcCGcgCgcGgggCCcGggcggccCcccgcccccgcGgcCGgcgggcggCcgCccgg	@CCC>DDDCFFEEEED5DEFAGBGFGF8DD<FFEEEFDGEDFFFEEGEGEEEEGFEDGEDGDEEFEEEEEFEDCCCDEEFGFEGFFEGDDA:@	C	49	G	44
22	37699377	T	272	TcttcCTTTCtTTcTTTCCTCCTTTcCCTCtctcTCTcccttTCTTCCCCcCCttcTCcTCttCcCTttcTcttCttccCCTCCcTTCtcTTtCCCtTTTTCtctTCCCcTtCtcttTCTctcttttttcCTttcCcTCtcTttTcTCTcttttCtCtTccCtTtcTtcctTtctccctcttttCtctctCctcCCCtcCctcTCtctcTTcttttcctTTTccTtCCCCTTCcCcTCCCTctCTCTTccttCttccTTtctCtccttTCtC	AA@@=B>==ADAA@DCDDFDEFCDDAGGEGGAGAEEEBBBGGEGEEGGGFBGGGG<EGBEBGGGBGEGGBEBGGFGGBBGG<HGAEEGGBEEGGGGGEEEEGG:GEGEGCEHGGCHHAEE:GCHHHGEGBFDHHCFADFHCDHGECEGCCHHHGGHGHECBGDDHCEH=BBD?CGBCCECDHHHDGCHCHECDCFFFDCFCHCCFHC;CDDCHHGHCCFDDDCCDHFFFFDDFCFADFFFDCHFDFCDCBFHFFFCCDBGBCGC==<>@CAA	T	143	C	129
22	38043444	C	70	cccaaCccaCCcaAacCCCaaaaaccccAAAaaaAaCCACcccacaAaAAacAAAacAcacaaaaacaac	AACBEDCDEDDDEHEDDDBEEEEEDDDDH9HEDEHEDD;DDEEF?EHFBHFEHGGFEG@FDBECBDEECB	A	40	C	30
22	39146329	C	116	ttCtccctCtctTttcCcCcTTCtTtccCCCTttcttTctTTttTTCTtCCcccTCTCTTTCCtCTCTCTTTcTTtCTtTCctTCttTctcttttcTccctttCTcTTcTtTtcct	B@FGBBBGGCBGFGGBBB?=B5GF<GBAGEFFGGCHHDCHEFDHEFGFHGFBCAFGFGDFFFEHGFFEGEEECFDHFEGAECGEFHHECHCCHHHCEC?CFEHEEBEDBFGDC>>C	T	68	C	48
22	39148483	G	52	AGAAGAaAGAGAAAGGgGAGgaAGGGGAAaGGGGGAgaGaaggaGGgAAAGg	?EDDG@FFGEGFFFBGDFEFD=EFFEFEEGFFFFFEDGFGGDDGED>?BC?A	G	28	A	24
22	39639853	G	125	GgGTgtTTTGtTGGTTGtTGTTTTTGTTGTTGTGGTTTGGTGttTTGGTGTttgTtgGGTTTTGTGtGgtTTGGGTGGTGTGggGGtGTGTTgttGTGTtttTTgTGtGGgGtgGGGtggTTGgg	?AEFCGFEE<EEEEFFEHFE=FFFFECFDFFDBEEFFDDD;EHHFFDEFEFCHDFHDEEFEFDCFDHDDHEDDDDEDDE9EDDDDDGDDDE5DGHBEDE<G=DEDEDEDD@CC?==A>DDBCB::	T	66	G	59
22	40814636	C	63	TtTTTCCCTTCCCtCtTtTtcttcttCttctCCtCCtCcCctctcCctcccccctctctcccc	FFGGGDDDFGDBCGD>GGGGBHGCGGDEGBGDCHDCGDADBCBHCC:HCC>CC?HCHCH=CC<	C	35	T	28
22	41170063	T	71	tcttTtTtCTTttcCCccctCcctcCcTtTtttttcttCcccctccCTtttcctccttctcctcTccccct	CCAB@BBECDFEEFFEFFFDGFFEFGFFEFEEEEDEEEFFFFFEEFEFFFFGGFFFFFFFGGFGFGFGCGE	C	36	T	35
22	41566595	C	55	ttctttcttctccttcTcccccttccttccttcccctcctcctcctttttctctc	CBCDEEDEEDEDDEEDFDDDDDEEDDEDEDFEEEEEFEEFBBCEEFFFFFEEA:@	C	28	T	27
22	41650190	C	55	ACAACAACCCACCACACCCAACAAACCCCACAAAcCCACCaAACCcCCCCCAAAA	EGEEGE?GFFDFAEGEEGGDEGE>B9EDDBEDD8FF@DDFECDFCACCACBCAA?	C	30	A	25
22	41657626	C	29	ttctcctccttccctttcctcccttCtcc	CBCDDDEDDEEDDDEEEDEEBEEFFD>D?	C	16	T	13
22	41744022	C	28	GCGCCGGGCCggCGGGCCGCCGgCCGGg	BDCDDC@BDCGGDBBBCCBCCBFBBB?:	G	16	C	12
22	42076381	C	58	CCaacAaacACACaccCcacCAaCCcCacCacaAccCCcaccacaaCCcccccaccCa	B6AACADDGFBFGDGGDGDGG@DGGGGEGGDGD<HHGGGEHHAEEEFFHGHFHEGHB@	C	37	A	21
22	42301712	T	82	cCCCttctCctccTttccttcttcccccccCTttttttcctttcctccCcCCcttttctcccctccCTttttccttctttcc	?8>?ABBBACFECGCEDD9E9?EDDDDDDDDEEEEED=DCDEEDDEDD9CDDDDFF=EFEED<997DGBFF:DEFEDFFE<=	C	44	T	38
22	42783130	G	54	GTTgtttgttttGGgGGgTtttGggtTtgtggGgGtgGgttgtggtgtggtTtG	B>ACFDEEDEDEEDFEEFFEEEEFFEFFGDFFEFEFGEGEFFFGBEFEAFDBA@	G	28	T	26
22	43558972	G	119	GgGAGGAgagGGGgGGGGGGGgGgAGaGAagggAGggAgGAgAAgaaggaAAgagAAgaaAGAGAAAGAaaAgGaAGaAAgAAggggAAAAGgGGgaGGggaagaaaGaggaGaagaag	8AB7CCHFFFCCACCB=ACCCFCFGDE;HFFF;GCFFHG@HGGHGGEG6GHGGGGHHGGEFCHCHH;CGFGDGCFHCCGHGGGG:GGGBGBBC@BGGBBGGGGG=GGAF@@EACDCBDD	G	65	A	54
22	43559137	G	37	TtGgTgGttTgttgTtTtgtgttgtttttgttgtgtg	BCCACCHG=ECGGCD8EGCGCHFDHHHHHBHH8FBG;	T	24	G	13
22	44277406	C	45	ccTCttCTTTTCTTTCCCTCtTCCCTCTcTttCTTTCtTTCTcCc	BCGBEEDGCGGDFGGDCDFDFFC@CFCEEFFBCFFFCEFFBF?AB	T	25	C	20
22	44324558	C	29	CTTTTTTTTCTCCTTTCTTCCTTTCCCCc	DGFGGDGFGDGCCFFFCFFCCFFFCB@?@	T	17	C	12
22	44324727	C	89	gggGGgcgGggCccgCgcgCCcCCCCgcCgggccCgcccCgCgcGGCcgcccCgcGGgGgccccccggCCgcgGgCccCcgcgccgcCc	@FFHHFDFHEFGADFGFDFFGDDGGGGDCFFFDDADEEEGFDF8?HEEGEEEGGCHHFHFEEDDEEFGFFGEFGGFFFFEF<FEDFD<@	C	51	G	38
22	44324730	C	90	ttTTtctTttCcctCtctCCcCCCCtcCtttccTCtcccCtCtcTTCctcccCtcTTtTtccccccttCCtctTtCccCctctctcCctc	BEGGEEEFEE@FFCDEFEDDFDDEEEF>EEFFFFDEFFEDFDFFDGDGFEGFDFDGGFGEGGGGDGFFDCDGFFFCGGCHFGFFFE?DBD	C	51	T	39
22	44368039	T	48	CTTCTTTCCCCtccTtCcttCTccTCcTCCCttCcTCCcTTtTtTTTc	AEEEEEEGG?GEGFEFGGE@GEGGDEGDFGFFFFGDFFEDDFDFCDA<	C	24	T	24
22	44368741	C	32	TTTCTCTtCCCcCCcCtcCccCtcTcCCTctT	EEFGE=EFGEDEEFEGFCFD?FDDDAB9B:<C	C	20	T	12
22	45723696	G	44	GCGGGGGGGCGCGGGGGCCGGGCGGGCCGCGCCGCGCCGcgCgG	HGHHHCHHHFGGGGGGGFFGFGFGGFFFGDGFDFEFEFB><C>?	G	28	C	16
22	45723842	G	152	AaAAaGGaGggaGagaAGgagGAAagGGgaAgaGGaAaAaGAaGGGGgGaAggggagGGGaGGGGgaGGGAGGgAaAAAgAaaAgAggaagAgggagggaGagGgggagGGAGGagaGagagAgGgagggggGGggAgaaggaagggggaaG	AD=:EDCFCBBEEFCFFECFCDFF@CEECFFCFEEFEEBCEFFEEEECEF@C@CCCCEDEGEED@CGEEEEEEDEGEEECE@EEDEDDGDDFDCCF@D?GEGDADDDGDDEEDEG?GDGDFEEED@GDDDDDCDDDECGG:DDGBC?>?@B5	G	91	A	61
22	45755666	C	327	CTTCTCCCTCTCTcTCTcCttTTCTCtTTTCTCTTCTCCccTtTTCCCCTCCTTTTcTCCctTtCTTCtcttCCTCTTcCTCTCTcCTCCctCTtCTTTttCCCCTCTctctTTttCCTTCTtcCCTCCCCCCcCTCTtCCttCcCCCCcTTCCCCTCCCTcCTCCcCtCCcTCTCCCtcCcctcTCTCCCcCTCCtTTCTCTTctTTCttCTTCCCttcTCtttTccccTTTttCtCTtcTCCCctcCTTTcCTTCtctTTTtccCTCctCCCccCTTCCTTCcttTCtCCCTTtTTTCCCttcTcTCttTctcTcTCTtcTCTCt	BAEEEEGGEGB<GGGGGGGDDGG?GGDEFGGFGGGGGFHFGG:GCGGG>GGGGGGFGGGGGBGDGGFGDHCCCGFGGDGFGGGCFHGGEGGADGEFGFGEEGGFGFFGH?FEGGEEGGGGGGEHGGGGGGGCGHGGGGDGGEDGHGGGDHGFGGEGFFGFGC=GFFHFEGGEFFFFFFEHGHHEHFFFFFFHFFCFEEFFFFE<GBGEFEEFFFFFFEEHFFEECFHHCHBFFE=FEFFEHFFFFHEHFFFFHFFFFEHEFFFEHHFFFHEFFFHGFFFFFFFFHEEEF>EECFEEFDEFFCBDHG?DCA6CC?BC<?>A:BCACCB	C	170	T	157
22	46114244	C	56	TCcCCCCCTTCCTCTCTTTTTCTTTCCTTCCTTCCTCCCCTCcTCCtCcCcCctCC	BGFEFFFGEEEGEGDGEDEEEFDDDFFDDGFDDFFDFFDFDCFDFFFEGFFEBE>B	C	34	T	22
22	46643964	T	26	TCTTCTTtTCCCTTTCTTCCCCcTTT	=G=?=FCFDEEEEEEEE7EED@@CC?	T	15	C	11
22	46658978	T	31	ttTcTctctCCCTcCctCtttcCCttctccc	?;@BEBGBGGGDFCGBHFHFHCFFDHCFA>@	C	17	T	14
22	46665006	A	60	AGGAAGgAAGGGAaAAAgagaaAaAAaGAAAggGaagAGGagAGGGAagGagaGAAagga	@DGCEHFE<HHHEEEBEGEFEBE<D?EGEDDGGGBEGDGGEGDGGGDEGFEGCFEAA?B=	A	34	G	26
22	46722531	C	120	CttcctctccCCTtCtTTTTCtcCctCtCcttccCCcttTCcCTcTtctcccCcctccCttctTtttttTttccCttCtcCtcTtctcccctcCCcttctttTccttttTcctcTTtctt	ACAC@?>?BA?>ACBEFFCDDDDDDEDDDDEEDDDDDEEFDDDGDGEEEDDDDDDDDDDEFEDGFEEEFGEEEDDDEDFEC@CFFEFEEEEDECCEEFDFFFFEEFFFEFEEF>FFFED@	T	61	C	59
22	46780385	C	46	TCTTTCCCCCCCTTTTCTCTTtTCTTccTtTCCctCCCcTCTcCCc	@ADGFDDDDDDDHGAGCFDGGEGDGFEAFFFCCEFCCCEECEECA@	C	25	T	21
22	46782249	A	37	AAAGAAGAAAGAgaGaAAAGAAaGAAagggAGgAGaa	==HC=H@HHGCHGEBFGGGBGGFBGGFEEAGBFF:BB	A	24	G	13
22	46790029	G	50	GTTGTGTGTTGGTTTGTTTTGTTGGGGtTGGTtTGttTTTTggGTTTtTg	AG=CGCGCFGCCG6DBGFEFBAFB@<BHFBBFHFBHHFFFFA9>DBA@CA	T	31	G	19
22	46931077	G	100	GgCCGcGCGcGgcGCCCGGCccgCCCCGgGcGcCCcGCcccCGcgcgcgGGgcggGGcGcGgGCcGcCGCgCGCgcCgGGcGGGGCcgGgGGcgGGCGCG	@B@DCFBDCDCFBCDDDCADGGEDDDDCFBGCGDDHBAHHHDCHGGGHGCBG@GGAC;BHBGB?HBH@BCGCBCGHCGBBFB?AABHF?C>@A===C??C	G	53	C	47
22	47095409	C	42	CcgcccgcgccggcCgccggccggccgccggcgcgcgcccgc	ACC@AABBCBBCCBDCBBCCBBCDBCDCCDDCC?DC>CACCC	C	25	G	17
22	47857576	A	110	GGAAAaAAGGAGGAGGAGAAAAgAGGaaAaGgagaGaGGgAAAagAggaaggaaaagaGGaagGagaagAggaggggaggaaagagagaagaaaaaaGaaaggaaaaaaa	DE@ABDEEGGFGGFGGFGFFFFFFGGDDFDGFDFDFEGFGFBFEGEGGEEGGAEEEGEGGEEGGDGEBGEGGEGEGGEGGDEEGEGEDEEGEC9DEEFEEFGBED;EE<7	A	64	G	46
22	49668137	T	32	tgGtgggGtttTGGTGGtGgtgggttggggtg	AADGCBBHGGGEHHEHHGGCHDDDHHDDDBF=	G	20	T	12
22	50298118	C	172	cCCttTTCttttTTCCTcTtCTccCTtttTCcTCCTccTCttctttcCcccCTtctCcCcCtcttctTCcTcCTtCTTtcctttTCCTTCCcttCccTttTTtttCccccCTTctCttCtcttTcccTTctttcCCcctCttttTTTTtTCctctCttCTtCtcTTttttct	C<<;CCF@GGFFEGDDGAFFDGBBDGGGGG9BGDDFBBGDGFBGGGBDBBBDGGBGDBDBDGBGGBGGDBGBDGHCGGGCBGHGGDDG:DDC@GDCCGHHGG;HHDCCC@DGFCE8CHCHCHFFCCCFFCHH9>CCCBF?HHEHEFFFHFCCHCGCHHCFHCG?FGEDDC<@	T	96	C	76
22	50435480	A	65	GGGggGAgAGAAGGAAAGAAGgGaAgGGGGAAAGGGGAGGAGAgAAgAAagaaGgaGAaaaAAgA	@@GCCFFCFGFFGGE@FGEFGCGGECGGGGFFEFFFEDFFEFECEEAEE?DDGFDHFDDD<EC?A	G	33	A	32
22	50439194	C	39	cTTcTTCCCTtcCtcTcctctTCctCcttTCtttctccc	?EGDGGCCCGFECFEGEDFE<FDDFDEFDFCFDDD9?><	C	20	T	19
22	50468907	C	29	GTTTTGTGTTGTTTTTtTGGggTGtTGGg	CGEGG=GCFFBFFF>FFFBBGGF@?C:C<	T	17	G	12
22	50656428	G	97	aagagaagagggGGGgggaagAGgagaggagAgaaaAggggAgaagaggGAaGAagaGGaaaggGgAggaAgAgAggaAaggggAagAAAGAGGAaa	CAA?BCCABA=BA?AEFEEEFHCFEEDEFEEHFEDEGFFFEHEEEFEAFCCECHFF>=CFFFGFCEGGGFG@GFGFFBGEFFFFGFGFFFBHBCC@>	G	51	A	46
22	50694013	A	81	aaaaaCaCaaAaACaaaCAAAaACaaACaAAAaaaAACCaaaaaaaaaaaaaaaaaaaaaaaaaaaaaaCaCaaAaaaAAa	A>BCD:E:BB:EH:BEDDBCCDGDEE=9FFHCFBF:C@6FF;FEEFFFFEEEBFFFEFFFFFFDFG<FF;F?F;?F?<@@B	A	71	C	10
22	50695500	G	156	GgaGagAgAGGAaGAagAAAggAGGaGAaGGAAAAagGGAAAAAAgAGAAggagAgaaaGaagaGAAaAgaGAAagaggaGaGAGGaaaaAAAagggAGgaGAGAAaAAagAggaAGAGGGGgaGaAaAAaAgGAGaGGAaAgaGgaaGAGaggGa	?CC5A@>CGA;HF?HFCGA;CCGBCFCHFAC<GGHGCCCCB5EGGCHBHGDDGDHDGGGCAGDGCDHGCDECHFGDG;BGCG=HCCG?GGGHGGDDDGBDGBGBGGGGGGDG@DGGBGBBB9DGBGGBGGGGD<GBFBBCGFC?ABGF@@?B=;>5	A	89	G	67
22	50705059	A	227	GAAGaGAAgaAGAAaAAGgggaaaGAGgAaAAAGaGagagaaAGAAgAaagGGGAaaggAgggGGagGGGaAaaGGGGGgGAaaGgaGgAaGaGAGgaAGGGaGGgAAaaAAaAAagGAGGGGaGggAGAGAGAgGggAGaGaGAaaaGAAGGggAggGagggAagaaaagGgggaaaAGgAggagggagaaaAgaaAAGagggaaAaggGGagGaAagAGAaGAgA	>A>=C>?>CCBBBBCDFADFEEDDDFEFFEFFFEEEEFEDEEFBF<EFEEEEEEFEEDFFFEEFFEDE;EE@AEEEEEEFBFEEEEEEFFFDAEFEFF@EDDFBEGEEFFFFFBFFFE@DEEDEDGFFDF9FDFFEFFFEFDFE6EEFDEEDDGFEEFDFFFDDFBFFFF9DGGFFFFEDEEGFDDFGEGEFBEGCFEEDEFBFCFEF:FCDDFDDFDBBCBABA;C	A	114	G	113
22	50708594	C	28	CcCTTCTTCCTCCTCCtccCCCCCcTCt	CDEFFGEEDCEFFEFEDEEEEEFEDBB@	C	19	T	9
22	50714289	T	67	cccctTTtcTTTTCctTTTctTTCCCCTtttttCTtttCTttttcTtcCTTTtTCTcCCTcTctcCt	5>??GGGGBGGGGDBBGFGBGHHDDDDGCHHHHDGBHFDG=GHHCFHCCFFFHFCFCCCFCEBG@@A	T	42	C	25
22	50719976	C	191	TTctCcCCTtCtcccCctcCtcCTtTctCTTCTTTCCCCCCCCcTcTtttCTcTTcCCCtTcCTTTCTCcccTTtTTcTCcccTtttcTctcTtctTcCCcTttcttCctttccCTcccttttcctTCCtcccTcTTccctcTCctcTTtCTCTTcttTTttctTCCcCCctcttcCTttTtCTCtttcct	A>>C?@=D?BCEBCDFCECFEDEFEFDEGFFFAFEFFGGFBGGDDDFEEEGFDFFDBFFEFDGEEF@FFDDDEEFFFDFDEEEDFFFEFEFCF@EFFE>GEEFEE<EGEFFEEEAEEE8DFFFEEFDFEFEDEEAEEEEEFEEEEFDE5EFEEEEEFFEEFEEFADEDFEEFEFDEEEFEEFEDEFFFEDE	T	96	C	95
22	50724733	G	64	GttGgttgggTggtTTtggtttTtttgTgtgtTttgTgttgttttGgtgggtggggtttttgtt	?DEBCEED@BFCCGFFGCCGGGFGGGCGCGCGFHGCBDHGBEHH@EDHDDDGCDDDHCHHHDBG	T	38	G	26
22	50751529	G	69	cGGgccCcGCcGGccgCcgGCCGcCgCGCCcCgcGgCGgcgGGGGCGCGggGGggCggCCgCGcgCcGc	A=DBABGBEFBAEBBCFB=E9FECGDGEFFCFDBEDGEC?DAEEEFAFDDDDDDEFDDDFDFD@DC6>@	G	36	C	33
22	50757541	T	52	ctcccttCctcctctcttctCccctCtccctTtctctttcctctctttttct	<B>@CFGFBGBBGBG;GGBGGBBBGFGBBBGFG5HCHHHCCHBHBHHCHH@@	C	26	T	26
22	50885705	A	108	GgaGgAaGAGAagGaaAgaAGAAAAAGGgAgaGAAAagagGAAAAGGGAGGaGgGGgAAGaGGAAAGAgaAgaGaaAGGgGaAGgAGgagAGGAaAAggGaGAGAGAg	@ADAFGECHCHEECEEHEE9AHGHHHC7FFGDCHHHFFFF:HGFHACCH>CFCFC?GHGBECCHEGBGFFCCFAFEGBBFBBEBFBBFBDGBBGFEFFF>E@F@C?@@	A	55	G	53
22	50925997	C	45	cacCCaacaccaccccCcAaAaCCCCaCACAACCCCCACACACAC	EEDGGEE<FDDEDD>EGDFFFEFFFFFFEF>D?FF8FDFEFEFDF	C	28	A	17
22	50942121	C	29	CtcTccCccCTCCCCCTTCTTCTtCCcTT	BDFEFFFFFG@EGGGEDEDDBFD:EE<@C	C	18	T	11
22	50960101	G	153	gGAgGGGaAAGgaAaGagAAAGgGAagAAAaaGGgGagaaGGGAAGaaGAAGggGGgAAGGAAGgAAAAAGGGAGGGGAAgaaGAaaGAAaaGggGaagAGGaagAagaAGGaaaGgggAAGAGAggAGaGgGGgAAAaaaGaAAgGAGAAGg	ACDCFGAFEEHCFEFGECDECHCHEFCEEEFFHHCGG@GFCHAEEHGEHBEHCDHHDCEHFCEGCEECEEDGHEHHHHBDDGG?EGGGDDGGFDDGGFDDGGFHDDGDHDGFGGGGDCDDDG>GDDCDGDFDFEDCADEEGFE@B?D:?@?CA	A	78	G	75
22	50961786	C	102	TTtTttcCCTTCTTcTTtctcctCtCttttTtctTCTtcccCtTcttcctctcTCcccCttCtttCcttCcctttttctcttcccttcctTcctctctttcT	??>BFEGDDEGDGFEGGEFECFEDDDE=EDFEFEGDGEFFFDEGFEEFBDGFFGDDFFDFEDFFEDFEEDFGEFFF?GEGEFFD?FFCGFFCFFFEGEEE@C	T	58	C	44
22	51042006	C	171	CCCGCgggCGGCcGGGCCGGGCGgCCCCgCGcGcCgggCCGgGGgGGCGGCCgCCgGGCCGcGCgGcGCcGGGCcGGgCGCgGGgGCgCGGgGggGCCcCcccCCCgcGGggcGCCCCggCcgGGCGgcCggGggCCccCcGGGCgCgcCGGCccCCgccCCgggccCGcc	A?>=>BFEBCCCCCCCDCCCCDCEDDDDFDDDCDDFEEDDCGCCECCDCCCDFDDFCCDABE@DGCECDDCCBBEC=FDCDFBCGB=FCB8GBGFBCCDCEEECCC>E=BHGABCCCCGFCEGBBCBEDCGFBGFCCEECEBBBCFCFDC?ACEEBBEEDCDEAE@@?ABB	G	88	C	83
22	51044243	C	101	CccttcTTcTTctCtcCcttCcctttCTctctCcTTTTTctcCCcTcCCTccTcCCctcCCccCccccctTcttcTtCttTtTCctcctTttccctTTcct	A<AACC?>?DEBGBGBDBGEDBBGGGDGBGBGEAG=GGGBGBDD@GBDDFABGCDDB>CDDBCDCBC6CHGCHGCFHCHHCHFCCHCCHFHHCAAFDB<@E	C	55	T	46
22	51049088	G	78	CGGCGCGCCCCGCCGCGGCCGCcCgggGCCGcCgcgGGcgGccGGgCCCGGccCgGcCGCcGCGCGcGcgGGcgcCcC	BB?FEFCGFGFEGDEEECFGEBF7FGGEEGEGGDFGEEGDEFGDDGEFFDDCGEEDGEDFFDFDEDGCFGCDFFE>AC	C	42	G	36
22	51065361	C	147	cCAccCaaaAaaccaAcacaaaacaAcccaaaaAaccCcaACACaacccCCAaCaccCaCaaCAccaAcAACacCAcAAcaaCacCAACacaaaAaCcaCaCcacaCCcAacaccCCAAcacAcccaaaaccccACAcacAAAACCc	AAACDFDDDEEEDDEFDEDEEEE>DFDDDEEEEFEDDGDEFBFHBEDDDGGFE=FDDGEEEEFFC;FFEEFFFEAEEFFEFFGEE?FFFFDFFEFEFEEFFFEF@FFEDEFEFEFFECEEFEEEEDEFEAEBDEDEDDDEECCBB@@	A	75	C	72
