1	1247494	T	48	TCCTTTcctcTTTTCTcTTtcttCccctcCTttTTcTTCctTCTctTT	B@DFEFBBGBGGGGDGBGCGB<GDBCCHCDFHHGGBFGCCGFBFCHGC	T	29	C	19	20	7	9	12	0.03941
1	1335790	A	44	ggaaagaagaaagagggaaaaaaaGGggaggggaaGGgAGaaGG	CCEEDECDEDDDF<FFFDDDDDDCFHGFEGGGGE<DH;DFEEFB	A	22	G	22	1	7	21	15	0.04595
1	1560856	T	40	ttttCttCTCtTCCtCTtCtttttttTTtTTTtTTTTtTT	AAEE:EE8?:ED@8D=>??DFFBE=EFF9FEEAECDE>AC	T	33	C	7	14	7	19	0	0.00894
1	1581759	G	225	GGGGGGGGGGGGGgGGGAAGGGGGAGGGgGGGAGGGGGAGGAGGGGGGGAAGGGGGGGgGAAAggGAGGAgAAGGGGGAGgAGGAGGGAAAGgAGGGGggAGAGGGGAggAgAGGGAAGAAAgAAggGGAaGggAAggGAGGGggGGAgAAGGgggAAGAGAAGgGggGGGAAGGgGAGAgAgGAAGGgGAGAGAgGGAAgGGggAGggggggAGAAGGGAGGaa	?=>BB=@CACCABFCCCFICABCCH@BCFBCCHCB@CCHBCECCCCBC@GGCCCCCCCECHDHGG;HCCHGHHCCCCCHCDHCCHCCCEGHC7GCCBBFG?BGBCBBGGGGGHBBBGG@EGGDGGGGB?GGAEHGGFFBGB@BEGB<GGGGBBFDFGGBGBFGBGBGGBBAGGBBGBGBGGGG@GGBBGBGBEBGBAAFFGBAFFDAAAABB@AA??????C?DB	G	159	A	66	116	63	43	3	0.00005
1	1582455	G	30	aGaGgGGgGaGagaGgGGGaGgAggGGGGG	FCFAF?CF=GCGGGC?BC:E:GGGEB<:=C	G	23	A	7	16	1	7	6	0.02473
1	1582961	G	143	GCCCCGGCCgCGCGGCCCCGcGCCGgGgCGGGCGCGCcGGCgCGCGCCCCGgGggCGcgcCcCggccgCCgggggGccgcgccCCcgCCgCgccgccCgCcGgccCGcCGggGgcgGcgCcCccgcCCgcggcGCCCCggggc	D=D?AB?8@@FF;GGGGGGGBFGGGCGCGGGGHGGGGBGGGCGGGGAEGFGCGDCGGCDCGCGDDCCDAGDDDDDGBCDCDCBGGCDFFDGDBCDCCFDFCFDCCFF>FFE<FDCDFCDFCFCADCF@D@DDCAEFFC@<<A@	C	77	G	66	47	29	30	37	0.04546
1	1583003	C	118	CTctcCcCttcctCCtttttTcctctccCCctCCtCtcctccCtCcTtccCTcCTttTtctTctCcCcccCtccttcTCCCCtttctccttcCtccttcccccCtccttcCtCtcccc	DBC?>BABCDCCEEGDDEEEEDDEDCDDGGDDEGEGEDDEDCGDGDEEDDGEEGDEEEFEFEEFGDGEEEFFEDDFE?GGEGFFFEFDEEFEEFEEFFEEEEEFFEE6FEFFFFECED	C	71	T	47	25	8	46	39	0.03705
1	1583495	T	82	CTtTccctcTTTTtTcTcctTtTcttTtcccttTTttTttTtTTtTttTTtttttttTttTtttctcTttcTtTTTttTtTt	:@@CGFGDGGGFFDGGGGGDGD<GDDGDGGDDDGGDA8CDFCFGDGEEGGECDDEDDFEEEEDDHDHE>DHFEFFFEECDC=	T	67	C	15	29	1	38	14	0.00747
1	1599888	A	112	AAAAAAAGGaaAAAAAAAaAaAaaAaAAGaAAaAGAAaaGAaGAAaaGGaGaaaAAGaGGaaAaAaaGaaagaGGGaaGaaGGaaaaGaaaaaGaaGaaaGaaaaaggGGgg	BEGHGHFCCEEHH<HHFHEHEFDEF>FHCCHHEHCC?EBCHFCHGFFCCF@FFFFBCF=?BFHEHFECFDFDFCCBFEBFFBBFFFB@FFFFGBDFB<5FBEFFFEFEBB;C	A	82	G	30	31	25	51	5	0.00003
1	1599940	C	67	TttCtttctCCCttCttCCttttCttttttCtttCtttCtttttccCCccCcccccCccccccccCc	BC?@8DC?F@GFGFGGGGGGGGGGGGCGGGEG?GGGGGGGGGGGCCGFACGCCCCCGCCC?DCCCG?	C	35	T	32	16	1	19	31	0.00005
1	1666251	G	108	aGGGAGGgGgGgAAGGGgGGGGggGgAAGGgAAGgAGGgggGGAgGgggGAGGggAgggggggAggAgAAAgAgAAgggggggAAgAAggAgggAAAAAaaAAaAAaa	A?ACHACFAFCFHHCCCFCCCCDECDHHACFGHBFHCAFFFCCHFCGGFCGBCEGHGGEGFFFHE=HGGGGGHFGGGGGBFEGGG;GGGGGEFFGGGFGDEHHCBC@@	G	69	A	39	26	33	43	6	0.00000
1	1666303	T	87	TcccccccTccTcTTTcTcTTcccccccTTcTTcccTcccTTTTTttTTTtTTttttTttttttTttTttttttttttttttttttT	BCCCCC=?AACEAEEEBEBEEBBBBBBBEFBEEB;BAABBEEDEEHHE>EHDEHHHHEHHHDHGEHHDCBHHHHHHEHHHHFHHHHD	T	61	C	26	28	0	33	26	0.00001
1	3789211	A	46	GggggGggGgGgGgGgGgggGGgGgggGGggaaaaaaaaaaaaaaa	>?EEFCEB=FCE6E=EBFEECBFBEEFCBGFGFGFGC:FFFFHFEF	G	31	A	15	12	0	19	15	0.00424
1	9324571	T	202	TtccttTtTtttTCcccttctttCTTCtCtctCtTtccccCtttcCccccccccctccttcCtccCCCCTttctCTTttcctctccttTTttcccCctcTtCTCtcctCttTcttTcccTccCCCtcctcttccTTTcTcTtCctcCtctTtccTcccTTccTtTTTCCTTCTTCTtctcTTtCTcTtTTtTTtTcctTCcc	DC?C?B=BADCEEE8BAFFAGGGGGGFGFGBGCGFGBBBBGGGGAGBBBBBBBBBGBBGGBGGBBFGFHFGGBGGDGGGB>GBHBBGHGGGGACBCBHCGHCGGH?BEGHHGCGHF=CCECBGGGHC@ECHHCBGGECGCGHDCHC;HCHFHCCFC>CFFCCFHDFFFFFFFFFFFHCHAFFHFFCDHFFHEFHGB?CCA=<	T	105	C	97	45	28	60	69	0.04151
1	11718859	C	80	tttTCCCTTcTCttcCtCTTcTctTCcttCtCCTctCTCtcCCTCcCCCTcCtCcTtCCtcctccCttcttCtctCcttc	C?C=AA:DCBFGGGBGGGFFBGBGGG<GGGC?GGBFGG8HCFFF<CGGGFCGHGAGHGFBC@FCCGEFCIHFHBHFCB<;	C	43	T	37	25	13	18	24	0.04647
1	11938210	G	44	ggggGGGgGAagAAGgAgAGAAAAAgAgagggagGGAAgaaggG	GEFEEEEEEFDEFFEGFFEEFFF?EGEDEGF@EFDDEDG>EFED	G	26	A	18	9	13	17	5	0.03054
1	12854414	G	69	aGGGGGGggaGGGGAGGGaGgGGGGGGGGgGGGGGGaGGGGGgGGGGGAGGggGgGGGgGGGGgGGGGG	CCBAC?C8FE=ABCHCCCEAFCBCCCABCGABCABBABBBBBGBBB@9GBBGFBFBBBGBABAF?@?>:	G	63	A	6	53	2	10	4	0.01334
1	15541607	T	82	cccTCCCtTcTcCttcTCcCcCTCTCTCTCTCTCTCCCTCTCTTTtTCcTcCTCcCcTCctTcCCcCtTTTCccTTcTcCcc	C?>FGGGGGBDBHGEBGGBCBGDGDGAGGGGGGGGGGG>GGGGGFHEFCECFFF?FCFFCHF?FDCCHFFFF?CFD@B=@<5	C	49	T	33	28	27	21	6	0.03023
1	16385874	T	178	TTTTTTTTTTTCTTTtTTTTtTTTtTtTTTTTTcttttTTccctccTctcttTtTTTTTTctTTTctTTTTtTcTTTtttTTtTtTtTTTTTtTTTtTTTTtTTTtTTtTttttTttTTttTTtTTTtTTtTtTTTTttttTTttttttTttTTTTTttTTtttTtTttTtTtTTTtt	=?DDCD:ACEEGEBEDDECFDDEEDEDEEEECEGDDDCEEGGHCGH>HEHEEDEEEEEEEHDEEDGDAEDAEEHEECAEDEEEDECEECDDDEDEECDDDDDDDDDDDBDFFBEDCEEDEEDDEDCDEDDEDEDDDDDEEEDDEEBEEDDECDCDCDAECD?EDDCBBAC@<?@A?BB	T	166	C	12	103	1	63	11	0.00032
1	16862340	G	98	AAAGGggAGGaGGGAGGGAGGAaGGGGGGGGAAGGGGGGgGGGGAaGGGAaGGGGGGGGGGGGGGGaGGggGGGGGGGGGGGGGGGGgaGGGgGGGGG	;@ECFDDFGGEGGGCFGG?BGEFGGGGGAGFE=GGGGGGFFFF8CFFGFEDFFFAFFFFFFFFFFEFFFGGFEFFFCFEFEEGFDDEBCCBB??ACC@	G	81	A	17	74	11	7	6	0.00931
1	16862502	A	443	AAAAAAAaAGGGAaaaAAGaaAGAAAAaAAAaagAaaaGAaaaAAGAaAagaGGaaAAGAAAaaggaaaaaAAaaAAaaAAaaGAAAAAAGaAGaaaagAAagaaaaAAaaaagaAAAAAAAAAaaAAaaAAAAaAGAaaaaaaaAAGAaaaAAAgAgaagaAgaAAAaAAAAAaGAAGgAGGAaaaAAgGaaAagGaaAAAAAAAAGAAagaaaaaaAaaaaAAGAagaaaaaaaagaaAaaaaAAGAaagAAaaaaaaGGaaagaGaGaGGAAGAaGGAagaagaGgGAAAAAAAAAaaAAAgaAGGaaaGAAGAAgAAGAgGGAAaaagGGagaaGGaagGGAAaAgGGGaaGAGAGAGGGAAAAGGAGGaaaGAaaAAAaAagAAaagAgAaAAGaagGaaaagaaGGgaaaaGAGaaaaaaAGGAaaAGGGaaaaaaa	@B>=:??@:@?>ACDBCCBEECBDEDDC=EDCDDECDC@EDDD>ECEDEDFDCADDEECEEECDFCDDDDDEEDDEEDCDEDDAEEEF@CCDDDDDDCFEE<FDDDDEDEDEDFDEDEEEEEDEDDEEDEBEEDD?CEEEEEEDDEE?EDDDEEEECGDEGCEG@DDEDDEEBEEBEDBEECCEEE@DDG@EEEEGCEDEEDEEEEECDDEFEEDEEEEEEEBEEHEE<EEEEEDEDBEDDEEEEDDCDEEGEEAEDEDEHHEBEGDHE<EBGDDGDAGGDEGEE?EBGG;DDCDDDDDEADDDGEDGGEBEG?DGDDGDAGDGG?CAFFDGGGEAFEGGEFFGFBDDDBBBGEEGDFDGDGGGDDCDGGDGGEEEBDEEDDDEDEGD@E<FDGCACCGDDGGCCCEGDDGHFCDBCECEB??AAAADEA??@DDC?:>==B?	A	335	G	108	159	73	176	35	0.00036
1	16973519	G	299	AAGGgGGGAAGGgGGGggGGGGGAgGGAggGgggGggGGGGAGAggGAgggggAAAAGAGGGGGGGGgGGgGGGGGGgAGGGGAggGgGGAgGAAGGAAgGAAGAGAggGGGAGGAgAgAGAgGGGggAGGGgGAGGGgGAGGAAGGGGgAAGgAGAGGggAGGGGgAGGAGGAAGGGAAgGgAGGGggagggGGAgGGGggGaaGgggGGggGGGAGGaGagggggAgggagggggGGgggAAGAgGgggGAgagggGgGGgAAGgggaGAGaaGGAGggGaggggagggGGGaagGg	DC>@?>>6:5<8B<>>ABAA9<CHFBCGEFBFFFBFFC;;BHCHFFCGFFFF@HHH?CFC:CCCCCBFCCF<CCCC<GHCCCCHGGCGCCHGCHHCCHHG<GHCH=GGGCCCHCCHGHGHCGGCCCGGFCCCGCHCB?ABGBBHGBBCBGGGBBFBGBBG8GBBBBGHBBGBBEGBBBGGGBGGBBBEEGGGHBBGGB@>GGBGGBEGFBBGEBBBGBBCBGEGEGGGGGBGGGGGGBBGGGGGBGGBGDGBGGGGG@AGBAEEHBFE<A@E@?C?@D@AB==BB>:?@8@;<<@???D	G	227	A	72	131	58	96	14	0.00042
1	16974013	C	32	cccCcAccAAcccccAAccccaaCaaaaaccA	>?AGBEBB<BBBABB@FBBCCGGFGGGGGCCD	C	19	A	13	2	6	17	7	0.03831
1	16974256	G	45	GGGGgGggCCGCGgGCgGCGggCCCCGGCCCCCCGGCCGCGCCGC	<>@CCCCC>DADBCCCDBCBDCCCCCBACCCCBBABCCBCBC@<@	G	24	C	21	17	21	7	0	0.01019
1	16975045	G	289	GGGGGGgggGGggggGGggggggGGGGGGgGgggGGGgGgGgGGGgGGGGGGGggGGGgGGGGGgGgGGgGGGgGGGGGgGGGGGgggGgGGGAGGgggGGgGgggGGGGGGgGGGGgGgGGGGGGGGAGAGGAAGGgGGAggGAGAagGggggGAGGAGAAGgggAGGGAAGGGgggAGGGAGAGGAGAGGGGGAGGgaAAGGGAAGGGAAAGGGGGGggAgAAGAGGggGggGGGggggGGgGggGagGGGGGGgAGGGgGAAGAggGGGgggaAAGGGggGGAGGG	:=:;=9?CD?AFEFFC@EFEFEFBCCCCCEAEEECCCEBFDF=CCCCCCCBCCFECCBFCBCBCFCFCAFCCCF?C=BCFCCCBBGGFCFCC;HCCGGGCCG?GEDACCC8BGCCCBFCFBBBB5B9?=BGBBGFABECBHGFCFAGFBB6GFFBHCCG@FGBGGFGBBBFGBBCGFFGBBBGBG?BGBGBBBAAFABHGGGB>BGGAB7GGGBBBBBBFFGBGGBGB@EGBGFBBAFFFGBBDBFFBFFBB@BBAFGABAFBHGBHED???CDBCEE@==A9<<B<AC	G	246	A	43	164	39	82	4	0.00098
1	16975495	T	66	TcTcctttTTTctTttttcctTctcccccttTcTcctttttcttTtTttttTtttttttTTtttTt	>5??>DGFCEE@GECGGGBBCCBGBBBBB?GEBAB?GGHHGBGHEF9HHHHDHHHAHEHDDHHHCD	T	50	C	16	15	0	35	16	0.01392
1	16975994	T	156	TTtcTtTTTTTTTTCTTTtttTTTTTTTttTttTTtTTCTTTCCTTTTtTtTTtTTtTTTTCTttCCtCTCTTtCtTTCTTTTTtttCTCCtCCTtCCTCTCTtCtTtTCtCttTtCCCtCTtCttTCttCttttttTTCCcTTCTCtCttttttt	CDC?ACFFFGFGGHDGGGEEEGEGGGG?EEHEEGGEGGDGGGDDFGDGDF=GBEDGFGGGG>?FFDDFDGDGGFDFGGCGGFGFFF@CFCBFCCAF8>FCFCFECFFGFCFCFFFFCCCFCFFCFFFCFF:FEEFFEFECCEFEBGBCA?A@@?>B	T	119	C	37	68	35	51	2	0.00001
1	16976188	C	133	tccccCCCccccctccccCCcCtCCcCCCccCtcCccCCCtccCcctcccCcCCccccccctCccccCctcccCcCCCcCcccCCCccccCcCCCCtccctCcCcCcCCCCtcccCCCCCCCCccCcCCCCcC	C@EEGFDGF;GGGDGGGGEFGGDGGG>GFGGFDHFGGGFGDGGGGGBGHHGHFFFHHHHHHEFHHHH@HDHGHGFGGFHFHGHFFFHBHAE9FEEECHHGE?HFEFHFEFFDHGDEEFFEEEFAHFFFC6A>A	C	122	T	11	56	0	66	11	0.00254
1	16976223	C	140	cccccCcCCtctcccccCCcctcCcccccCcCCCcCttcCCCccccCcCCCCcctcccCcCcCCCCccccCCCCCCCCccCcCCCCtCCCccccccCCCCCCCCcCCCCCCCCCcCCCCCcCcCCcCCcCCCCCCCCCCC	?CEEFFHFFDGDGFFGGFGGGDG=GGGGGGCGGFGFDDGCFFGGGGFGGFFFGGCGHHGHGHGFGFHHHHFFGGFGGFHHFHFGFDEFGEHHHHH9FFEED=FEHEEFFEEFFEHEEE:FHEHEEHEEHFDDEEEDDECA	C	133	T	7	79	0	54	7	0.00243
1	16976451	G	50	ggggggggggggggggGAgggggggAggggggGGggAAGggggGAagaga	?@CCCCCCCCCCCCCCHECCBDDDDEAC@>DDGGDDDDGDDDDFDBCC@B	G	42	A	8	5	5	37	3	0.00495
1	17083685	C	36	CAACAACAACAAACCACAACACCCaCCCCaaCCCCa	GFFGFFGFFDEFFDGFGFDGFGGFEFFFFEEEG@@B	C	19	A	17	19	13	0	4	0.04040
1	17084304	C	349	CCtCtcccCCCctcCcCCCccctCccccCcccctcCccttctcCcccccctccCCCcCCcCcccCtccCCcCcCcccccCcCCttcCCccccCCCttcCcccCCcCCCCccCCccCCccCcCccctCCcCcctcctctACtccCCcCCCcccctcccccccCCCCcCCCtctccCCCCctcccccccccccccccCCCCccCtcCccccccCCccccctcCCCccCCcCcctctCtCccCCcccCCccCcCCCCccCCccCcCcCCcCCCCcCccccccccCccCCaccCccCCCccCCCcCCccCCccccCccCCCccCccCCCCccccCCCccCCcCcCCCCCCCcc	D@C9>@BBA@BCCBCCFBEED?>FDCDDEDDDDEC=CDDDCCDCCCCDCCDDDG7FDGDD?DDDGDDDGGDGDGDDBDDGCEGEED>GDDDDEGGEDDGDDDFGDGGHHDDFGDCGCDDEDGDDDEGGDGDEDDDEDDFGEDCGGDGGAEDDDE;DDDDDDGFFGDGEGFEEEDFGGGEFDDCDDDCCEEEEEEEFGGGEEDEDFEEEEEDFFEEEEA>DGGBEEGGEGDDEEDGCFEEGFDDEGGEEGEFGFFECFFEEF@FEFFEFFFFEDEEEEEFEFDDFFCFEEDEEFCFEEFFFEFFEEFFEEEEFDDFFF<DEEDFFEEECDEEEEADCDAA?A@BAAAA=B	C	319	T	28	138	0	181	28	0.00000
1	17085127	C	101	ccccccccccCcctcCtccccCcctctcccccccccCtctCCcCccccccccCCcccCCcCCCCCCcCCCcCCCCCCcCcCcCcCCCcCCCCcCcCCCCCC	CAAC=>5:?CFBAFBGGBBBBGBBGBGBBBBBAABBGGBGGGB@BBBBBCAAGGB=BGFAGGGFFF@EGEBEFG=EGCFCDBACFEFCFFFFCFBCBA@BC	C	95	T	6	43	0	52	6	0.03675
1	17085165	G	104	ctCTtCTTCCCcCTTtTCTTCCttTtCcTtCCCtCTCCtCtCCCCCTCTCCcCCCCCCtttCCCCtccCCttcCCTCctCCttCtCCtcCCttCCCCCCCttct	BBCEECGGDDDFEGGEDDGGECEDG@DFGEDDDEDGCDFDEDDDCDF=FCDGDCCCCCFFFDCCCFGDCCFFGCCF8GFCCFFCFCCFGCCA<CCA????BCDA	C	64	T	40	54	14	10	26	0.00000
1	17085267	A	199	AAaaAAaaGAAAgAaaaAaAAgaaaAAaaaaAAaaAAaAAaAAAAAAAaaAAaaaAAAaAAAAAAGAAAaaAAaAaaaAAaAaaaaAaaaaaaaAAaaAaAAAAaaaAAGAaaAaaaaaGaaaAaaaaaAAGaAaaaAGaAAAaaAGaaaaAAAaaaaaAaaGAaaGAGAaAaaAAAaaGAaAAaaaaaaAAaaaaaGA	CC?@<>CDB?@BCEEFFEF@FCFFFFFFFFFFFF@FFFFFFEFFFFFFCFFEFFEFEF@FFFFFFGDFFFFF@FFFFFFEFF@GGFAFDGGFEGFFGFEFEFDFEFGFEGFGGFF>GGGGGGGEGGGGGFDBGFGGGFFGFFDGGEFGGGGEEEGG?GGEGGFEGGFEFEGEEFEEEGGFEDEEFGGGGEDC@CB<BC?	A	185	G	14	84	12	101	2	0.00439
1	17085502	T	137	ctctcccttttTcccTTCcTtccCctcTCTccctctcCccttccccTTcCctcTCTctccttCTccctTCTcccTcctccTtcctccttttTccctcccTtcctcTTcttctctcccctttttttTtctcTCTCTtt	AABAA@ACCDFFDDDGFGDFECCGDEDGGE?DDEDEBGDDEEDDDDGFDGDEDGGADEDDDD6EDDDEBGGDEDFC>EDDFFDEFDDEFFEGEDDFEECGFEEFEGGEEAEFEDEEDEFFFFGEDFFEFDFEDABAC	C	72	T	65	10	23	62	42	0.00474
1	17087159	G	202	cggGgGGgggcgggggggcgcgggGgggggggggggggGcggggcgGgcgGggcggggggcgggcggggggggggcgcggggggcggggGgGggccgggggGgggggggggggggcgggggccgGgcggggGgggggGggggGGggggggggggcggGcgcgggggcgGgGGGGGggGGGGGgGGggGGGGgGggGGGGGGG	AC@@C<5BBACBCCCDDDEDEFFFHFFFFEFFFF7FFFHGFFFFGFHFGFHFFGFFFFFFGFFFGEFFEFFCDFFGFGFFFFFFGFFFFHFHFFGHGGGDEHFGGEFGGGGEGGGHGGGGGHHGHGGFGFGGGEGGGHGGFGHG=FFGGAGGGGHGGGHEHGGGHHHGGGGFGGGGGGGGGGFG<GFGFGFGGFEGFEEDCA	G	179	C	23	41	0	138	23	0.00529
1	19408380	T	57	cctccctTTtTTttttctcccTtcTcctcccctcttcttctTtctcttTtttccttt	ACB@CAEGFCGGECEEDEDDDAEDGDDEDDDDEDDDDE=DEFEDFEBFFF:FEEE7D	T	34	C	23	8	0	26	23	0.01633
1	19499835	G	159	CgggggggcccGcgcGgggccGggggggGcgcCggcCggGcCcggccgGCGcgGcgcccCCccGGgcCCggggggCgcggGgCcggGgcCCCccCcCgcggCgggGGcgCCcgGcggCCcgcCGggCCCGCcGgGcgCGGgcggGgggcGCCCccCgcC	>C>BBCCDFFEGHGHFFEEGGGFFFFFFHG=GGFFGG>FGGGGFFFGFHGHGFHGFGGFGGDGGHDGGGDFFFADGFHGGHGGGGGGGHGEFHHGHGGHEGGEEGGGGGFFHGDHGGFFEGHFGHFFFFBFHGGGHGFGGGGGGGGGGHFEFGGECB@C	G	86	C	73	23	32	63	41	0.02980
1	21752752	G	91	GGGGAGAgGAGGGGGAGgGGAAGGGGGGGGgAGAAgGgAGGGggAAGaGGGGgggggggggAggagAAagAggggggagagAgAagggAAA	@@>>BAFGAHCCCCBHC:BCHH8CCCCC@CFHCHHFAGGCCCDGHGCGCCCBFGGGGG>GFGCGGGGGGGGGGFGG;FGGGGFGEDA:C?C	G	64	A	27	32	21	32	6	0.01952
1	21752762	T	86	TTATtTTAATTTTTTTTtATAAtTtATTTttAATaTTTTtttttttttAttatAAatAttttttatatAtAatttAAAtttttatt	?BGEBGGHHDFFGCGFGEEGFGEGEHGGGDEHHGFGGGGF@FFFEF<DFEFFAGGFEGFF<EEEGEFFGEGEAEBGGGEDDDBA=>	T	61	A	25	23	18	38	7	0.00466
1	21752830	C	54	CCccCttccttccctCtCccttCCCtcctccccCcCCtctcCcccCcCcccccc	DDAC;BC?CGGABBGEGGBBGG@FGGBBGB@BBECDGGCH@GCCCFCFCBCD6A	C	42	T	12	14	0	28	12	0.02373
1	22157689	G	218	AaaAagGGGGgaAgaGgGgaaggaaaaaaAaAaGaagAAagGAgaaagggaAGaAaaGAaAGAGagaagaaagaaaaaaGaggagGGGGagggagGAGgaaGaAGaAAaaaAggAGgAGAGAgaGGAgGAGgagagGAAAAgaaaGaGaaGGgAaAagGAagggaaGGGagAAGGaGAGaAGGAGAgGAGGgagaaAagAaAGGAgGagGaGGaaaGa	8AA;BBCC@BAD=DGFE>FFEEF:FFFFECF;FHFFFECFCHCFFFFFFFF@FADFFHBFCHEHFFGFFFEFCFFFF6EHGGFGFGHHG@GGGGGHEFGEGGGECGEEGGEBBGCHFBHAHEF:FHDGF7FFFFGGGE9CDGGGFG9GGGGGGDGDFEGDGGDGFHGDFDGDDGG?FD8FDGBDGCFGDFFGGGGED;G@9DGHEEF=<CB@C>B:C9	A	119	G	99	42	54	77	45	0.00602
1	22333595	G	42	aaaaaggaaagagaGaaaagggaaGaGaaaaggaGgaaGggg	CDDGFBBFFECFCFAFFEFBCCFFCGCFFFFDDFBDGGCED>	A	24	G	18	0	5	24	13	0.01007
1	24201094	G	67	cgGgGgCgGcGCCCgGGgGgCCgGgCcCCgCcgcgCcggGgCgCGGggGCgCgGCCGCGCCCCcCCC	9<@CCCDCCBCDDDCCCCC?DDDC@DBCCDCC9CDDBDD@DCDCB<DEBCDCDBCCBCBCCBBBCD@	G	35	C	32	15	25	20	7	0.00567
1	26448849	T	197	CTttCttttCctTttcTCCTctTCCCcCTTtcTttctcCTCTtCCttCTCccCtctctcTCCttctTTtcCctctTTttTccctCtCTctCctCctcCctTcttctCTTTTtTcctttccttCctCcctTTtCcTCcctTCTtcCtcCTtCCtCctCtTCcttCttCctCtcTCCcCCtCTCTCtCccTCtCcTtct	DBC?@BBCED@HFGGAGGGGBGGGDDBGGFEBFGGBGBGGGFGGGGGGEG?BFGBGBG@BGGGGBGGCEBGCDBGG9HGFBCBGGGG>CHGCHBCHCGCHFCHHAHGGGGGHGCCGHH9CEEGCFGCCH=GHFCGFCCHFCGHCFHCFFHFFHFDIFFFFCHHDHHFCHFHCFFFBFFGFEFEEHF??BBB?=AC=C	T	100	C	97	36	50	64	47	0.03171
1	34052305	C	38	CctCctttttTtCcCCCtTCtCtTcttttttctccCtc	DCC>5HHGGGFGEBDGEGDGGFGDCHFHHHHCHCCEHC	T	21	C	17	3	9	18	8	0.01587
1	39748921	G	82	AAAGaAAAAGaGAagagAGAAGAGGAAGAGAaAaaGAAGGGGaAaGGGAGaGAaGAGAGAGgAAGGggGGaaGaaAaaaaaA	@DAGFFFFFGFFEFCG@E:F>GFGFFFGFGFGFGGG>EFFFFGEGFEFEFGFBGFEFEFEFDEEFEDDEFGGFGFEFDAAAA	A	49	G	33	29	28	20	5	0.01539
1	39879366	T	31	tTcCCtttCcCtTCtCCTCtCctCCcTCtCT	>:>DDHHGDCDHGDDCCFC6;=DCCCFCFDC	C	17	T	14	13	5	4	9	0.03254
1	40235489	T	112	TtctTTtTTTTcTTTTctTTTTtcTTtTTtcTTtTtTTtTctTtTtTTTTTtcTTTctcTTtTTTTTTTttttTTTTtcTTTTTctTtTtTTtTTcTTtTTtttTtttTTtt	FECDD@EGGGFDGGGHDE>EGBEDGGDGGEDFGFGEEGEFDFGFBFGFGEFFEFGGEFEFFFFF6AFFFFEFAFFFF8EFFFFFEFFFFFFFFFFEFFEFFFF9EFACDCA;	T	100	C	12	66	0	34	12	0.00001
1	47610117	C	244	cCcccCCcCCCCccCcCCCcCcccCccCCCCccCCCCCCCcCcCcccCCCcCCCcCcccCCCCccCCcccCccCCcCccCCccCCCccCCCCCCCcCcccccCCcccCCCcCccCCcCCCccCcCCccCcccCCcccCCCcCCCCCcCCCcCCcCcccCCcCCCCcCCCCCCCCCccCCCcccCCCCCccCCTCCccccCTCCCCTcCCTTcTcTTccccTTCTcCCCCCcTCCCCCTccCCCt	@BDDD>>FEE;<AGGFAGGGGFFGGGGGGFFBGGGGGFGGGGGGGGGGCGGGGGGGGGGGGBGGGG:GFFFHGFBHGGHGD<HGGGHGEGGDFCFHGHHHHHGGHHHGGGHGFHGGHGGGGHGHFCHHGHGGFFHGHGFFHFFCFF@CFFHFGHFHHHCFHFFDFHFFFFCFFFFHHCFFGEHFFFFCHHFFFFFGHHHFFDFFFFGFFEEHFHEFHHHHEEFEFCCCDDE?B@A>>ACCACC9	C	230	T	14	135	13	95	1	0.01035
1	55119289	G	193	gGCCgcCGGGccGgcccCGCGGcCgCCCGCcCggcccGCGccgcCcGGCGgcgcgGGCCGcGcGCGCCCGGGcGGgCgggCGcCCCgccGGCGgGgCCggcccGCCccCGCCgccgcgCGGCGGGgGgcGcGGcGggcgGGGGcccCGGCGgccGGGcgggGCcGccccGGCggcgCCggcCGCGCGgGGgcc	CC?@AD@BEFGHFEFGGG>GHGGGFEFGHEGGFFGGGHHFGGFGHGHHGHFGDHFHHGGGGHGHGGFEGHHHGHEGEGGGGHHGGGGGFHHEHGHFGGGAHHHG=GFHFGFFGH?GDGFGGAGGGGGGHGHGGIGGFHGGGGGFHH@GDFGGHHGGGHGGGGFHGHGHHGFFGGHGFFGFHFGGGDD?C?<EE	G	99	C	94	61	44	38	50	0.04382
1	82433929	A	49	tatAAaAAAatAAattAtataTTaattaaattttttatatatttaattt	BCCBBGFFFEEFFFEEFEFEFDFGFFFGGGFFFFEFGFGFGEFFGGFFE	T	25	A	24	2	8	23	16	0.03743
1	121116688	A	79	GGgGaGGAaAGGGGGGGAGAGGGGGGGgGGGGGGGGGGGGGGGGGGGGGGGGGGGagGgGGGGgaGGGgGGGGGaGggG	6?GBF==7DHABCBCCCGBGCBBBBBBGBABBBA=BBBBBBBBBBBABBB@BBB@FGAGAAAAFCBCC<?;>?@A>B@C	G	70	A	9	62	4	8	5	0.00491
1	144874070	C	51	TccctttctctcctTctcccccttccccctcccttcccccctctcTcctcc	DCCC><@DAEBGGDGGDGGGGGDDGCGGHEGFHEEFHHHHG@HEHFHH9B@	C	33	T	18	0	3	33	15	0.03918
1	145014263	C	183	ccccCccctCCCcCCCCcCCCCTCccCCCcctCTCCCCCCCcCCCCCCCCCCCCCCCCCCCCCCCCCccCCcccCCcccCCtCcCCCCCCtCCCCCCCcCCCCCCCcCcCCCCtccCCcCCccCCtttCccCCcCCcccccCCCCtccCCcCcCcccccCccccccCCtccccccCccCcccc	CBBBEBBBGAGEAEGGEB@GB8EG=BEEG>BGGDGFEGGG6CGAGGGAGGG<GGGGD:GGGF@EGEGCCGGCCCEECCCGGHGCGEEGGGHFEGGGGGCEFG=GFECFCFFFFHACFFCGFCCFEHIFFCCFF@FDBCACCFFFFHCCFFCFBFCCCCCFCCC@CCEDHC@B?A?B:=B>;@=	C	171	T	12	105	2	66	10	0.00419
1	145281408	C	776	TCCccCCCCTTcCCCcCTCCCcTCCccCCtCTccccCCCCCCCCCCCCCCTCcTtCCTTTCCCCcCCccTCCCCCTCCcccccccCCTCcCCCCctccTCCTCCCcccctcCTCCCtcttctcCCCTCcccctcCCTCCCTCccccCCCcccTCccCCCCCCCtccccccCCCCccTTCTTCCcccCTCCcccTTCTCCCCCcctcccCCCccctcccCCCCcccCCCCCCcccccCTCCtcTCCCTCCccccCCTCCttcctCTCCCCTCCCcCTCCcccccCCCctccTCCCctccCTCCTttcCTCCTCCTCCTTcccCTCCCcCTCccccccCCCCCCCCCCCTCTccCCccccCCCCcccTCCccccTCctcCCCCcCCCCCCTcccccCCCCCCTccccTCccccTCCCTtCTCCTCCtccCCCCCTCCCCcccctttcCCTCTCTccCTCCccTCCCCCCctcTCCCctccccccCCCcTTccCCCCctcCTcccCTTCCCTCCTTTTccccccCCCCCCTccctccCCCCCCccccCCCTTCCCCCttCCTCTCccCCCCCCCcCCcccCCccTCCCCCCCTCTcccCCTCCCccccctccCCcccccctccCCCTTTccccctCCCTtcCTCCCCctcccttctCCCCTTcCCCTTtcctcCCCTttctcTCCCTtcccCCcccCTCCTCCTCTTCcCCTTCCcccCCTCCTCtccctCcctCCCCTCTcccCCCCCccccCCTCTtccCCTTCCCttcCCTCCccc	CA@A@??8<?>B?==9?C>>>BFAACDBCECGDDDCBBDB7DCDDDDCDDGDDGEDDGG8CDDDDDDDDGDDDDDGCDDDDDDDDBDGCDDDDDDEDCGDEGDEDDDDDDDDCEEEEDEDDEDDDBHEDDDDEBEEGEEDEDDDCCDDDD<DFDDDD=DDDDDECC@DDDDDDDDDGADGGCCADDDGADDDDEGDGDDDDDDDEDDDCCDCDDEDDDDD?ADDDD>DDDDECEDDDFDDEEGC<5CDDEEDDDDGDDEEEED@GDDDDGDDDEDGDBDEEEEDDCEFEEGC>C;FEDDFCDGFFEDGDCGCCFDC=FEEEDGDDDE>GDDDEEEEDDDDDDDDDDBGDGEEDCEEEEDDDDDEEGDDDDEDGDECEDDDDEDDCDCDGEEEEEDCDDDDGEEECGCEEDDFBDDGFDGCCFCCBDE@CCDDFDDADEEEEDFFEDDGDEB<EECFCCEEGCCDCCC@FEFCCCEFEDEDEE?CCEFFEECCCCEEDDFEEECFF=CCFCCFDFFEBEDDDCCCCCCFEEEFEECCCCCCEEEECCCFFCCCCCFFC=FCF=EECCCCCCCECCEEEC@EEFCCC8CCCFCFBECCCFCCCCCCCCDDDCCEEEEDEFEECCCCFFEEEEEFCCCFFECFCCCCEFEEEFFEFCCCCFFECCCFFEEEFECCCFDFEFEACCCEFEEECBDEEBEBCFCCFCFFCCCBEECBCEECBFBBEBDCEEBCCDACCCCFCEA@BA=ABA@??@@@D@CA?=??ACAAA:>=C?C?CBBB	C	613	T	163	359	111	254	52	0.03034
1	148902392	G	125	AaaGgagGGggaagGGgagaaggagggggGGggagaaGagGggggaggaGGGgGaagaaggaaggagggGgaGgGgGaggggaagagGGGggggggGGgGggggGAgggGgggggggggGGgggg	@C?A@CCECBCFFFGGEDEEFFFDFFFFFHHFFFFFFHFFHFFBFFFFFHHFFGFDCFFFFFEFCFDFFHFFHFHFHFFGGGGGGGGHEHGEEGFGHGFHGGGGHDGAGDGBAGDGGGGGGGDCA	G	96	A	29	27	2	69	27	0.02218
1	148903616	G	198	AgGGGGGggGAAgGAAAGGGaGGaGAGgGggGGAAAAGGgGGAGAaGAGAGAGAAggGAGGGGGGgGGggGGgAGGggaGgGggAggggGGGGggGggaaAGggggGgggggAGgGaGGgggGGAGggagaagGAGAaAAagAgGggGgggggggGGGGgAGGAgAGggAAAAAaAaggAgAGGgGgagggAAggGgG	E?;>=??BB?FFCBGFHCCBD>CDCH?CCC?CCHGHHACCCCHAGC=HCECGCHCCCCH@CCCCCCCCCCCCCHCBCDDCDCCCGD=CCCBCCDD6DDECHCDDDDCDDDDCHCCCECCDDAC=H?DDEDEECBGCCDGFEDFDBDDBDDDADDDBBBBDGABGDGBBDGGFGGDGEDDGCGAADABECDCGGBC@??	G	141	A	57	71	42	70	15	0.00270
1	148903617	G	199	GGGGGggGAAgGGAAAGGGaGGaGAGgGgGGAAAAGGgGGAGAaGAGAGAGAAggGAGGGGGGGgGggGGgAGGggaGgGggAggggGGGGggGggaaAGggggGgggggAGgGaGGgggGGAGggagaagGAGAaAAagAgGggGgggggggGGGGgAGGAgAGggAAAAAaAaggAgAGGgGgagggAAggGgGGag	B@==?AAABBBACDEEDEDFAEFEFDCECEEFFEFEECEDEEEFAFEFEFEF<CCEFEEC@EEFCECCEECBEDCCFECEBCFD>CCEEEEDD;DDGFEEDDD?EDDD>DFEDEFEEDDCEEFCCDGBGG?DEDEGFDGDFADDDDDDD=DCCDADDEEDDEDEDDCEEEDEFEGDDDDECCDDBGDDCCEBDE@ACDA	G	142	A	57	73	41	69	16	0.01090
1	149676401	A	79	agggGGGggaAaaAgagGAaggAgggaAagaaaaAgAagagggaaAgaggggggaAaagagagagAggAAaAagaAAAa	CCAC<;;AACCDDFCFC;HEBCHBCCFHFCFFFFBCGFCFCCCFFHCFCCDDDDGHGFDFDG;GD9DD@GGGGDGGGGG	A	43	G	36	16	4	27	32	0.00959
1	150526406	C	38	tTTTTctTcccttTcTttTtcTTTTtCCcttccTTTTT	B?AFFDEEDDDEEFCFFFFFEFFFEFFEEFEEEEEEBD	T	27	C	11	17	2	10	9	0.02930
1	152186699	T	143	TTTTTTTTTTTTTTTTTTTTTTTTATATTAATAAAtAttttAAATtTAAtTtTAAtTtttAtTttAttttTTttATttAttTtAtATATAtTtATttAttAttTTttTtttATTtTTTTtATAtATAtTTtATAATAtATAAA	B@@GDGGFGGGFGG;GGGGHGDFGFGHGGGHFHGEHBAHHDHHHGHFHHGDGGHGHGHH@GHGHHGHHHGFFHHGEFHGHHFGHBGFGFGHFHGFHH;HHGFG?FHHFHGHGFFHFFFFGGFGBGFGHEFHFEFGDDCDDC@C	T	104	A	39	58	39	46	0	0.00000
1	152186708	C	155	CCTCCCCCTCCCCCCCCCCCCCCCCCCcCcccccCCCcCCCtCcCCCcCcctCcCccCcctcCCccCCctCccCcCcCCCCcCcCCCctcCccCccCCtcCcccCCCcCCCCcCCCcCCCcCCcCCCCCCtCCCCCCCCCCCCCcCCCCCCcccc	>@?FGDFGFGGFFGG;FGGFGGGGFFGB9CCBCA6FGCEFEGEBFFEBEBC;ECFB;FACH;EF=CF;CGFCCEBG<FGDCCF?@FCAHCFCCDC@?EGBE=;CFAECDFEECFFACFFFAFFC6FEEFEGEEEFEEFDEEEFEBBBBBAB687<	C	146	T	9	100	2	46	7	0.00791
1	152187554	C	98	TtTtCTTTctcTTctCCTTtCCTCTCTCCctcTCCCTTCCttTCtCcTCttTCTCCCTcTCCtCtCCCCCCCCTCCTtCCCCCCCCCCCCCTCCCTTC	BC>?BA=;CCC?CFFDEECEFECG6GFEFFEE;GFF<FGFEFFEFGGFGFFDGCEGB>GFFEFEFGGGFFCCCDCCDBBB=BBA6B9=D?@?>@AAAC	C	58	T	40	51	26	7	14	0.01117
1	152187588	C	224	CTCCCCCCccCCcCcCCccCCCCCCCcCCCcCcCCCCCTCCCCCcCCCCCCCCCCTTCCCCCCCTCTcCcccCCCTCCCCCCTCTcTCCcccCCTTCTCcTCcTCCCTCcTTcCCTTCCCCTCcTTCcCCCCTTCCtCTCCCCCTCCCTctccCCTCcccTCTTcCCCCCCcccCCCCCccccCCCccCCCCCCTCCTCCCtccccCCCCCCCccCTCCCCctc	AB<@BCBDBBEDB?BD6BBDDDDD9DBDDDBDBCCCDDECCACCCCCDCCDDDDBFFCC@CCCCGD>ACCCCC:CFCCCCCCFCCCFDCAACCCFFCFCCFCCFCCCFCCFFCCCFFCCCCFCAFFCCCCCCFF@CGCCC@CCCFCCCFCGCCCCFCCCCFCFF5CCCBCCCBCCBCBBBCBACBB@@BAAABBD>BE=BBC>>==@<<@A?A>;ACA???>@@	C	185	T	39	137	35	48	4	0.03723
1	152187935	C	52	cCCCcccCCcccCCCcCcCCCCcCccTTTTCcTTTCTTTTcCTTCTTCTTTc	=:EEBA6GFBBBGGGBGCGGEGCFCCDDDDFCDDDFDDDDCFD@DD<D@@?>	C	34	T	18	19	18	15	0	0.00077
1	152187945	C	54	CCcccCCCcCcCCCCccCccTTTTCcTTTCTTTTcCTTCTTCTTTcTcTTTTCC	A>DDECDDFDDADCCHEDHHGFGGDHFFFCCFFFHCFFCFFCFFFHEHFFCCCC	C	31	T	23	18	23	13	0	0.00022
1	152188109	T	142	AAataaTAtAaaTatTTATaTaaAtAaaataTaAaTTTtTaTTTtTTtaTTTTTTTTaTTTTaTTTTTTTTTTtaaTTTTTTTTaaTTaTTTTaaTTTaTTaTTTTTTttTTTTTTTTTaTTTTTTTTTTTTTTaTTaTTTT	AECCE;EHFHAEGEFGGHGFGFFHGHFFFGFFFGFGGGHGFGGG@GGGGAGFGGFFBGFGGGGGGGGGGGGGGH>GFFFFFGFGGGGFGFFFFGCFFFBCC?FFFFFFHHFFFFFFFEFEEFFCFFFFFFFEFEFDD@DC??	T	103	A	39	92	8	11	31	0.00000
1	152188964	C	89	CCCCccTCcTccTCTccccCccCCCccCCCcccCCCccccccTccTctcttccCTccctcctctccTCCctccTtccccTtCTcccccT	>GGEF=EFFFFFFAGFFFFAFFFFGEFFGGGGGGGEGGGCGFEGGEGFGFFGGFE=GFED<EFEFFEEEGFGFECGGFGEFFEGGGGEB	C	68	T	21	20	12	48	9	0.03569
1	152192219	G	44	gGGgGgGccggggggcGccggccggGGggggGGgGggGGGgGGG	EEEFECEFFFF=FFFFEFDCGFEGGEDGGFCE@GDGGDDDFEAB	G	37	C	7	16	0	21	7	0.03705
1	155003605	C	46	CTCCTCCCcTTTTTTCTTcCcccTCtTccTTTTTTTcctTcctCCt	9GDDGDCC=GGFGGGDGGHCHHFFCEFGHFFFFFFFGHEFHBAB?B	T	24	C	22	20	11	4	11	0.02684
1	156281020	G	71	cgGgGgGgggcgggGcGccCGGcGccGcGgGGgggcgcggGgcggGgCcGGcgcgcggcggcgcgcccggc	CCB@ACCCCECEEFGDGADGGGCFDDGDGEGGFGFDGEGGGGEFFGGG@GG@G@>EFFAGEEEEGECEFFB	G	46	C	25	16	2	30	23	0.02057
1	158263123	C	161	tctcccttTtcTTtctccCtccctccCCtccttccttTttTtTttccTTcccccttcccCCTcttTCttttcccCtctcTtttcccCTTtCtTcttTttcctccccctccttcctccctCtctctcTTttctctccCTTccctTtcctctTctCcTTtccc	AACCCD@@BADDD?E<EFBCGGGDGGDDDGGDDGGDDGDDGDG;DGGFGFGGGG;DGGGAAGGDDG@?DADGGCDDGDGGBDDGGGDGG99D>HDEFEEGHEHHHHHEHHEDGHDHB>BDAHAGEGDFEEHEDEFG@FFBGHEFEHHEHEFHCCFDDADC@	C	81	T	80	12	23	69	57	0.03672
1	159902526	T	42	ctttCtcCtCttctcCttctcCccCccCttccttctcctccc	??BDGF7GEGGGBGB6BGBGBGBBG6CGHHBCGHBHBAHCC>	C	25	T	17	7	0	18	17	0.03001
1	161487805	T	202	tTTTTTTTTTcTtTTTTTtTccTTTTTTTTTTTTTtTTccTtTTtttcTTTTTccctTTtTttccccTTcTtTtTTtTTtTTTTTTTTTTTTTttTTTtttTTtTTtTTttTTTTttTTTttTTttTtTTTtttttttTTttttTttTTTTtTtttTtTTTTTTttTTttTttTTttTTTtTTttTTTTtTTtTTtTTtTTt	C@AEFFFDGGEGEFGFGGEGFEGGGGFCGG9GGHGDGGFFG8GGEEECEGGGFEFFEGGFGEFGFFFGGFFFG>EFFFGFGGFGGGDGGGFGGEEGGGCFFGFBGFFGGEBGFGEDFFFFFFFFF@FFFFFFFEFFFFCFFFEDFFFFFFFFFFFFCBFFFFFF@FFFFFFFFFFFFDFEFEEFEFEDFDDCCDCACB?ACC	T	188	C	14	122	0	66	14	0.00000
1	168513129	C	92	CcTCTTttCTTcCCTTTTTTTcTccTTTttTTTTtTcttctTtttcctTTTttcTTtcctTTtcTttcTTtTcTccttcTtttttTttTttt	A>BFE?ECEFFEAFFFFFCFDFFFFFGFEEE;FEEEFEEEFFEFE;GFFCEFFGFFFGFFFEFGFEFGB>FEGCGGGBFDFFEFFEFEDA;C	T	69	C	23	37	5	32	18	0.00863
1	177917479	G	66	GAGGAAGAaGAAGGAAAAAAGAGGAGaGGGAGGAGAGaAGGaAAGGgGGagGaGAaGGGGGGaGGA	?BGGFFGEEDFFGFFFEEEEGFGGFGFGGFFGGEFEFEEFFDDEFEGFFCFFFFEEEEEFCC:?AC	G	36	A	30	34	22	2	8	0.03465
1	201178904	A	36	aaaAaaaaAaaaAAAaaaaaaaaaaGgAGGaGGGGG	>A@ECCDDEDDCFFFDDECEEED=:D9EDDECCBB?	A	27	G	9	6	8	21	1	0.00072
1	201178924	A	38	AAAaAaaaaaaaaaGAaGGagGGGGGGGGGGgGGggGg	?ACDE9DCDEEDECGEEGGE>GAGGGDGGGG?GGB@DA	G	21	A	17	16	5	5	12	0.00792
1	201178926	G	40	GGGgGgggggggggAGgAAggAAAAAAAAAaAAaaAaAAa	:?CCFACCD:DDDDFGCEED7EEEEEEEEEGEEFDE@B@D	A	22	G	18	17	5	5	13	0.00353
1	201179068	G	51	aGGaaGGgggggggaGgGGgGgaGggggGGGaagGgGggGGgggggGGGGG	C=BFFEECCCCCCCFECEECECFECDDDD@DCGDDDDDDDDDCDA?E@BA?	G	44	A	7	21	0	23	7	0.03265
1	203465396	T	55	cctttCtcCtcttCttctCtCtctTccCcttCtccCctttcccccttttctcctt	?=BC8>D@DGBGGDGGBGDEDGBDGBBDCGHCFCADCGHHCBC=CCCHHAHCCD>	C	28	T	27	8	1	20	26	0.02480
1	207075171	T	31	TCtTtTttCTCTCTCCCCCTCCTCTTCTCCC	FGDFDFDDEEEEFEEEFEFEFFEEEBFABBC	C	16	T	15	16	11	0	4	0.04338
1	233490543	G	76	GGGGGGGGGGGGGGGGGGGGGGggGgGGGGGgaAGaGGAAAAAAAAAGAAAAAAAAaaaaaAGaGGGaGGGGAGaG	CBCCCC@CCCCACACCB@C>BBGGBABB<BBFGGBGA6GGGEGGGGFAGHHGGFHEHGGGGFC@??@C>?=?C=?A	G	46	A	30	42	20	4	10	0.01327
1	241755348	C	124	CCCCCTTTCCCCTTTCCtTTTTTtCCTccCccTCCTCCCTTcCtCCccCTcccCTccCCCctCCCTcTccCtTcccCTccTcctCCtTccCCcTCTcTTCcTTcTTcCCCCtctcctTcCcTtc	8>CDCGDGDDCDGGGCDGGGGGGGDDGAADBBGDDGDDDGFCDHCDC<DFCCCDGBCDCDBGDDDFCGB@CGFCCCCFCCFC@HCCHFCCCC>FCFCFFCCFF>FFCCCBC>CDABGFBB7DA@	C	79	T	45	43	34	36	11	0.02197
1	243328208	G	346	GGGGGGGgggGgGggGgggGGGGGggggGGGGGGGGgGgGGGGGGggGGgggGGGGGGGGGGggggGGGGGggGGgGGGGgGGGGGGgGGggGgGGAgGGggGGGGAGGgGAGGgggGggGgGggAGGgggggAGGGgGGgAGgggGGGGGGGgGGGGGGgGAGgGgGGggggGAggggGgggGGgggGAAggGggggGGggggGGGGggggggggggGAGGGGGGggggGGggggGGggGGGAGggGgGGAgGGAgAGGGGGggAGgggAGgggggggGGGggGgGAgggggAgGgggAGggGAggggGgggggGGgAGGgGgGGggggGGGAggGGGgAAggag	D@@?AAACCBCCGCCGCCCFDFGGCCCCFGGGGGGGCDCFGGGFGCCGGCCCFGGGGFHHHH?CCCGGGGGCCGGCGGDGCGGGFFGCGGDCDCFGFDGGCCGGGFFFFDGFFGDDCGDDGDBDDFGGDDDDDEGGGCFGDFCCDDGFGGGEFCGGGGGFDF@FDFDGFDDDDGDDDDDFDDDF?D9DGFEDDFDDD?FFDDD?FFFFDDDDDDDDDDGEFFFFFFDDDDFFDDDDFEDDFFFDFC>FDFFEDFFEDBFFFFFDDEFDDCEFDDDDDDDFFFDDFDFEDDDACECFDECDEDDFEDDDDEDDDDCFE?FFGCD@CD>>>?BCBA=<?CC<A?AAD<	G	320	A	26	165	25	155	1	0.00000
1	243329049	G	271	GAGGgAggGGGGGGaaGAGggGGggGAAAGggGgGaaaaagagGGgGgaGgGgGGGGGGgGGGagGGAaGGGgagGGGgaagAAGgaGgGgggGGGGGgGAagagGGggagggGgaggGGGgaGGgggAgggGAGGGGaGGGgagaaGGggGgGGaAGGggggggGGAgggAGgggaggggggGGggggGaggggggggGgggggggggagGGgaGgagGgGGGGggGGaGggggGGGGGGgGGgGGGGgaGGGggGggGGGGGGgGaGGg	CCDD?@>AAAAAA?CCCBBBDFFGFFDEEFFFEEGEEFFEFFFFGFGFFGFGFGGGGFGFGGGFFGGFFGGFFFFGGGCFDFFEGFEGEGCFFGGGGGFGFFFEFGGGGGFFFGFFFFGGGFFGGFFFEGGFC>GGGFGGGGGGGGGGFDGFGGFGFGBGGGGGGGGFGGFFGGGGFGGGGFFGGGFGGGGGGGGGGGGFDGGGGGG:GGGFFGEFGG9FGFFFCGGFFGFGGGGFFFF;FGFFGFFFFGGFFEGFEGEFEEGDDBB?>CD	G	223	A	48	114	15	109	33	0.01635
1	247365430	A	88	gGaGAggGggaggggAgAAAAgaGaaAAaGAaAaaggaGagggaAaGgaAGgagAGAAaaggAAGAaAaggggaAaAaaaAgaAaggA	>BCEEDFGEBEFFFEFEGF?<EDGEEFFEFFEEFEEFFGFFGEEFFGGEFEFFEFGFF<FFFFDGFFEFFFFFEEDEFEFEGFEE>ED	A	50	G	38	24	10	26	28	0.04804
1	247419664	C	253	CtcttctCCtttttCtctttCCCttTTTcCTTctttcCCtcCTTCtctccTCttTCCtttcCtcccccCttctcTcctTcctcttTCcCccTCctTCTCTTtctTcTCCtctcTCctttctCTCtcCTtCcccCttcCCttcttctCCttccCTcCctcTCttCctCTttctCtcCtttccctccttttTtcccctCtttcTCcttctccccctcCcCTcCctCccctcctTccCtCCcTtccctctctctct	AA??BBA>5BAACBACCDCCCBAEEFDGDDGGDEEEDDCEDDGGDEDEDDGDBEFDDEEEDDEDDDDDDEEDEDGDDEGDDEDEEHDDDDDGDDDGDGDGGDEDGDGDDEDEDGDDEEEDDDGDFDD=EDDEDCFFECDFFEBFEEDD=FEEDGEDEF9GDFFDEADGFECFDEEDFFFE@EFEEFF@FGFEEEEFDEEFDD:AFFBFEEEEEFFCECFFCEFCE8EFEEFFEECF@CEFFBEEEEE@@=>=B	C	134	T	119	50	30	84	89	0.04287
1	248112554	T	364	TTTcttTTTtTTtTTtttttttttttTttTTTtttttttTTttTTTTTTTTttTttTTTtTTTTTTTtTTTtttTTTtTttTtTttTttttTttttTTtttTttttTttTtTTttttTTTttTtttTTttTTTttTttTttttTtTTtTTTttCTtTttttTTTCCTTttttTTCttTTCTttCTTTTTtTTtttttttTTTtttttTTTTttTTTtTCtTTTTCTTTTTTTTTTtttTtttTTTTtttTTtTTTTTtttTttttttttTTtttTTTCTTtTtTtttttTTtTTtttttTTTtTttTTTTttTtTttTttTTTtTtcCTTttCCtttttTCtTTCtttTTTtttCTTTttCCtt	CDBAC>@???BACCCDFEDDDDEDEEFEDGHGEEEEEEEGGEEGGGGGGG>EEGBEGGGEEEFGFGGEGDEDEEGGGDGEEGEHEEGEEEDEEDEEGGF9EG:CEEFEEGEGGFEFDG=?DEGE?DGGF;FGF<E<FFGE@EEGFGGFFGFDFCGDG9EFFGGGDDGFFEFEGGDEBGEBGEDDGGGGGFGFBBFFFFFFGGFFFFFEGGGEFE=EEFCBFGGGCFFFFGFFCFDFEAFFCDFFFFEEFFFFEFFFFDFFFEFEFFFFFFDF<FFFFCFFFFFEFDDDEFFFFFFDBEEFFFEEFF@FFFEFFEFEFEEEEFFEEFECEFEEDCAEDEDEBBCD=>A@CCD@??=ACCA9ACB@	T	345	C	19	166	17	179	2	0.00054
1	248112627	T	352	cccccccCCcccCCCTCCcCcCcccccCCcCCccccccCCCcCcccCCCCccCcCcccCccCCCccCctTCCccTTcccccCTcCCTcccCCCcccTCCCccTTccTCCTCTCTcCTccTccCCTctTCCTCCTCTCcccccccCCTCcccTccccTTCCCTccCtCcccccTTTTttcTCTCccctttcCCttccccTCttctcTtcTctCtcccTCTCcccccTTcccccCCTtccCCcccTtTCCCCCtcctCccCCctcTCcccTTcTtttTtCccccTtcCCcTcTTccCCccCcccTCccTcCTccCtcTCCCCCctCcccTtcccctTctcccCtcCCccCcctC	?ACA?C<B???AEEEDEFBEBDABBBBEFBFFBBBBBBFFCBCB7BBFFFBBFBGBBBGBB9G@B;GBGFFFBBFFBBBABEGBEFFBB9GEGBBBFGCFBBBFBBEGGFGFFFBGFBBFBBGFFBGFEGFFEFGFGBCBBBBBGEECBBB?CCCAFFF9FFACFFAC=ABCFFFEAHCFFFGCCCGHHCD>HHCCCCFFHHCHCEHCDCHEHC>CFGFFCCCCCFFCA=BC?G@HCCGFCBCFGDGCFFFFC>DGCCFFCGCDDCCBEECEHHDEDECACBEHBFECBCEEA@FDBCFCCCEE>?ECFECCEHCEEEEEECHECBCEHCCCBHDBGBABDD@BB>;A<<@C	C	263	T	89	101	56	162	33	0.00007
1	248112745	G	122	tgtTGTTgttgTgtTTtTGtttttttgggtttgTgttttggtttgttgTtgtgtgggtgtttgTTTTTtttTTgtTTTgggggtggtgTtgtgtttgttgggTTgTTTgtTTtgTTTTTTTg	?C@?<??ACC?@BCBBEEDGHHFFGGBBCGGGCFCGFFECCGGGCGGCFGCGCGCCCGCGBGCFFFEFGGGFFCGFEECCCCCGCCGCFGCGCGGGCHHDDCFEDEDFDGFFGDFFEEFFFD	T	81	G	41	34	2	47	39	0.00001
1	248112762	T	56	CCCCcCtcCtttttcttctCctctccctcctttCCCtCCCtcTCctTCCCCCCttt	BDDB?EHHEGGCGGGDGGGFGGGGGBGGGDGGGGFFGFFFFHFFGGFEFGGEFHHG	C	33	T	23	20	2	13	21	0.00008
1	248112763	G	54	AgaAgggggaggagAagagaagagggAAAgAAAgaGAagGAAAAAAgggAAAAa	DDDFFEDEFEFEEEGEEEFEEEEFEFHHHEHCHDEHHEFGHHHHHGGGFCC@?A	A	31	G	23	20	2	11	21	0.00005
1	248112771	C	70	ccccctcctcTtctctttcttcccTTTcTTctCTtcCTTTTTTcccTTTTtTTTttttttTtTttttTTt	CCA?BB;CDFEDFDEEDDFEDFFFCDEFEDFEGEEFGEEEEEDGGGADCCEDDCEFFFFFCBCAA@9@@C	T	48	C	22	24	2	24	20	0.00112
1	248138520	A	78	agagAggggAgAggGGaggAgaaggAaaAGggagAggAgggggAAGggggAGGagagaaGgaaAAAggAaGgAAAgaA	C@B<CACCFHEGFECCFFFHFFFFFHEFHCFFDFHFFHFGGFGGGCGGGGHCCGGGED=BHFGGGGGGGGADGGEB@?	G	43	A	35	8	19	35	16	0.00165
1	248167130	A	146	AAAAAAgAaAAAAagagAAAgaaAaaaaaggAAAgaAAaaagaaaAAAAAaAaAggAagAaaAaaaggagaAAaAAgAggAAAaAAaaaaaaaaAAaaaaaaaAaaaAAaaaaaAaAaaAAagAaaaAaAAaaaagaAaagaaaaa	CAAA@ACDEEFFFFCFCF<FCFFFFFFFFCCFF>CFFFFFFCF<FFFEFCFEFFDDFFCFGG?GGGDBGDGFEGFEDEDDFFFGFFFGGGGGGG;EFGGGGGGEGGGDEGGGHHEHEGHEEEBEGFGEGDEGGEFCFEFFB?@ADD	A	126	G	20	54	0	72	20	0.00007
1	248167137	G	144	GGGGgagaGGGaggGgggggaaGGGagGGgggaggGGGGGgGgGaaGgaGggGgggagagGgGGaGaaGGGgGGggggggggGGgggggggGgggGGgggggGgGggGGgaGgggGgGGgggagGggagggggGggGGgGgggg	@AAABECFG=GECCGACBCCFFGGECCGGCCCFDCGGGGGCGCGFFFCFFCCBCCCGDGDGDEFGFG?GGGCGGDDDDDDDDGGDDDDDDDFDDDBFDDDDDF>FC9FFDHFDD?FDFFDDDFCFCCDDCCDDD?BC;8A:?A:	G	126	A	18	50	0	76	18	0.00033
1	248224099	T	219	CTcctTTcctcccctTcTttctcTtctCTTCctTCcccCCCtccTTttcCcttTccTTtCCttTTtTTTcCCttcTTTTCtTTctcCtTctTCTccCtctTctcttTttcccTcttccTctcttcttTctccctccctttttCttctttttTtTtcccctctcTccTCttccttctcccccTtttttCccTtttCcctcTTtCTctcTctTcCCctTTc	ADC?C<?A?A?BCB@?DCDDFEFGDEDFFGGFDGGFFFGGGDFFAGEEFGFEEGFFGGEGGEEGGEGGEFGGEEFGGGGGEGGFDFFEHEDGGEFFGEF>GFEFEEGEEFFFGGFEF>FFE?EDFFEEGFGGGFGGGFFEEDGFFF<FFEFEEGDFFGGFGFGE5GEFFFGGFFGFGGFFGFFFGEFFGGFEFFFGFFGFFFFFAFFF@EFGCBB>A?D	T	120	C	99	46	23	74	76	0.01948
1	248224294	C	295	CttcTCtTCCTTTcCTTCcttCTTtTCTtCTCCcTCcTTCCTTCccTcttCctcTCcCCCcTCCCTTCCCCCTTCttCTTTtttCcCCTTCCTCCctttTTctCttCcccCTCtctCTCCcCcccCttcCTTTccCTTCCttccttCCtctccttcCtctCtCctttctCccCttcCCcctctctccCtcccctCCcCCCcccCCttccCCCtccCccCctCtCCctcTcCCccccTCtTTTtCCCCCCTTTtcctctcCCttCCTCttCtctcTCCttcTCTTTCttCTcctCC	D@B>@ABBE;CDCBFDCEBFGFDCFEGEGGEAGBEEBEEGGEEFBBEBGEFBGBEGBGGGBEGFGFDHGHEFFDGGFBEEEGFGGCGGEE?GEGGBHHHEDBHFGGGABAGEGHCHGEDGCG=CCFHHCGEEECCFDDGFHHCCHHGGHCHCCHHCGGCHG9GCHGHCHF=CFHHCGGCCHCGCHCCCHBCCBHFFCFFF>CCFFHDCCFFFHCBFCCF?HFIFFCHCDCDFCCCCDFHDCDGFFFFFDD@DHCCH=HCFFCHEEDDGHEGCGBDFGFDABBBA<>C<>A5;@C?	C	172	T	123	97	54	75	69	0.04445
1	248224398	A	269	AAgAagAAAAaGgaaAagGaAAagagGaaGaaagaAaagAGaAGGGaaaAAAagaagaAaaaaaGGagAaagAAggGaAAgagGAggAaAaaagaAgGGAgaAgaaAAggaagaAgaAAgAAAAgAAgAAAGGaaGagAAaaAaaAagaggaaaaggAggggaAAaaggAagaggAgaAgaaaAggAagaAaAAgAAagAaGAagAaagaAAaAAaaAaaaaAAaaAAagAAAAAagAGAAAgGGAaAaAAAaaaaaAAAaaaAAAAAa	BC??ABA<;>BBBFEFFEGEFFFFFFGE@GFFFFFFFFFFEEFGGDFFFDFEFFFFFEFDFFFFEFFFFFFFBFFFGFEEFFFGFFFFFFFFFFFEFGGFGG9GEGFF:GGDGGDGGFFGFFCFGFFGFFEFFGGGGGF:GGFGGEGGGEGFGFFGGEGGGGFFFGGGGEGGGFG>GDEGGGFECGDGGGEGDEGFEDGEGFEGGE9HGFEEGEEGGEGGGFEDGGEEGFEEEEEGGEFEEBGFEDGEGDDBGGGGGDDD>FEEBA??B	A	192	G	77	93	21	99	56	0.00165
1	248224451	T	221	tttttttTttttttTTttttTtttttTttttttTttTtttTtTTtTTttTtTTttTttttTTtTTttTttttTTttTTttTTTTTttTCTTTtCCTtTtTTtttttTTTttTTTTTTtTTttttttttTtTCttTttTTTTtTtCTCTttttTtCttTtTtttttttTttTtCTTTtTCtCtTttTttTCTTtCTTTCCTttTtTTTCttTtttCTTttTT	ACA??BB@CDECCEDEGGFG?F@GFFFGGGGGGFGGAGGGDGEFGDEGGFGFFGGEGGGEGGGFFGGEGGGGFEGGFFGGFFFFFGEFGEFFHFFFFFHFFHHHHHFFFGBFE<FEEHFFHHHGGGHFFH@FHHF;DEFFEHFHG>FFHGCHEHFHHEHEHHHHHCHEHHEHFEDEHEEHFHEGHEHHEFEEHF7EEEEEHCEFDEEEHFDDGFCDDDECB	T	205	C	16	86	16	119	0	0.00000
1	248224489	A	193	GAaAaAAAaaaaaAAAaaaAAAAAAaAAaaagaaaaAaAGaaAaaAAAAaaGAGGaaaaAaGaaAaAaaagaaaAaaAaGAAAaAGaGaAaaAaaAGAAaGAAAGGAaaAaAAAGaaAaaaGAGaaGAAaAAAaaAAAaAAAGGGGaGaaaGAaAAAAAaaGaGAAAGAaaaGAaaaAaAaAAaAaAaAGGGa	>ECA@>A>B<BABCBC5C=DDAHGGDHHCDDFDDDDHDHCDDIDDF9GHDDCH<CDDCDGEBDDHDGEDDFDDCGEEHCCHHHEHCDCEHEEHEEHCHHDCHHHCCHEEHEHCHCEDHDEECHCECCHHEHFGEEGGGEGGGCBBBEBEED@GFGGGGGEEB>AGGG;GEEEBGEEEAEFEGH<@@D:BCCCA	A	161	G	32	77	30	84	2	0.00000
1	248224618	C	161	GgCCgcgcccCCgcCCccggCcgCCCCggccCCcCccgccgccgccccccCcCCCcCCCCcCCCCCCCcccCccCcccCcCCCcCccCcCCCCccCCccCccccCcccCcCcCCCCccCcccccCcccCCcCcCccCCcccccCCcCCCCcCCcCccCcCc	@A:>>CA=CCBBGFFGFECAGFEEGGFFFFFFFFFFFCFFFFCFFFFFFFGFGGGFEFFFFGGGGGCGFFGGFG7GGFFGGG7GGGGFFFFFAGGGFGGFFFGGGGGFEGFGEFEDGGFGGFGGFGGGEEGDGEGGFEGGGFGFEGEDEFDCDCCB@A<?E	C	148	G	13	70	1	78	12	0.00683
1	248224754	T	104	tttCTtttcCctTtcCcCTtTTCcCCtccttTCctCCtcttTtTttCtTCCTtTctCCtccCCttCttcCTCttCtcttctTttttcCtctttCtcCTcCCCTc	BBCCGEEDFCFDHEFDF:GEGGBFDDEFFEEGEFEDEEFEE=EGEEDEEDDGFGCEDCEGGDDFFDFFGDG7FEDFDFFFFB@FFFFCGGFFFCEFCFGDBADD	T	57	C	47	15	27	42	20	0.00240
1	248604881	A	88	ttaAAatAaaaAAttaAttaaAAatAatatttaaattttAaaattaaaAAtaatttAtaAaaAAAaAAAAaAaAaaAaaAAaaAAaat	??AABDEEDEEFFEEEEDEE?EFEEFEEEEEEEEEEEEEFDBBEFFEFEFEEFFFFEEFFEFEFEEFBEDFE5EFFE@DEECECD@A@	A	64	T	24	28	0	36	24	0.00002
1	248605183	C	79	GcgcCcccCgcCCcgCcgccCCCcgcggCggccCCCCCcCccCCCcCCcCCCcccCcCCccCccCCCCCcCCCcCccCc	BCC?>:::?A?EEBCFBCBBG?FBCBCC<CCBBFCFFG?FCCFFFCGGBGFFBCAFCADCCECDFFFEEAFEEBEC?B=	C	69	G	10	37	1	32	9	0.01499
1	248637367	A	95	aAaAaaAaaaaAaAaaAaaAAAAaAAAAaaaaaaaaAaAaaaAaaAaaAaaaaAAaaAaAGaAGAGGGGAGGGGGGAAGGGGGGGGGaAAAGGGG	AAAECDCEEEECEHEEBEDHEHAEHHHHFFFFFFFFGFGFFFGFFGFFGEFFFGBFFAFGAFGAGAABAGBBABABHH?=@@@@@??@CCD:>CC	A	70	G	25	31	25	39	0	0.00000
1	248637416	G	220	gggGgGgggGggGggGggggGGggGgGGgGGGGGGGGGGGGGGGGGGGGGGGGGGgGGGGGGGGGCgCGGgGGCGCGGGCGCGGCGGCGGGGGGgGGGCGGCGGcCCCGGGGGgGGCGGGGgCGGGggGGCGgGGGGggGGgggGCGgCCCCggGGGGGggCGGCGggGgCGGGgGCGGggGGggggGGGgggCcggGGGGGgGCGGGGcGGggGgGGGG	?FEHEHFEEHFEGFEIFFFFHHEF;EHHGHCHGDHEHCHHGHHHHHGGGGGGHEHFHHHHHEHGHGGGHHFHHEHGHHHGHGHHGHHGGHHGHFGCGHGFGFGGFFFFGCFGGGHGFFGGGGCGGGFGGGFGEGGGGGFGGG7FGFGFFFFFGEGGGGGGF=GFFGGGGGFGGGFGFGGGFGGDFFFGGGFFGEGFFGGFFGBFDEFEFBDDAAC@AA@?	G	190	C	30	133	27	57	3	0.02602
1	248637417	C	224	ccCcCcccCccCccCccccCCccCcCCcCCCCCCCCCCCCCCCCCCCCCCCCCCcCCCCCCCCCTcTCCcCCTCTCCCTCTCCTCCTCCCCCCcCCCTCCTCCtcTTTCCCCCcCCTCCCCcTCCCccCCTCcCCCCccCCcccCTCcTTTTccCCCCCccTCCTCccCcTCCCcCTCCccCCccccCCCcccTtccCCCCCcCTCCCCtCCccCcCCCCCCCT	GFFFGFEFFFFGFFFFFFF??FGAEFFFFGGGFGFGGGEFGGGFE7GFFFFD6GGGGFGFFEFFGGGFFGGGGFGGGGGFGFFGFFFGFFEFFFFEGGEGGFDFGFFGF8DFFGFEFEEFEGFFFEGGFEEFHFFFDGFF?GDGFFEGFFFFGGEEFFEG;CEDFEGGFG@FDEGEFEFGGEEFGGFFEEGGFFFGFFFDDEAGGFGEFDCCBBAA>>AACAAC	C	193	T	31	136	28	57	3	0.02697
1	248651927	A	117	AAAAaAAAAaAAAAAAGAGGAGAAGAGGAGGGAAAGGAGaAAGaGAAAaGGGAGGGaAGAGAGGAGaGGAGAaGGaAaaAGaaAAAaaAaGaaAAaAGAAAaGaAaaaaaGAaGAGa	FFFFFECFFFFFFFFFFEGGFGFFGEFAFFFGFFFGGFGC?FGGFEEFGGFGDFFEGEFE=DAFEF?FFE9EFEFGEGGEFFEEEEGGEGFGDEDGDFDEDFFFCDCDAABB=C?CD	A	79	G	38	51	38	28	0	0.00000
1	248652023	G	169	GgggggGGgGGGgGGGgagGGGgggAGGGGgGGAGagggGAggGgaGGGAAGAGGgggGAGgaGggGGAgaAAggGGAggaAggaAgaGgggggGGGggagGgggggGGGggggGAGGGggggggagggggggaggggggggggggggggggggggggggggggggggg	BCC?BB>=BBAADCDCFEF@EDEEDCEEEEEEEFEDFFFEFFFEFDEEEFFEFDEFFFEBEDDEFFEEFFBFFFFECFFFDFFF:FECECFDFFEEEGGDFEFFFF7EEEFFFFE8BEEGFFFCFEFFGG9GGEGGGFGGGG@GGGGGGGGHFGGGFGGGGGGFF??A?	G	144	A	25	46	14	98	11	0.02478
1	248813827	T	47	CcTccTTccccccccTTTTTTTtTTTTttTtTTTTTtTTTtTTTTtt	AAGGGGGGGHGHHH;GGFFFFEEFFFFEEFBEFFFFEDEEEFGFFC?	T	35	C	12	27	1	8	11	0.00004
1	248813972	G	52	GgGGAgGGggGgAGggAAGggAgGGGAAGAAGGGGGGGGGGGGGGAAAGGAA	EBGGFCFFCC5?EFDDFEFDCFDGGGEEFEECFFFFFFFFFFFFEDDDFEBA	G	38	A	14	28	14	10	0	0.04586
2	15448311	A	73	ATAATTTTTaATAAAATTAAATTATTATATATATAATtTAtATTaTTaATTTAAaaaaTAtaAAAAATTaaaa	EGFFGGDGGGFGFE?EGFFFFFGEGGFEEGFGEGBEFFDEEEFFHFFGEFFFEEGGFGFEEDEEEEEFEDB=B	A	41	T	32	29	29	12	3	0.04462
2	44010620	G	63	GAGGgGgAgGgAgAaAGAgGgGaggGgAAAGGGGgGaAGgAAgGAGgggAgAggagAggaGgg	CAAEFGFFFGFDFFFFGFGAGGGFGGGFFFGGFGGGGFFCDEGFEFGGGEEEEGGGEEGGE@A	G	42	A	21	18	16	24	5	0.01636
2	47233720	G	85	GGTGTgTTGTgGGGggTGGGTGTGGTTGGGGgGGTTGTGGgTGGTGGgTGGTGGTTGTgGGTTtTGGTGGGGTGggGTgGgggGG	HHEHEEEDHEEGHHFFEHGHEHEHHEEGGHHFHGEDG:FGGDGGDGGEDGGDGGCDGDGGGDDFDDGCGGCFCGFFFB6D>>>C?	G	58	T	27	44	26	14	1	0.02992
2	48925746	C	43	CCTCCTCCcCTCCccTCCTCcTCcCcTcCTTcCTTTTTccccC	DE>GGEGGG;EGGGFEFDEFGDFDFFDGFDCGFDDDDDGG=BC	C	29	T	14	17	14	12	0	0.00389
2	87131063	G	108	GgGGGGGGgGGGgGGGGGGggGGggggGGGGGGGgGgGCGCggggGgGGGGgggCgGGggGGggCCggGGGGGCGCGgggggCGGGggGCGCgGgGgCGGggGggggg	AB@DDHHHFHHHFHCHH9IFDGGDGFGGHGHBHHFHGHGGGGGEGFFHHHFGGGFGFGGBHFGGFFGGGGGGGGGEGGGGGGFGGGGGGFGFEGGGAFFGGEGGCCAB	G	97	C	11	54	11	43	0	0.00297
2	87355912	C	196	CCcCCCCCCCcccCCCTCCCTCCCCCccCcTCCCcCcCCCcCcCcCCCCcCcTcCcTCccCcTCCccccCCCCcTCcCCcccCcCCCTccCTTCCcCCTTCCTcTCCTCCccCCccCcccTTTccTCccTccCCCcCCCCccCCTccTcTCCcccCcccCCCCCcccCcCCcCTTCcTcccCCcccccctcccttc	DB>EFF5GGGBAAGG@EGGGEGGGGGBBGBEGGGBFAGFGBEBEBDGEGBEBEAGBBGB@GBEGGABBC>GGGCEGCGGCCBGCGGDDCCGEEGGCGGEEEGDCEG:EFGABGFCAFCCCDDDCCDFCCDACGFFCFFFFACFFCCCDCDDFCC@FCCCFCFFFCCCFCFFCFDDC@:@CCFEBCAA7?B<58@A@	C	167	T	29	90	26	77	3	0.00018
2	87414330	T	82	TTTTTTTTtTTTTtTTtTTttTTttCTCtTCTTtttTTTtTCTttttCCTTTttCTttTtCtCtCttTTTTttTCtTTttTc	D@EEGGFGEGGGGEGGDGGDEGGDE@ADEGDGFFFFGGGFGDGFFFEDDFDFFFCFFFFFCFCF?@GFFFFFFFCFFFEEDB	T	70	C	12	40	11	30	1	0.02554
2	88013719	G	70	gggaGaGgagGagaGGGGGggGGagGGgaaGGaGGagaGGgGgggggGGGGgGggGggGGgGGgGGgGGg	>AACBFCFDFCFFF6CCC@FF?>5FCCGGGCBGCBGFG@BGBGGEGGBABBGBGGBD:BBGBAGB?B==@	G	59	A	11	33	0	26	11	0.00048
2	91809324	C	346	CCTCctCCTTCCcCTTTtTCTTtCCTCCCtcCTTCcCccCTCctTctttCCCTTCTCCtCCTtTCtTCTctCTCttctccTCcCCCcTCCcCCCCCtcCTtTCCccccCctCcCCctcCtttccctCTCCTCcCTCCCCCtcCCCCCtTCCtccccCCCCTTcCCCTCCCCTCCtctCTTCccTCtccttctTCCccCCCccCCCccttTCCCCtccttCTCTCCctctcCccTtttcCCCCtcCcccCCCcccccCCTcccCCCCCCCCCccCcCccCCccccCCCCccccCCCctcCcCTctcctcccTCCCCccCtccCtCCctcttCCcTCCTttCcCtccc	DD@9:BA@;@<B@CCCDFGGGEFGGGGEGGBGGFBBGB9GGGBGGBGGGAGGGGFGDFGDDGGGEGGGGBGGG9GGBGBBGGBGGE@GGGCGGEEGGBDGHGGGABCAG9HGAGGCHCGHHHCBCHDBGGGGCGEGGGGG<CGGGFDHGGFHBBCBAGEGGDAA:G<=GGGGCGHCHG@EFCCGGHCAHHCHFEGCBFFFCCGGFCCHHGEGEGACCEGGFFEFFCHCHCFCCFHHHCAFEFHCFCCCFFFCCC8CF;FCCCFFDFFFFCFBCFBFCBFFCCCCFDFFCCCCFBFCHBFCFFCDCCHBCCFFFFFCCFHCCFHFECHCHFFFACCCECB<;CC@;A	C	245	T	101	146	47	99	54	0.03199
2	91809456	T	158	tggttTtTtTtTggtttttttGTttttTTGttttGTttttttTTttgGgtTtttGttttGTgTtTtGtGGtgTTtTgtGTtttTTtTTTtGTTtttGtGGttTTTTTTttTTTTttTTttTTttttttttttttttttttTtttTtttttttTttttt	?@@CCEDEEFEFFFEEEEEEEEFEEEEFFEEEEEAEEEDEEEFFEEFEFEEEEE?EEE=EFDEDFEEEDCEFFFEE:FEF:FFFBFEEFFDFFEFEDEEEEFFFFFFFFFFFFFFFFEFFFEFDFFFDEEFFFFFAFFFCEFFFEFFFFFF>DBB?>C	T	135	G	23	42	14	93	9	0.00882
2	91872634	C	104	ccCCCTcCtcCCCTCTCccTCCCcTCCCCTCCCccTcCCTcTTTCCCcTTCTTCCccCcccccTTCTcCCTCTTCcTcCTCCcCCcCCCcccCCcCCCccCccC	AB?>>GD?DCDDAG@GDDDGDDDDGD>DDF?DDDBGDDAGDGGFDDDEGFDGGCDEEDAEEEBGGDFDD@GDFGDEFDDGDCECCDCDCEEECCECCCEEC9?@	C	80	T	24	48	23	32	1	0.00079
2	91872635	C	106	ccCCCTcCtcCCCTCTCccTCCCcTCCCCTCCCccTcCCTcTTcTCCCcTTCTTCCccCcccccTTCTcCCTCTTCcTcCTCCcCCcCCCcccCCcCCCccCccCc	?C>==EB5FBDDDEDEDBBEDCDBEDDCDEDDDBBEBDDECEE=EDDDCEEDEEDCCCDACCC;EEDDBD@ECEEDCCCCDCCCCC?CCCCACCC>CCCCCCA?A@	C	82	T	24	48	23	34	1	0.00038
2	91925022	C	49	AAAAACACACcAACAAACCCaCCaaCCcCaCCCaaCCacaCCCCCCCac	DDFFFF=GFEGFFGFDFFFGEFFBDCFGFEEFEFEEFEH@FED>F>@@E	C	28	A	21	24	12	4	9	0.04761
2	91925139	C	103	CgCCCCCgCCCCCccCCggCCcCCCccCcCCCCcCCcCccccgcCgcCccccCCcCCcCCcccCcCCcccgCcccCcCccccccCCcccccccccCccccccc	BBBBFD@FGFFGEFFGEFFGGFGDFEFGF@GGFFGE;FFGGG>FG7FGGFGGFFFGEGGGGGGGGGFGGFFGFGFGGGFFGFGGFEGGGHGGGGFFFGGFG?A	C	96	G	7	43	0	53	7	0.03958
2	96555522	C	58	CACCCCCCCCCAACAcCCACCAAAAcAAcccaCAAcAAACcCCAAcAcACCCAACACA	ADDDDDDDDDDHHDHGDDHDCHGGCGGGFGGGCGEGGGGCGCCGCGGGFBBBDC@BA?	C	33	A	25	24	24	9	1	0.03255
2	112615933	T	118	TtTttTTTTTTTttTTTtTttTTTTtTtTTTtTTtTtttTtttTtTCttTttttTTtTttttCTCTttTttcCttTttCtttCTCcttTttctTtCTtttttCttcCTtttttTtttt	DC?AAA@BADBBD9GEFDGD7GGFEDGDHHGDEGDFDDDGEADFDFGE?GEEDEFGEFEEEDGEGGDEGEEHGEEGEEFEDEFFFHEE;EEGEFEFFEEEEEFEEHFFEEDDEFDEEC	T	104	C	14	41	10	63	4	0.04120
2	128339456	G	73	TTtTGTTGGTGTTtGGGGGTGTTTTTGGtGGTTGTtTtGGGGTtGTTTGtTTTGTGGTGGgtTTGGtTTGTGG	>DEEGEEHEEHBEEHHHHHEHEEEEEHHEGGDDHEFDFGGGGDFGDDCGFDDDGDGCDGGGFDDGFA@@C6CC	T	41	G	32	32	31	9	1	0.03568
2	128890880	C	146	GGGGGgggCCCcccCcccCCcCccCccccCccCCcccCcCCCccccCCcCcccccCCccccCcccccCcCcccCcCcCCcCccccCccccCcccCCccccccccCccctcccccccccccccccccCCCccCcccccccccccccc	B<===@@ABABAAAB5DCFCCFDDFDDDDFDDGFDDDGDFFFDDDDEEDGDDDDDFFDDDDDDDDDDGCGDDDGDFDGEDFEEED?EEDEFEECEEAEDEEEDEFEED7DE<EEEEEEEEEEDEDDDEFEEDEEEEDEEDCDC@=B	C	137	G	8	37	5	100	3	0.04543
2	131936169	C	34	cCcccccCTCTcccTcCTCCTcCCcTcTCcCCCc	C?ABABBGEFEBBBEBGEGGECDECE=EGADGFB	C	27	T	7	12	7	15	0	0.01056
2	159312776	G	44	TGTTTGTTTGGGGTGGGtttTtGTtTGttTGGTGtGGTGgtgGG	DEFGGGGFG=GGFGGGGE6FFFFFFFFB?CFF@FFFFFFGFGE?	T	23	G	21	14	19	9	2	0.03649
2	165793968	G	71	AgaAGgaagAGagAAgAaaagggggaggagggagAggaAaggaaaAgGgaAagggagagaaAagagggaaa	EADE?BDFBGAFCHGBHEFFCCCCCFCCFCCCFCIBCFHFCCFFFHDCDGGGCDDGCGAGGGGDGDDDFGA	A	37	G	34	11	3	26	31	0.03700
2	179325735	C	128	CCCTTTTCTTTCCCTTTTTCTTtcCTcCTTTCcCCTCcCTCtCCTCTTTttCtTtCCTttCttCtCtctctctttCCTTCcTTTTTTCTCcCtTCTTTtcCctCCcCCtCtCCttttTttCctttTCt	<CDD?EDGEEEEGGECEEEGFEGBGEAGEEEFBG@EGBGEGHEGDGDEEHHGHEHGGCGHGHHEHGHCFCCCHHHDGDDF5DDADDD=DFCFGDFCCDHCFCHFFCFFHFFF<FH<HCGGFADCAACE	T	73	C	55	41	42	32	13	0.02451
2	179614004	C	120	aaaCcAAACCACCaACaCCACaaACACCCAcCAAACCAAAACaCAACCaCCAcAAAaacACACACaaaAAaaCCAccACAAaCCAACaACcaCCaaCCaAACcAaCCACAAAaACAcCaA	CCGEF:FFFFFGFFFGF5FFGFGFEFFGFEGECFFGGFEFFGEGFFGFGFGAGFDEGGBE?EGEEGGGBDG?EEEGGEFEEEEFEEEGE<EGFEGGF>GD6DGEGFD>EDECCBBBAA??	A	69	C	51	44	42	25	9	0.03956
2	191064753	C	102	ttcCTtCctTcctCtctCttCcTttCCCcCCtctTTtCtTtTttCCTctcctTCcCCccCCcTCCTtTtcTccttCCTCcCtCCcCCTtcCCCCcCtcCcCc	CBBBCCFFDGFEDGCFEGEBGFGEDGGGFEG=FEDEFGEGDGFFGGGG@GGEFGGEFDGFFGGFFFFFCGGGGFEFDFFGFF?FGFFFFFFFFFGFDCBBCC	C	60	T	42	35	15	25	27	0.02842
2	204824200	T	56	TCCtTCTCTCCCTCCTTCCTTTTCCTTCTCTTCTTTcCTCTcTcccTTTTTTTTcT	EGEGGFFEFCBFFAFFEGFFFFFFFEEFDFEEDEEECFEFECECCCEDDDEADC=?	T	32	C	24	31	18	1	6	0.03458
2	218758123	G	63	GgGGGGGGGGGGGGGGGGGGGGGGGGGGGGgGGGgGGGGGGGggGGGaagaAgGgGGaAGaGG	@ECC@CCBC@CCCCC@CCCCC;CCCCAB=B>BBCBB?BBB>BGFBBBFF<EFE?D>8;@=>CC	G	56	A	7	48	2	8	5	0.00301
2	218940259	C	37	ccttTcccTCTTctCcttCccctTTtccCTTccTTcT	BCABFGFFGDGGGDDGDCD<GHEFGEHHCFF;HFEDA	C	19	T	18	4	11	15	7	0.02011
2	219305404	G	51	GGCGgGCCGCGCGGGGGGGGGGGCGGGCgGGgCgggCCCGGgCgGCggCGg	EBGHFH?GHFHGHHHHHHHHHHGGGCGFFG;GFGGFFFF8GEEAFGEBBCB	G	37	C	14	26	14	11	0	0.02323
2	219890979	T	30	TTcccTctcctttcccctcctcctctcttT	DFB:AGBGBBFHH;CC8HBCGCAH7H?ABC	C	16	T	14	0	4	16	10	0.03653
2	219895548	C	182	CCcaccaaAcaaCACaCaaAcacCCCCCccacCCacACCCccaccAaaCcaaCCCaCaAACCaCAAaaACaCacCCaCaaAcacacacCCcccccaccCaCaccaAAaaacaaacaCaccAacAcccaaccCcacaaaacCAcacccccacaccccccaaccaaccaaccaaacaccacaca	DBCC?CCD;8CDBABDEFFEAEBEGFEFABFBGFFB@FFFBBFBBFFDGBFFGEGFEFF?GFFGEFEFFFFGFBGGFFFGFBF<FBDBGFBCCACGCCFFGGCAGFFGGGCGFGCGFFCCFGBFBCCGGC?GC7BGFGGCFEBFCCC;AD;EDCC@CCGH7CGG;CGGCAFGFCFBBD@?;D	C	101	A	81	35	16	66	65	0.03108
2	220315970	G	79	agaaaGGGGaAGaagaAGGaggggagaGaaaagAaggggggaAGGGGGGgAgaGagagggGaaagaaggggagaagaga	?ABDBCEEGEFGFFFFCBGFFFFFFFFGFFFEFFFFFFFDFEBGGFGGGFFFGGGGFGGGFGFGGFGGGGGGGEEGF<F	G	44	A	35	16	5	28	30	0.03970
2	220336723	C	98	ccCTttcCtttttctcctttctctTtccTCtTCCCCtctCTCtttcctCCcctccctcccttctttcctcttCCCtctctcccctCCtcCcCtccttc	CA>>B:@?C>CB>BCCDCDEDED5GDDDGDDGDDD8?DEDGDEEEDDEDDDDED?DEDDD5EEEEEEEFAFFDDCFEFEFEDEEDDDEECECFEFFFD	C	54	T	44	18	5	36	39	0.01567
2	220420785	G	218	AaGGAgAaGAAAgGgaaGAGaAaaaAGGgAAaAAAGaAAGAAGAAAGAGgGAAAggGAAGAAaGAAGGagGGAagAGAGgAagAGGGGgAGaaAAaAGGaGGaAggagAAaGAGGGgGgAAaaaaaaAGgAAGgGAAAaaaGGaaaaAaaaagAaaAaGaGaaGGgagaGGaaGgGGGagGaGGGgggaGGAGGGgaaggaaAAggGAgaggaaaAaa	EC><BA:A>EECC?FDFAH;DEEDEGC@EDHEHHHCEHHBHHCHGHCHCFCHHHCFCGH7HGE>CDCCEEBCBEFHB5CFHFFHCCC=GHBFDEHBGCBFBCFGGGDFHHFCHC@CFCFCH@EFFCFHCGHG9GCHGG7BEBC;FEFGEFBCGGFFGFBFBF6@BGFFFBBFFBGBBBF<BFBBBFGCFBBGBBB@FAFDFEFGFDBHEC<DAA?CBB	A	121	G	97	60	62	61	35	0.03982
2	227873028	A	97	AgaaaAAggggAaagagaaggagAgGaaAaagGaagggggaAagAgggaAAgGggaAgAgAaAgGgaaaaAgaaaaAaaagAagaAaaagaggaaaa	C??CCC:>BBCFFFCFCFF<CFCBCGFFFFFCGFFCCCCCFEF>FCCDF@FCFDDGFDEDFGFDGDGEGGFDGGGGEFGGDEGDGEGBGDF@DGFFC	A	59	G	38	18	4	41	34	0.02599
2	231065722	A	37	tttAttAAttAAaAAatAAttaAtaaAataaaaaAaa	BCDHDEGHEEHHEHHDEHHFFFHFBFFFFFFFDFG>?	A	25	T	12	12	0	13	12	0.00309
2	233272146	G	87	cGCGccccGggcCcGGCCccGcccccgggcccGgccggCcccggcgcCgGGcccgcCGcGGGggggGccccCCGcCccGCGgCcGGG	A?BC@GFGEEFGGGGGGGGGGGGGGGFFDGGGGEGGFFG?EEGFGGHGGGGHHFGGGGHGFGGGGGGGGHHFFFHFHGFFFEFGFF?	C	49	G	38	12	20	37	18	0.01305
2	242610773	T	133	AAaTaaAATAaATATTattATAATTTTTTTatATTAAaaATAATtTAaAATTAATaaAAaTAtTAaaTTTTAtAAAAATTTTAaaTTTtaaatAaaattaTATtTaTAtAAaaaTtAAATaAaaTTTAtATaT	AEBDFFHHFHFEHHGGFFGHGHHGGGGGGGGGHGGHGGG@GHHGHFHGHGGGHHGFGFFGGEAFHFGFFFFGHGGGGGEFFFGGGFEFHEGGDGHGGHHGFGFHFGFGHGGFFFFHFFFCF<FEDEDE<BD?@	A	74	T	59	43	45	31	14	0.04187
3	3887093	A	138	agAGAGgaAggggggaAAGAGagGagagGGggagGgagAagaggGggAGgGaAgAAGgAGGagaagaAAAgagGAAAgGgaaAGaGGGAaagaaGAggAAgAgAAgaGGagAagAAAGgAaAAAAGaggGgagAagAg	AC?@?@AA?CBCFGEDDFGDGEFGEEEEGGEFDEGFDEFB6EEEGFDFFCFEFDFEGFFGGFGFEGCFFFFFEGFEFAGGEEEGEGGGFEF=F@FEEEFDGEFDEFFFEGGE=GEEEFGEFECEDFEFGEEBBB=BBD	G	71	A	67	26	37	45	30	0.03990
3	9547950	G	50	cCgGggcgccgGcGccGgccgGggcCccgcGGccGcgcgcgggGGcgggc	A>FBEECFDDFCDCDDCEBDECEFEDDECEBCBDCEGEFDFGGBBEFBB@	G	28	C	22	10	2	18	20	0.04472
3	9547959	C	45	ctcCtCttCcttcCCccctTttctCCttCtctctcccCCtccctc	CC:>?CHGDAFGBDEBBBGGGGBHDDHHDHCHCHCCCCCHBBCHB	C	27	T	18	10	1	17	17	0.03065
3	10091035	T	130	TTTTTTTCTTTCTtTTTTTTTTttTTTTTTTTtCTTTTTTttCttCCTTTTTCCCTTCTTCTTtCtTTTTtTTTCTTCCTTTttCCtCCTCTTtCTTTttTTTTTTTTtTTTCCCttCCCCTCTTCTtTt	B@>?EEDGEFEGEEEDEEDEE;EFBECECDEEFGEEEE;;FEGFFGGDEEEEGGGDDDDEADDFFFDDD9FDDDFDCFFDDDEFFFFFFDFDDFFDCCDFDCDDDDDDFCDCEFEDEEFEGEFCCBA?>C	T	100	C	30	78	30	22	0	0.00209
3	11925489	C	63	TCCtCCcCCCCCCCCtCCCcCcttcCCCtCctCCCCCccccCCccCCCCccCccCCcccccCc	BBBCDFCGGFGGGGFGFGGBGBGGAHGBHGCHGGGFGCCCCEG@CGFFFCCFCCFFCCCCAB;	C	56	T	7	35	1	21	6	0.03595
3	32032397	G	106	ttgtTgtGTggGTTgTTGgGGTGttGGtGTtGtGTtttTttGtTGGTtGtttGGgGttGttTtGggTgtgGTGggTgtGtgGttgGtTTGTgtTttGGgtGGGttt	AC?ABCC?CCE?GGFGGCFCCGCEECCECHE=<CGDEEGDECEGCCGFBEFFCCGCFC;FFGFC=FGGFEBFAGFFGFBFF@FFFBFFFBFDFEFFBAFE???AAB	T	57	G	49	20	31	37	18	0.00610
3	37107022	C	81	AaAAAAACCCCCACCCCAACACAAAcCCCCCACCCACACCCAACACCACACAaCCAAACacCCaCCaCaCaACAAaACACC	FD;EFCFGCGGGFFGG7FFC7GFEEHGFFFFEFFFEFEFCFDEFEFFDFEFEEAF7DEFDGFFCDCAA@B=?>BB=CAA??	C	43	A	38	41	30	2	8	0.03992
3	46965111	C	84	tTcttTTtTTtCttcctTcCccttcTCctTCCcCccCTctctTCccTTCccTTtttTTtTcTTctttTctcccctCtTtcTcTc	B9?D@AEHFGFGGGBBGGBGBBGGBEGBGG>GBGBBGGB=CHFFACFGGCCGG=AHFFGFCFDCAHGFCHCCCC?FCEHCGBC7	T	47	C	37	23	10	24	27	0.04658
3	49721533	G	88	GGGGGgGGGggggGGCgGGgGGGgGCgGgggGggggGgggGGgggGGggCggGGGCGGGggGgCggGCGGGGggGGggggggGggggg	D@FGDBGEGCCCCA@GCGGCHGECGGCECCCECDDDGDCDEGDCDEGDDFDDEFD=DFFDDFD?BDFEFFD<DDFDDCDDC@>DDB;<	G	82	C	6	38	6	44	0	0.02605
3	49721561	A	78	AaACaAaaaAaaaaAaaaAAaaaAAaaCaaAAACAAAaaAaCaaACAAAAaaAAaaaaaaAaaaaaCaAAaaaaAaaa	:EDFFEEFFDFFFFEFEEEFEFEEEGEGDFEEDFECEGEEGGGFCD?EEEGG?EFFGGGG?GGGGGFGDCGGGGDGD>	A	72	C	6	27	6	45	0	0.00431
3	49723174	A	147	AaaaaAAAaaAaaaAaaaAaaAAaAAAaAaAaaaAaaaAAaaaAAaaaaaAAaAaAaaAAaAaaAAAAaaAAAaaaAaaaaaaaAaaaaaaaaaAGGAGaaaAGaaaaaaaGGaaaaaaaaaAaGaaaaAaaaaaaaAGAaaGGaGa	ACC>>A>?B<ACCC<CEDECD5EDFFFDFDFDDDBCDDFFDDDFFDDDDCFFDFCFED9FDFEDFEEFCEEFFEEAFEEECE=EFDDD<BDDEEFDDEDEECFDEEEEE<CCDEDEEFCCD:EEDAEFCEEEEDEEDECEAABA=@=	A	136	G	11	42	11	94	0	0.00001
3	52860936	C	205	TCcTCTCtcTCttCcTtCTCccttTCTttccTccCtctcCcTCCCTTTtccTctTCtctctcTtcttTCtcCCtctCcTTtcCTtcCCTTTCtCTCCccTTtTCcccTTctccCccCtCCCtctTTcTtcTctCTcTTctTcCccCtcTtcTccTtcTTcccttTTtcCccctTTtTCtCcctcctTTtctccTCCcTccccTcc	DDB=BBB@?DCCDFFGCGGGGGDDGGGD7GGGGGG@GDGEGFGGGGGGDGGGGDBG=GDGDGHCFDDGGDGFGDGDGBGGDGGFDGGGGGGGDGBGG;HGFEFGDFHFFHCHH<HGGEGGGEGEGDDFEAGHBGFHFEHDFHFGECCHC6IFH>FEHFFHH@EDFF5GFHHG>FFEFFEFHHECHEFG9>A5DCBBCCCB;>ABC	C	108	T	97	39	52	69	45	0.01650
3	61975382	T	68	cTcctCtTTcTcCcCCcCctccTcTCTCTTTCCCTcctTttCTTCtcTTTTtcTccCcTTTTTTtctt	CBGFDGDFFFCGFGGFGGGDGGFHEFFE=BFGFEBHHDBB?EEEFBHEEBE=HEHHFHEEEEEDEH;@	T	36	C	32	25	13	11	19	0.02716
3	62110291	C	34	cccGcGgCGcGgccCcccccccCCCccccccccc	A?;?CCBGEBECBBDABBBBBBGAECCCACCBCA	C	28	G	6	5	4	23	2	0.03051
3	64526717	G	61	GGGGGGGCCGgCGCCggCGCGCCcgCgCGCGGCgCgCCCCCCCgCGCGcGcCGggCggCGG	HHH;BAHGEHGFGGGCFGEFGEFFGGGFGGGBDEFGFFFFDFFDFGFGGGGFFGGFG>CBC	G	32	C	29	20	26	12	3	0.01806
3	64527465	C	57	CCTCCCCTTTtttCCTCtCCCTtTTTTCCCTCCCTCTCCtTTTtTtCCCTCTCTTTT	FFGGGGGFFGEDEGDGGEEFGGEFFFFFFFFFFFF=FFFCFFFEFEFFEEEEEEBCB	T	31	C	26	23	26	8	0	0.00572
3	64641150	C	48	GGGGCCGCCCGGCGCGCGGCGCCCCCCCGCCCgCCggGGCgCGCGGCg	DCEEF@EFDGEEGBEDFEDFEFEEECEFDFFF@DFGFCEFFCBA>@CA	C	25	G	23	25	18	0	5	0.01965
3	98217178	T	42	aattaaTtATttaAttttttAttTAAttAtTTATAtTtttAA	@BBBBEGEFGEEEFDDFEDBFEFGEDFFEFEFDDDBB<<>A?	T	27	A	15	7	10	20	5	0.02018
3	125695687	G	81	aGGGgGGGGGaGGGggGGGGgGGGGGaGaaGGggGgGgagGggGGGGgGGGGGGGGggGGGgGGgGgGggggggGGGGggg	C@D=GDEEEECEDAFFEEEEFEEEEDFEGF@EGFE:9GGGBGFE>EEGEEDDD?EDGGDEEGDDGDGCGGGGGGDDCCE8;	G	75	A	6	49	0	26	6	0.00279
3	148459395	C	185	ttCtTctcttTCCtttcCCcCcTttctttTCcttttttcCCttctCTttcCCtTCCccTtTctCcctTTtTCTtttCtTCCTTTCTTctcCTcCcccccCtttTttCtccccCtctcCccCTttctttTctcCttttttcccCttctttccCcTcctCctctTCtcCcCTttCttCCcCCCcCct	C?@C=AAABB@BAB7B?CFEFCEDBCDEEEGDDDEEEEDGG=EDEGED7DGGDEGG:DDDEDDGDDEFEEEGEBEDGEEGGEE7GEEDDDGE6GEDDDDGB>EDEFGEEDEDGEEFEFEEGEFEEFFBEEEDGEF9FFFDEDFFFEF@FEEFEDEEEFEFEEDFFDFCFDEFFFFFFEECC@>=B	T	94	C	91	25	41	69	50	0.00954
3	151078216	A	121	AGAGAGAGAAAGAGGAAGAGGAGGAAGAGGAAAGAAAGAAGAAGGGAGAAAGGGAgGGgAAGAAAGAGGGGAAGGgGGGGAgGAAAAGAAAgGgAGAGAAgaGAAAgGAGgAGAggGaAAg	>CGC>DHCHHG7HACHHCHCCHCCHHCHACGGGAGGGBGGBGGBBBEBGGGBBBGGBBEGGBGGGBGBBBBGGB7GBBB<FGBGGGGBGGGFBBFAFBGGDFAGGEE@F@DC@CBB>?C?A	G	61	A	60	49	58	12	2	0.00845
3	170912469	T	85	AtAttAataaAAtAAaTaatatatttattaAAttaatttataaAtataattttaaaaaaaatataatattttaaaaatattaata	EA>>C;@DDFFGFGHEGEFGF?@GGGFGGFHHGGFFFGGFGFFHA<GGFFGFHGGGGGGGGHGGGGHGHHHHGHGGGHHHHGGC?	A	49	T	36	10	1	39	35	0.02103
3	195346614	G	222	gcGGcgGCgCgGgggcGGcGGGGgGGGGGGGgGGgcGGggGGgGGgGGGGGgGGgGGgGGGgGGGGGGGGgGGGGGGGgGGGGGggGCccggGGggGGGggGGgGGGGgGGGGcgggGGGcgGggGggGGGGGGcGGcggggGgGGgcgGggGGggcGgggcggGGggggGGGggggGGGGgGGgcGGGggggggGgggGggGGgGGGgGGGGGggGggGGG	?CCBEDGGEGFGFFFGH=GHGHHFHHGHHHHFHHFGHHF:HAFGGFHHHGAFHGFHHGHHHGHHG;HHHHGG;GHHHHGCHHHHEGHG@GGGGHGGHGFGGGGDHGGGGHGGHHGGGGGGHGFGFGGEGG;GFGGGGHFFGGGGGGGFGGAGGGGGHGGFFHGGCG?GGFGGGGEGGGGGE?GGDHGGGGGEGFFGEGFGGDFGGFGGEEEFFFC@DBADAC	G	204	C	18	123	3	81	15	0.00039
3	195346623	A	239	GaAaaagAAgAAAAaAAAAAAAAaAAagAAaaAAaAaAAAAAaAAaAAaAAAaAAAAAAAAaAAAAAAAaAAAAAaaAGggAaaAAaaAAAaaAAaAAAaAAAAgaaAAgaAaAaaAAAAAAAAgaaaaAaAAagaAaaAAaagAaaagaaAAaaaaAAAaaaaAAAAaAAaagAAAaaaaaAaaaAaaAAaAAAaAAAAAaAaaAAAAaaaAaAAAAaaAAAaaAAAAAAAaaAAAAa	?B@>CC@EDGBD>FFFFF=BFFFFEFFFFEDFFBFCFFFFF@=F@E?EFF@5FACD@@@F@EE@EC9FEG9FFF>EGFDDG9DGFEEFEF=GFEF<BFFGFFF:FGGEFGFEGDGFDE?DEEEEGG?GDEDDEG8GE?FEEGGG8EGGGCFEDFGHFEEEE>FEEEDEFEAGGGEEECGFEGEGFEDDGEEGEEEGEAEEEEEGEEDEEF@@DECDCB?>B?AA;???ACCA?@ACCCB	A	225	G	14	139	2	86	12	0.00104
3	195412715	T	82	TTTTTTTTtTTTTTTtTTTTcccTtTTtTTTTTcCtTccTTCttcTTTctTtcttTTTtttTttttttTtTtttttTTttTt	@A@DCEEEEEDEDECGEEEEBBBFGFEGEEEED@GGE@CEDEFGCDDECFEGCHGDEDHFCDFHH>HIDFDHHAHGDDCHBB	T	71	C	11	42	2	29	9	0.01987
3	195452005	C	176	TtTtTTTtTtTttTttttTttTtttttttttTtttCtttCttCTTgtCCttcTTtttcCttTCtttTtCTTtCTTTttttttCTtcTttttttcttTttttttctttCccctcCCttcTtttttTtCtcttcttttctcttttttttcttttcttcgtctttttttttctcttttt	C?>C@??@AEBEDEFFGADEFFGFGGFFGGGEGGGFGGGGGGGFF5?GEGGBEEGGGBGGFEGGGGFGHFGGGFEFGGGGGGGCGBFGGGGGGAGGFG@H;GHCHHGFCCAHCFFHHCFEHHHHFHEACHGCFHFHCHCHCGHHHHHCHFG9CC;;9:C?IHHHHFHHCFCFHGDC	T	140	C	34	27	14	113	20	0.01205
3	195706589	T	69	TTTTtTtTTTTTTTCtCttTCTtCttttTTTtTtTtTttTCtTTTTTCtTTTtTTttCTCTTCCCttCt	@FGFEGEGEGGGFFDFDF@GCGB@FFFFFFGFFFFFF<GFCFFFFFECEFFFFFFFECECEFABCDEBB	T	57	C	12	34	12	23	0	0.00596
3	195710989	G	138	aGgGgGGAGGAgaAGAGgggAGgggggGGAgGAGAAgaaGGgaggGGagGGgAgGAgGgagAGGggGGggGAggggggGAAAAaAGAGaggGagGAGaAAGgAagAgaAGgAGGGGgaggaGAaggggaAggAggagg	C;ECECCHCCGFFGCHCFF;HCFFFFFCCHF=HBGHEFFBCGG:ECBGGCCGHDCHGCEGFHBBGGCCGFBGGGGGGGBGGHGGGBGAGGGBCG@GBFGGBGGF;GEGGBGGBBBBFGGGGBGGDGGGFDABB@@<DA	G	91	A	47	39	29	52	18	0.04795
3	196453467	A	160	CCAAAAAAAAACCACCAAACAAAACCAAAAACcaCAAcCCCAACACaAcCCAACCaCCcAACAAAACccAAccccACAAACAcAaAACACcCAaaAaacACAccccCCaacCcaACaCCCaacaAcAACcaCAccACaaccAaacaaACCAAccacAAcc	>BBDDFEFFFDGFEFFEFFEFGFEGGEFEFFFGEGFFHGBGFDFFGE>HGGF9FFDFFGFFGBFFEFHHED=HGHDEEBFFEHEEEEEEFHFEEEEEEHEEEHIIHEEEEHEHEEFEFFBEDHDEFEEDGEDEHHEDEEHGCCCGDCCDCCCB<>@A@DC	A	86	C	74	63	42	23	32	0.03137
4	64892	G	215	GGccGGcCCGCCcCGGCCCgCCcCGGCCCGcgCGGgGGGGCGCGGCgGCCGGGCccgCCGGcCggGGcggcCCGggccCCGGGGGCcCgCgcCCCGcGgCGCCGCCcccggccGGcccgGGGcGCGgGGCCGCGccGGGCCCcGgCgGCGGCCccccgCccGCGgGgcgcGGGgGCCgcgcgGGGCgggGgccGcccCCGcGGcGCccCGcGCgc	DA@B@@ABBABCDGGGGGGFGGBFGGGCGGDEEGGEGGGGGGGGGGEGGGGGGGDDEGGGBDGEFEGDFFBFEFEGEDD?GGGBFFEEGFGEGGGGEBGGGGGGGGEDDFGDEGDEEEFFGFEFFEFFFGGFFFECFFFFFFEFGFEFFFEFF8EEEFFEEFFFEFGEGEFFFGFFFGEEDGFFFFGGGFGEDFECDDGEA>D@BA?=AB>AABC	C	109	G	106	60	73	49	33	0.04905
4	1291791	A	166	AGaaAGaaGaaGGGAgaAGAaAGaaaGAgGaAaGAAAaGaaaGgGAaaGgGAAgGgAaAgGaGGAgAaGgAaaAGAaGgGaagGAGGgaaAGaGgGAGGGGgGAaGGaAaggaAgGAAggaagggaGAGAggGAGggaaaAGgaAaaGGGaaggaGgGggagAAag	6=FFABDDBDDCCBGFEFCHEHCEEECHE@EHECHIIE@EDECECHEEBFCHHDCGGEHFCDBAHEHECFGFEHCHFCFCFCFCHCCFFDHCFCEBHBBABFBGFBBEGFFFFGGBGGGGFFGGGEBGBGGGBGBGEDFFGAFFGFFBABFD>FFAF@AB@BBCCB	A	84	G	82	36	48	48	34	0.04572
4	1388324	A	134	AAaAAAaaAAAAAAAAAAAAAaAAAAAaAAaaAaAAaAaaAaaAAAAAaAAAAAaaAaAAAAaaAAAaAAaAAAAAAAaaAAAAAaAAAAAaaAaaAAaaAaaAaaAaaaaaAAAAAAaACCCccccccCcacc	CABECGDCGFHHFHHHHHHFHDEHHIECFIDDHDEHDHDDHDDBHDHCEHHEHHBEGCFHHGEEHHHEHHEHHHHDHHECHHHG:EGHGGGEEGEEGGEEGAEEFFGDEEEDFGGGGGFFBCCH<GHHGCE@=@	A	121	C	13	80	4	41	9	0.01664
4	1388724	C	49	ggcCccccccggcccggcccggggCgCCCCcCccccCCcCCCccccCCc	CBD7DFGGFEFFGGGFFGGGFFFF>ECCCC>CHHIHCCFCCCGB?AA?E	C	38	G	11	14	0	24	11	0.02120
4	1388788	C	59	cCCCCcCccccCCccCCcccccCCccccccCccCcCcCTCCCCTtcTTCTTCctCcTTT	>FBGGBABBBBG:BBBG=BCBC7>=C9C=CGA:G9GCCF7FAFFHCFE@FF7CCDCFG?	C	48	T	11	22	9	26	2	0.04497
4	1388817	C	53	GccgggggcgcCCccCCCCCccCCCCCCcccCcCCCCccCCCCccccCCcCCC	@@EGFFFDGFGDDGGD<DDDHGDD8DD@GHGDHDDCCBHCCCC=HFDCBECBC	C	46	G	7	27	1	19	6	0.04297
4	3494600	A	120	AGGGGAGaGaGagaggAaGAGaaaGGgggGaaaaaAgaaaaagaAgaaAagggGaAAgGgaggGGAGgAaGaGGgagAggGGGAGaaAGGaAggaaaaagaaggagggaAgGGagAaGGg	=<;?AGCFCFCFCFCCFFBGCEFFCCCCCCFFFCFFCFFFFFCFGCDFHDBDD<GBEDCDG7DCCHBDHGCGCCCDDGDDBBAGCGFHBBGGDDGGHHHDGFDDGDDDFGD?@FB@=A?A	G	62	A	58	30	17	32	41	0.04013
4	4190683	G	118	aGgaGgggaGaaGgggGaaggGGGGGGGggGgggGGaaggGgaaGGgaggggggggggagGggagGaagGGGGgggGgGggGgGgggggGgggggggGgggggggggggGGgGggggG	?@ADAA=A@DEEFBCBFFFCCGGGGGGGCCGCCCGFFFCCGCDFGFCFCCCCCBBCCCECGCCECGGGCCF<FDDDGDGDDGDGDDDDDF?DDD?DCFDDDDEDDDDCDFFDFDC?CD	G	102	A	16	34	0	68	16	0.00546
4	4239516	C	45	TTTCCCTCTCTTCCcCCCtCctCtCCttCCCCCcCcttCtCcCCC	GDFFGGGGFEEGGGCGGFHFCHFHF?HIBFFFFCFCEHFHFBEBC	C	30	T	15	25	7	5	8	0.01626
4	4239539	C	56	CCTCTCTTCCcCCCtctCtCCttCCCCCcCctCtCcCCCCcCCCCCcCCcccCcct	?DDGGGGGFGFG7GF9FGEGGFFG8DEEGGGFEFGFF;FFGFFFCFGFFFFGBEA>	C	44	T	12	32	4	12	8	0.01790
4	4239587	G	73	GGGttGGGGGgGgttGtGgGGGgGGGGGgGGgggGggtgggGgggGGGGGtGgggGgGgGgGgggtggGGggG	BC?;:GHHGHFHFCDHDHFHHGD@GGHHGHHEGGHGGEGFGGGGGG@GGGEGGGGGGGCGGGFGGEGFFGFCA	G	65	T	8	36	0	29	8	0.00512
4	15733297	A	48	GgAGaaAaAAGGAAAAAgAGAAgAAAgGgAGAAAAAAAGAaGAggagG	>A:HFEEFEDHGEDEEEGEHEEGEDDEGGDGDDDCDDDGDGFC@E?BA	A	30	G	18	25	10	5	8	0.04891
4	48344154	G	26	TGggtTGgtTggggggTgtTTgTggG	C7DFDFBFDGFFFGGD<GEFFEFBEA	G	16	T	10	3	7	13	3	0.01521
4	69696638	A	125	aaggggagAGAgaaGgAgagaaAaAggAaggGAaggGggggggGAAAgAagggggAGaAgAgGgAgggAGaaggggAaagaagaagagaaaaagaggagagaaaaaagggaaggagaaagaagga	ACCBB9ABA@BFEDEEFFDFDDEDFFFFDFFDFCFFBFFFFFFAFFFFGD9FFFFEED?FF7DFFFFFFEDDFFFF<EE>EDFEEFEGEECAEGCGGDDEGDDDEDEFGGEEGEEFEEEGEEGGE	G	63	A	62	8	17	55	45	0.04622
4	74453656	G	169	gAGaaGAAagggGAgaAAGaaAaGGGagaGGgaaaggagGGgGgaGaaaaGgaaAAAGGaaaaaAGAagagaaagAAagaggAAGGagaggGGaaGaaAgAaGGgaagaGagaagaagaagGggggGgggGaagGGgAGgaGgggaaGGGgagaggggGaagaggaaga	CA:CC<CBCCDD;EFCFFFCDCDBGGDFDGGFDDDFFDFGGFGF:GDDDDFFDDCEFEGDCDDDFGEDFDFDD=FFFEGDFFE?GFDFDGFGGDCGEDFAECBGGEEGE9DEE;GDDGEEFGGBGGGGFGEEEGGGGEFGEFGB=EE=FFGFGDBEGEFEEFAAB?BDA	G	88	A	81	36	19	52	62	0.02112
4	88536362	G	33	GgggGAAAggggagAAaAAAgaGggAaaAAaAG	@CBCCHHDCCCDECGDGHG>@GCDDHGGGGGEB	A	18	G	15	12	4	6	11	0.03664
4	119434892	G	97	GgGgggGggGggAGGGgGgaggGGggGgggGGgGGgGGggAgggggGGGGAgGggggGGgAaGAggAAGggGgAgAGGGgGggGGggAAGgAgAGGA	BFGDDEGFEGFEFGGGFGFEFFGGFEFEDFGGFGGFGGFGFGDGFEGGGGFGFGFFFFGFFFGF6FEEFAFFFEGEFFFFE>FEFFFEDFECDCBAC	G	81	A	16	36	14	45	2	0.00199
4	123533820	C	41	CCTTCTTCTTCCCCTCCCTCCtTCCtCCTTtCCtTCTtTtc	=G@GGGGGGGGGGEGGFGFFFFEFFFFFFFFFFBCCCAB?D	C	21	T	20	20	14	1	6	0.04483
4	140811075	C	93	ccccccCcCcCcccccCCccccCcccccccccccccCccccCccCcccCCccCCcccccCccCccccccCcCCCCcTTTTtttTtTTttTCTT	A?AABCBDFEGFFFFFGGFFDFFFFFFFFFFFFFFFGFFFFHFFGFEFGEEFGFFFAFFGFGFDGF=GG9GFGFGGDEEEFEFCAAB:@BAAC	C	77	T	16	21	10	56	6	0.00954
4	140811084	C	92	TtttttTTttttTtttttttttttttTttttTttTtttTTttTTtttttTttTttttttTtTTTTtCCCCcccCcCCccCCCCCCCCccCcC	AACBBDCEFEEEEDEEDDDDDEEEEEFEEEEFEEFEEEFFEEAFEEEEEFEF@EEEDEEFEFFFFFFFFEGGBEFFEEFEDEEEEEFFCC:A	T	66	C	26	18	17	48	9	0.00157
4	190878597	C	149	CcCCccCCCCCCcCCCCcCCcCccCCCCccCCCccccCCCcccccCCcTCTCcTTTCTTTCTTCTCTTTTTTcCTTTTCcCTCTTCTTcTcCTCcTCCTTTTTTcTCTTTTCTCTTCTCTTCTTTTCTCTccTCcccCcTccTCtCtcT	;EDAFFFEEFFGFFFGFGG@GGGGGGGFGGAEFGFGGFFFGGGGHFDHCF;FH@FEFEFFEEFFFGFFFFFFHGFFEFFGFD=FFEEEGDHFEEHEEEEEEEEDGECEEEEFEFEEFAFEEDEEEEFEFEHHEECFHEGDGDBA@>=@@	C	91	T	58	55	56	36	2	0.00000
5	745306	A	228	AAAAAAAAAAAAAAaAAAAAAAAaAAaAAAAAAAaaaAAAAAAAAAAAaAaAAAAAAAAAaaAaaaAaAaAAAAaaaaAAAAaaAAAAAaaAAaaaaaaAAaaAAAAAaAaAaAAaaaaAaaAAAaaaaaAAAaACAaCCCCaaAAAAAAaaACAaaaCaCCaCAAaACCaaACCCaACACaCCCCCaCAACACACAAACCACAAAACACaaAAACaACAACCAaaAA	C=?BBFFFFFFA:FF;FEFEFDFF?FF>FEFEECF=FFEFEFFFFFEEGFFEFFEFFCFFGGFGFGFGFGFFFFFGGEFFFFFGFFFFFGDEEG<GGFFDFGFFFFFEGEG;GEEGF;GE7GEEEGGFGGEFEGEF:FCCFDGFE@EBEEGDE@EGEGFGFFGFDEGEFFFCEFFFGEFEFGFDFFFGFEEFEFE@EEDEFEFDEDDEDEFEDEFFFDCCCBCAB<C?	A	193	C	35	126	35	67	0	0.00000
5	837556	T	247	tgtgTggttTTTgTtttgttggtTTTtttgTttTggttgTTgttTTgtTTTTtgtgTTgttTtgggtTTTtTTTtTtTTttTttggtttggggtTTttgttTTtgggtgTTttTTTTTTTtttttgtgggttggTTgttTTtgTtTTggtTtTTTttTtgtTttttTTgggtTtgttttttTttTTTtTttTttTTTtTtttttttTtttttttTTttTTtttttttttttttTTtTTtttttTTTt	ACCC?BBCB??AB@DDDFEDFFEEFEEE@EEEDFFEEEFEBFEEEEFEFFFEEFEAEBFEEFEFFFEFEFEFFFEFEFFEDE<EFFEEFCGFFEFDEEFEEFFE?FFEFFFEDBFFE>EFEEEEEDFGDGFFGGFFB>FFFEGFFFFEGFFEFFFFFCFGEFFFFFFEGGGFDFEEFFEFFEFE9<EEDGGEDDEEEFEFFFEFFFEFDDFEFEEEFFEDFFFFFFFFEFFDFEEDDEDDEBECDCA	T	201	G	46	82	0	119	46	0.00000
5	4420196	G	157	GaaaGaAgaAGGaggAaagagaggggAaGggaAAggAAaagaGgGgGgggggGggGGGggggGgggGGgggggGggggggggGggggggggggggGgggggggggGggggggggggggggggggggggggggggggggggggggggggggggggggg	EC?CC?><A@BEDGF9EFEEFEEEFFEFHFEFEEFFEEFFFFHFGFHFFFFFHFFHHDFFFFIFFFHGFDFFFHGFFFCDEEBFFGFFGGFGEGBHEFEGGGGGGG<DGGGGGDGGAGGGGGGGFGGFGGGGGCFHGEGHEFGGFGGGFGDGCBB??	G	134	A	23	19	8	115	15	0.03110
5	9122926	C	134	TTTTTCcTCTcccTTCTCcctTTCTcTtTCCTccTttTTCCcttCctTctccCctCcTtCcTcttcctttTTTTtttTcTTtttccccctCTcttcctTcttCcctcCcccTTtttctttctCctccttccccc	AABCBADEEBEEDCEEFEDDD<FEED6EFEFEDDDEEEFBGDEEFDEFDECCADEFDEEEDFEEEDEFFFFFFDFDFFEFCFFEEECCDBEFEFFADFFEFFAEDFEFEEEDEFFFEFEFEFEDEEEFFD@@@=	T	71	C	63	33	17	38	46	0.02147
5	89816299	C	259	CCcCCcaaCCaaaCCcCCacaaCaCAcCccAACaCAAaAACaaCACAaaaACAcACcaacCcaaaaaacaAccCAAaccaaaACcaccCCCcAACccACacaccAccccAaccacACaCccaaaCCACcCCCacCAaCacaCCCCaCCAAccCCCCAacacacCcacAcCCccaCCccCcCccacacaccaccaacaCcACaacaAaccCaCaacCccaacaAaCCcccccCcCCACaAaAcaccCaacccCaaAaaCc	DACB@AAA??=?C=BECFGFEFGFFFF?CEFFFFEE=FFFFFEGFGBFFFFGEFFFFFFFEEFDFFFFFFFFFGFFFF:FFFGGFFEFGFGFCFFFFFGFFFFFFFFFFFFFFEFFFFFFFEGGGFFGGEEFGGFEGFGGGFFFFGFGFFGGGFGFFGGFGGGGGGGDGAFGFGGFGGDGEGBBFGGFGGGGGGFGGEGFEGGFFDGFGEFEHHHFGGFGHGEGFFGGFGGEGEFEEG@EEGGGGDGFGGGDFFDB:AD	C	149	A	110	69	35	80	75	0.02121
5	140214361	G	138	GgggGGGGAGGGgGGGaaGGAaGGggGGggGgGGagGaGaGGGGGgggGagGggGGGGgGgGGGGgGgGGGgGGGgGgggggggggGGagGgGGGgGgggGgGgGGGgggGGGgGgGggGgGGGgggggGggGGggGg	>C??<;>=GAB?CCCCEFCCHFCCCCCCC@CCDCFCCFCFACCCBCDCCFDCBDACCCDBDCBCBDCDC@CDCCCDCDDDDDDDDDCB8DCDCCCDBDDDBDBCBBBDDAABBEBDB8DBDBBBDDDDDB?<5>?=CA	G	128	A	10	71	2	57	8	0.04594
5	140214381	G	141	GGggGgGGaaAaGaAGGAAaagAagAGagGGGGgGgGGGGaGgGGGgGGGgGaaggaggggaGGgGgGGGaGgggGgGaGGGggaGGGGGgGgaGgGGGgggaaGggGGgaGgGaggaaGgGGgGgGGgGGGGggGGgggg	?B@=BBFEEBDFGFFGGFFFFCFFCFGFCGGGGCGCGFGGFCCGGGCGGGCFGGDDF=CCDGGGDGD=GGGGADDGDGFGGGCCB>GFFGDG5GFDFFFDDDGGFDDFFDDF@FECCGGFDFFDFDFFDEFEEBBGGC@>A	G	112	A	29	65	6	47	23	0.00035
5	141309824	G	67	ggggAAgAggaAgGaAgGgggGgAAggagaggGGgaagaGaagggAGagaggggAaAagagaggaAg	?@A=EGGEDEEGFCEHECEEECFGFEFEGFGECC=FFFFB@FGFGH@F>DGE?FFFGFFF8FGE?EB	G	40	A	27	7	11	33	16	0.04989
5	145477855	T	34	TccctcTTcttctcctTttttctcTttcTtTctt	>AACEDGFDEEDE@EFGFCFEDCEFEFEFFFEE@	T	22	C	12	7	0	15	12	0.03563
5	153783587	A	134	AAGaAAgAAgAGGAaGGgAAGgGGGgAAAAaAAAGAAGAGGgAGGAgAGgGAGGGAGaggGaAGAaGGagGAAGAAgaggAGAGGGAAGGAAaGAggGAggAgAAGGgAgaggaggagAAAgaAAgagaaAGGA	@B@DDGGGHFHCCFEACFEH;=A@CGCHHHEHCHCDFAGCCFH@CHFHCGCHCACHBFFFAEEC@F@CFFBGGBGCGF9FFBFBB9GGB?EGFBGGGBG:FGGGG@AFFEFFFEFEDDD@D@ADD?@@A>ACCA	G	68	A	66	39	50	29	16	0.02878
5	171583610	A	64	GAGaAAAAAGGAAGAAGAGAGAAGGGAGGGaGAgGGaGGaGaAGGGaAGGaGGAagGGGGAGGA	BFEEFEFFEEEECDEFEEEFDFEEDE=DDDFDEFDDFDDEDCEDDCFDDDFDDEEFCCDBBBB?	G	35	A	29	33	21	2	8	0.03404
5	175353627	A	58	GAAAAGAAAAAAAGGAAGGaAAGGGaAAGGaAGGAAaGaGAaGaGGaaGAAAAaaaGA	CHHHHCHHHEHHH6CHGCCEGHBABEHGABFGBBGGFBFBGFBF<BFFAGDEC;??C?	A	38	G	20	26	20	12	0	0.00478
5	175387139	C	42	TCttcttcCtCttCCtctttCtCttCttttCtCctcccCccc	D<ABHEDGGD;DDGGDGDDDDCGDDCDDDDGDFGEHHG<CHH	C	21	T	21	11	1	10	20	0.00139
5	176637576	T	160	cCCtccccTCTTTCCcTCCtCTTCCcTTCTCCCCcccTCTCTTTTcTTTtCcCTTtTCTtCcCcCttCCtCTtTTcTTTTcTctCTcttTctTCttTTcTTctTTtcTTTCttCcttCTTCTTTTctCTTCtTCccTCccTTccCtCTTTCTTcttTcTT	BCDDBCEDEGFDFFFDFFFDEFF@GEFFFDFBGGDDDFAEFFDF7EFFFFG>FFEFFGFBF?G?GFEGCFGFFFFEFDFDEEEDFDEFEEEEEEFEEEEEEEFDBFEEEEEBFFEFDFDEEEEEEEEFEEFFEFEEEEEEDDEEDEFCCCBCC@@?A??C	T	89	C	71	63	39	26	32	0.04727
5	177031954	A	38	aAAGAGAGGAGaaAGAaGGGGAaAGaAGAAaGGGAGgG	FEEHDHEHHAHBG7GD9GGGGBFDGGDGBDFGG>;DAC	A	20	G	18	13	17	7	1	0.04502
5	177163580	A	93	AAAAAAAAAaaAaAaAAaaAaaaAaaaaaaaaAAAAAAAaAaaGGGaaGGGAGGAAGGGaaGGAaGAAGGAAGaaaAGAAAaAAGaaaGGGGa	CAAHHHHHHEFHFHFDIFFHFFFHFGFEFBGGHGGHHAHEH@GBC>GFBBCGBBGGCBBGGBBGFB?GBBGGBGGFGBGFFFEEACAA<A??C	A	70	G	23	37	23	33	0	0.00001
5	178949560	A	159	GAGAAAGAAGGAGAAGAAAaAAAGAGAAAAGAAAAAGaAAGGAAGGGGaAAGGGaAGGAAAGaAaGaAaGaGGaGGaaAAGGGAAGAaaGAGAGAAAGGGaaGAGAGAGaAGGaaAGAAGAaaaGagGGGaaAaAGGGaaggAAagGgGgAGGgaaaAA	BACFEFEFFC@FEG@EFEFFFFFEFDFFAFEFFFFFEGFFEEFFEEDEGFFEEEGFEEFFFEFFDEGFDDGDDGDEGGBDDDEEEDEGFDEEFDEEEDCDGGDEDEDEDGEDDGFEDEEDEGGEDGGDDDBGEGEDDDFGFGEEGEDGC?FCBCCCA?@	A	94	G	65	62	58	32	7	0.00072
5	178949561	G	161	GTGGGTGGTTGGTGGTGGGgGGGTGTGGGGTGGGGGTgGGTTGGTTTTgGGTTTgGTTGGTGTgGgTgGgTgTTgTTggGGTTTGGTGggTGTGTGGGTTTggTGTGTGTgGTTggGTGGTGgggTgtTTTggGgGTTTggttGGgtTtTtGTTtgggGGt	>BEEGFGGFFEGFGEEHFHFGGGEFFGGFGEFFGGGEFGGFFGGEEEFGGGFFFGGFFGGDGEGGEFGG?FGFFGEEEG=EFDDFFEFGGEFEBEFFFEEEHFEFEFEFEAFEEGBFEFFEFEGFEGEEEEGGFGFEEEGGEEFFGEEEDCEEECEECB8@	G	95	T	66	63	58	32	8	0.00170
5	179071958	C	195	CccCCCCCCcCCccccCcccccCGCcCCcCcGCCCccCcCGCccccccCGCcCccCCCcccccccccccCCGCCCGcCCGcccccCccCcccccGCccCccccccCCccccGcCcCGGccccccccccccccCcgcccCcgccCCcgccccCcccccgccgcgcccgccgccccccCCcccccccccccccgccg	DC@B??<?AABBDDEDFD?DCCGGGCGGDGDHGFGDDGAGDGDDDDDDGFFDGDDCGGDDDDDDDDDD9G>HGGGHDGFHDDDDDEDC:EDDEDHGE=GDDEDDDGGEAEEGEGEGEHAE9EEEEEE?EEEEAEFCEEGBFEAGGEGEEEE6EEEDEFEEGEGEEEGEEFBFEFEEFFEEEEEEDAEEEECEA@E	C	174	G	21	49	11	125	10	0.04219
5	180039606	C	145	cctCCtttccCtctTCcttcTTtCCttTCcCCtTTCtcCCCCttCTttCtccTttctTttttcCCctccCTCCctCccctcTcccCccTtcCcCCCTCCtttcttCTtcccCCtcctcCctcctcCtctctCcccttctcccccc	C<CB@DED@?DH8FF@AFFBFFGFFGGFFBFFGEFGGBGGEFGGGFGGEGABFGGBGGFFFGBFFBGBBFDF=@GGBBBGBEACCGBBEGB>BEGFEFGHHHCHH@EHBC@FFGBCHCFCGCCHCECCH9GECCCFHCFCC>?<<	C	86	T	59	35	14	51	45	0.04876
5	180661980	T	125	TCTTcCTTTTctcCCTTTtTTCCTCtcTcccCTTTTTCttTcTtTTtTCCTTCccCcTtTTTCtTctCcctctcTCcctTccTcCTttCctCtcctTctTTTTTTcTCTTtttCCcCtTTCctCc	EDDFGDFGGGGCGDDHFGDEGDDGDDGGGGADGGGGGDADGAG>GGEFCDGGCGHDHFEGGDDEGGE=HGECEHECHHEFHGFGCFABCHACEEGEFHCFFFCFFDFCFFEEECCHCEFGDD=AC	T	71	C	54	47	25	24	29	0.02962
6	6004035	C	48	aAAacCAaaaaACCCaacCaaAAAaCAAacaCcacaaaaCaaaaaaAC	EHHFBDGFFFEHDCDFFBBFFHHDG>5HGCGDCGAGGGGCFGGGGGE@	A	34	C	14	10	9	24	5	0.04914
6	17764896	G	223	CCCgCCccGGGgGGgGgcCGggCGCCCGCCGGCcCCgCGCgggCgGGcgCGCGGGgggCggGgggCCCGgCGccGgGggcgGcGGCgGGGGCCCcGgGggCCcCCCgCCGgcggCCGgGCgCgCGCgCcCCccGGGCcCGgGGCCCgccCCgCCCCGgGgccGGcCCGGcgCGCggcggCgGGggcccCCGccgGCGCgCCCggcgcgcGCcggggccgggcc	AB>BCDDDCDCFEEFEFEEDFFGEFGFEFGDEGCGEFGEFFFFFFEEFFFBFEEDFFFGAFEFFFEFFEGFEGGEGEGGGGEGEDFGDEDEEGAFEGEGGFFA?FFGGFEGGGEGGEEEFGGGDEDGDF?GGGDDDFFGD=DDEFFDGADDGFFEEDGDGBGDDFFEDDEGFDEG=GGGEGDD6GFGGEDDGGFDEDFEFCBFGGCCADCBA?B?<@@?DDBC	G	118	C	105	55	69	63	36	0.00468
6	18222102	C	86	CcCCCCCCCCCCCCCCCCCCCCCCCCCCCcCCCCCCCCCcCCCcCcccCCCCcCcCCCCCcccCCCCcCCCcCCCCccCTtCtTtt	BACGGBGFAGHGGGGGEGGEAGGEDFFFCGFFFFFDFFCCFFFFFGGGFFFFFFGFFFFFEGGFEEFGFFFFFFCCDCCBAC>CCC	C	80	T	6	64	2	16	4	0.02436
6	24532392	T	200	tCCCTcCTTCTCTTCTTTTTTTCTCTTTTCttcCTTTTTtCCCTTTCtTCtTCTTTtCCcTCTtcTTCCcTCCtttCCtTCCCCCCCTtTTCCtCCTTCtCttTCCttTTTctTcCTCttTttttTTTctcTCTtTTTTtttTTtCcCCTttTCcccCctTttCCTCcCCTTTCtcCTCcttCCtCttCCccCTcTTcCC	C9DF9B@GGGDFEGGGFG9BGGGBHHHGEC=GBGGEGGFGGDGGFGGGGGGGGFFGDGBCFGGHCG@CFCGGGHHHGCHGGGGGGGGGH=FCFHEDGGGGGHAGGGHHFF>CHFAFFFHHFHHHHGFF>H>CFFHEFFFFFHFFH7CFFDHH;FCCCFBHFHHFFBFC6FFFEFHCEEFCHHFE@EGGFF@@A:>BC>A?	T	114	C	86	71	65	43	21	0.04842
6	29141849	T	195	ccCTcttCccCtcTcTtCTCTctcTtTTCTCCcCTCccTcTTcCTTTCTTCCCTTTtcTTTTCTTCTCTtcTctcTTcTCtcTTccTCcttTTtcCTCTTTTCcctTtTTCCTTTcCCttTCCTccCTtttccTCCTCCCtcttTcCcCTcTTttctctcTTTtCCCTCCTTTTccCttcCttctTtTTcTTTTT	A@?@CBDDFEGEFF:EEFFFFF@EFDFFGFF6FGFF9FEB;FFGFFFFFCGGFFEFEEFFFFFFFGFFDFGF?F@FFFFFDGFFGGFFGFEFFFGFEEFFEFFEGFEFEEEE?EEFGDFDEEEEGGFE:FFGFEFEEEFEFGFFAGEGFEGEEFFGCFFGE>EFFEECFFDDDDGFFFFG@EEEBBA=8???CCC	T	108	C	87	74	44	34	43	0.01251
6	30859306	G	123	GcgGgcgggCCCCcCCCGGCCcCcgGcCCcccCGCcGgggCGgGGgcgcgcgCcggccGcCggGgccCcgcCcggCGgggcggcggGgcgcgcgcGCcccgggggggGggggggggggggggg	ECB?BDBDEFE7FE>EGHGGEEAFFHFGEFEFGGDFGFFFGHFHGFEAFFFF7FFFFE@FDFFDFFFE@FFGFFF>HFFFDGFGFCGGFGGGGGGHGFB:GGGAGEEGGEGE<G=?D?5:GGB	G	71	C	52	16	21	55	31	0.04616
6	30893728	C	69	tcTCTCcCCCCccTCCCTTccTctTtTTccCTcTCTCctcTCCcCTTTTTctCTttCcTTTTTcCCTTT	CD@BFFGGGGGGGGGDGFFGGGHDGEFFHHGGGGGGGHDGFFFHFFCEFFHEEEEEFHEFEFEHFBCCB	C	35	T	34	19	27	16	7	0.04061
6	30993958	A	275	GGggAGaaAGAgAaaAAAaaAgaaaAAGGaAAAaAgaAGggaAGagaaAAGaggaGaGaGAAagaAaggaGgAAggaAGgaagAaGaAAAaAAaggGAaaagaAgAgggaaggAGAgaagGAaaAAgaAAAaGggAgGGGgggGGagagAagaaaaAAGAAGGAGgGaaaAaAaggAAgAGAgaagAGGaagagAaAAGaagGagaaaaaAgaGgGaaaAAAgAAaaaaAAaAaggggAAggAAGGaagaggAAggAAaAggggaAgAAaAAgAa	6;><A=BD=@DF?EEFHHFEHBFCFHFCBFHHHFHFFHBFFFHCAFFFHFBFFFD=FCFCHHFFEFAFFFCEHHCFFHCFFFDHFCFHC9FHGFFFCHGDFFFGFGFGGGEF=HCHFFFFCB=FACGGHHHF>GG9GCBCDGGCAGA<GHGGGGGG@HCHHCCHCFCGGGHBC=GGHGGHBGGGGGHB@BGGEDEGCGBGGEBGBGFHHHGGFBGBGE<GGGGGGEAGGCGGGCG;FGGFCGG<AACDF?EGFGFFHHFEDDCBCCBCD?@B@AA	A	168	G	107	82	38	86	69	0.03428
6	30994024	C	213	ctctCcCCccccccccCtcTtTcccCCtCCccccCCtcCcttttCCttCTTcccttCCttCCcCttttcCtCCcCCtCctCccCCcttctcCcCCtttcCccCCccCctCcttCCCcccCCccCccCcCCCcccCCCCCccCCcCcccCCCCCCCcccCCccCccccCCcccccCCcCCCCCCcccccCccccCCcCcccCcccCccCccccc	CCC?>C9BGFGGGGFFDGGGGFGDCDDGBCGGGGCDEGEGG@CGEEGFDFGGFGGGDDGGDDGD=GGGGDGDDGDDGDGGDGGDDH;HHGHDGCCFDHHDHGC8HGDHHDHHGCDCHHHDDHHDHHDHDDDGGGDDCDCDHDDHCHG@CCCCCCCHGGCCBCCH;HG=CHHHHFCCHCCCCCCHHH=HCDHGHCCHCFHHCHGFBC?@<EDEE	C	177	T	36	81	4	96	32	0.00006
6	30994025	A	200	AaAAaaaaaaaaAgaGgGaaaAAgAAaaaaAAgaAaggggAAggAAGGaaggAAggAAaAggggaAgAAaAAgAagAaaAAaggagaAaAAgggaaaAaaAagAaggAAAaaaAAaaAaaAaAAAaaAAAAAaaAAaAaaaAAAAAAAaaAAaaAaaaAaaaaaAAaAAAAAaaaaaaaaAAaAaaaAaaaAaaAaaaaa	CC@EFEEEEEDDHFEHFGE5<HDFHHEEEEHHDEHEF>FFHHFF;@CIEBCCHHFFHHEHGGFFEDFC=EHHF@EFFEEGHEFFEEFFEGGFGGFFEHFEGFFGFGG?GFFFFHHDFA>CHFHHGD<CHHHHEFHGFFFFFGHGGGEGC;GGB@GFFEGEFFF?GFFGGGGGEEFFDFEFGGEG;BDGA=9G?AC=@>A?	A	166	G	34	77	4	89	30	0.00010
6	30994026	C	208	cCccccccccCacAaAcccCCaCCccccCCacCcaaaaCCaaCCAAcccaaCCaaCCcCaaaacCaCCcCCaCcaCccCCcaacacCcCCaaacCccCCccCcaCcaaCCCcccCCccCccCcCCCcccCCCCCccCCcCcccCCCCCCCcccCCccCccccCCcccccCCcCCCCCCcccccCccccCCcCcccCcccCccCccccc	CBFEHGGGFFGDGFC<GG;GGDGGGGGGDG9GGGDDCDFFDDB<EFGGGDDGGDDGGGGDDDDGGEGGGGGDDGDGGGGGHDDGDGGGGGDDDHDHGG>GGEHCFHECDFGHHHGGHHGHHGHGGGHGBGGGGFHHFFHFHHHFGFFFGF@GGFFEHFHAH=8FHGGGBFDHFF7FFCHGH;GCHHHHFFHFHGGFHGGEFDBCC?CB	C	174	A	34	80	4	94	30	0.00011
6	30995078	G	242	gGGGGgGGgggGGGGGGGGGGGgGgGgGgGgGgggGgGgGGGggGGgGgggggGGGGgggGGggggGgGGGGGggggGggGGGgggggggGgggggGGggGGgggGGGGGggGGggGGggggggGGGGgGgggGGGGgGGggGGGgGgGGgggGGGGgGgGGgggGggGgGGgGGGGgGGGggGgggGGgggAAGgGAAGAAAAAAAAAAAAAAAAAAAAaagGAAAAGGAAGAAAaggGGG	A;C@CA=CCCFFFFAGBG6HHGEHFHDGFHFHFFFGDHFHBFFFHHFHFFFFFHH@HFFGH;F@FFHFAHHHGGGGGHG>HHGGGGG@GGBGGGGG;HGGCHGABAHHHHFGHHFGHHGGGGEGGGGG=HGDGGGGGGGHGGGGGBGGFAGGGGGGGGEGGFAHGGGEGGGGEGGGDA@GGB?GGEFGGEGADDGGGDBGDDDDDDCDCDDDEEDDDDDCDEGFCDCDGGABE@A>@=?AC@	G	206	A	36	108	33	98	3	0.00000
6	30995080	G	245	GGgGGgggGGGGGGGGGGGGgGgGgGgGgGgggGGgGGGggGGgGgggggGGGGggGggggGgGGGGGggggGggGGGGggggggGgggggGGggGGgGggGGGGGggGGggGGgggggGgGGGGGgggGGGGgGGggGGGgGgGGgggGGGGgGgGGgggGgGgGGgGGGGgGGGgGgggGGggggCCGgGCCGCCCCCCCCCCCCCCCCCCCCccgGCCCCGGCCGCCCcggGGGCGGCCCCg	DC??A@CBDACAD@C@FEAAEGFGFFFEFGFFFGEFGGGFFGGFGFFFFEGGBGFFGFDFFGFFGGGFFFGFFEE;?GGFG@EGGFGGGGGGFGGFGGFA=FFGGGGCGGFGGGGGGGE?GFEGGGGFFFGGFGGGGGGFFAFGF;BGGFFFFGFGFFAGGFFFGFFGFEFEGAFFAFGGFFFF>A>FFFGFCFFFFFFFFFFFGFFGGFFFFFFHHGEEFEFEFEFEFGDG8@BCBBCBACA?=	G	204	C	41	111	38	93	3	0.00000
6	30995178	C	344	CCTCCTTTcCcTcCCcTcCTcCCTtcCcctcctcTtTccctCcCccTCctCTCTCCCTTCCTcctccTTccCccCTCTCTccctTTTTTcTtTCTCCcTccCCcccccccCccCCCcccCTcccCCTccccCTCcctcCTttCTTtctTTCCCCCCtccTCTTtTTCttCcTTCcTttcCTTCCcccTCccCTCCcCCCcCTcctcCTTTctcTTtttctcTccCTtctCTTTCTTTCtccttCTCCccctTCTtccCtcTTTTTctcttttTTttCCTCCctTcccCTCctTTCTTccCCcCCtcCttCTCCTtcTctttCTTCTcCtcctCttcccTCtccc	?E:?>A?AC>@CFAEHEF>FFFGGCGGGGDDGDGGDFGGGDEGGFG@GGDGGFGGEGGGGGFGGDGGEGGGGFGGGG=EGGGGBFFDGCGGCGDGGGGGGHGGGGHHFFHGGGGGGGHHGGGHHDGGHGHHGGFHHDHGGEEFGFEHBG>GEG8GGEHHGGGFDGDFEEGHGDG@GEEGG@EGGGHHEGHHFBFFHFDFGGGHGEHFFFFH?HGGEHEGBHFHGFFEHDGDFFF6FFFEHHCACFFFHGCDFFE;GHFEHFFFFFHDHEEEEEEC8FFFFFDEFHGHFFFHDFFFFDHHFFAFFCHFEEFEFEEEHDHDADFGFFEGD@CEBC@;BCB?B@=EC	C	201	T	143	92	88	109	55	0.00443
6	30995187	T	340	CctTttcttctCcCtttcTtTttCtcTCCTTTCCTTCttcttCCttTttTCTCTCtttcCCCCCtCcCTCTTtCttTTtttttttTttTTTtttTCtttTTCtttTCTttctTCccTCCctcCCTTTTTTcttCTCCcCCTccTtCCTCcctTCCTTtttCTttTCTTtTTTTCttctTCCCtctCCccctctCCttTCctcTCCCTCCCTcttccTCTTtttcCTCcttTctCCCCCtctccccCCccTTCTTcCtttTCTtcCCTCCttTTtTTtctTccTCTTCctCtcccTCCTCtTcttcTcctttcCTctttTCTtcCCCctTcccTctcctct	DAC@AA@>CBBCDEEFEDGDEEEGEDG;?FEGGGEGFEEDEEGGECGEEGGGBFGEEEDGFFGGEFDF>GGGEHAEGGCDEEDEEFDEDGFEFFGGBEEGEGDEAGGDFEDEGFDDGGGEDDG<?GGGGGEEEGFFFEDGFEDGFG:GGEEFG>FGGEFCGGFFEDGGEGFFGGFDEEGGGGCBFGGEEDBEFF8ECEEEFDGGFFFGFFGEFDEEEFFFEAFEFGDEFEFEFFFFFFFEFEEEEFFDEFFF<FDFFEAFEFFEFFFFDFFFFFFEEEFFEAFFFFFEFFFDEEFFFEFFFEDFEFDEFDEDFFEFDEFDFEEEFFDEFC@?A>>BB<B?	T	189	C	151	84	86	105	65	0.02888
6	30996959	G	524	GGGGGgGGaGaGGGGGaagAAGGGAagaAGggAGGagaagggagGaagaAGGaagGgGGgggggGGGGGgagGAgggaGagaaGGGGGGGGGggGGagagggagAGGGgaAGGAGGGGAGGggaGGgggGGgAGgaGGGGAGgggagAAGgggGAAagaGAaaaggGGaGggGGAAGGGAAGGGggaggGGGagAgaaaGAAgggaGagggggAaggggGGGGggggagagAgGGgGGAGggGGGaaagggGGAGGGggaGGAaGGGGggggGAAgggGGGGGGggggAGGgaagGGGGAgggGGGggGgagaGGGGGGGGGgaGgGggaGGgggggGgggggggGgGGGggGGGGggggGGGgggGGgGGGgGGgggGGGGggGGGGgggGGgGgggGGGGGggGGGGggGGGGggGggggggGGgGGGGGgggGGGgggGGGGggGGGGGggggGGgggGGGgggGGGGGgggggggGgGggGGGgGGggGGGggGgggGGGggGGGgggGGGGggggggGG	D>DA:C>B@@BBB?BA>CCB=B>BBCCDCGGGDFDDECDDEEABCCDECEHFDCEHFHHFFFFF<DDGHFDFE<FDFCHDFDCGHHGHHGDGF6G7DFDFBFDFCFDGFCEGHEGHFHBHGFFDHHFFCBHFE@FD@GGGEHFFFDFEBIFEEB=DDFAGEDDDFEH;DDFFHAEEHGGEEDHHFFDFFGHHDFBADACH?EFFFCG8G>GFFCDAFDF?GGHGFFGEDEEEGHHGHHDGFGGGHEEEGGF>GDGAGGGCHHEEGCGGGGGGHEEGGG@HHHHHGDGGEGFGEEGHFHHEGGGGHHFGHFE@EGH@=;HH@HFEHGHGGEHGAGGEA;GEGGBGGFGGFDGG9HHFGGGGGGGAAGGGGGGGGFC?GAGGFGCGGGGG9GGGGGFEEDDGDGFG:GFFFHHGGGGEFGE9EGGGGGGGCGGGGFGGGGGGGGGGGGGGGGGGGGGGGGGEGFGGGGGGGGGGGGGGG<FGG??EGGGBFG:GGGGAGFFFFGHHFDEEFCDDEEBD:BA?<@CC	G	436	A	88	232	34	204	54	0.01408
6	30997334	A	368	AggggGAGGGgaAGAGaGAaGAgaaggGAAaaAGAaAGAGAaaaaagggaAAgaGaaggaGAAgGGgaggggGgagaaAAAaaGaaagaaaaAAAaAgaGGAAGGGGaaagGGggGGGGAAaGaaagGGGGAGGGaGaAGAaaAGGGaagAGagAaaAagAAAAgaAaaGaAAaaaaAAgGGaaaAagagaAgaAggGAGAAggAaaagGGAaaAGGaggGGagGAAaGaagAgGAGAGggAAAAGaGGAGAGgaAAGAgaaGaagaGGAGGaaaagaAGAAaaAgaGGaaAGGAGaaggaGAagAaGAagGagAAGaggaGAaaGggaGGGGaagaAGaAAgAGgagGAgAgAgAGAAgGGaaagGG	ECC??>=8;<BC><><A>CB?D>DCCD?FAEEFCHEHCGCFDDDEEDECEHDDECEAEEECHHFCBFEEFEECFEEEEHHHCECEEEFEECEFIIEHCB;AGHACCCEEEFBCEDACCCHHEBEEEFBB?CHCC@DB?HCHFEHC:6EFFHC?FGFFHFGHCGBEFGFFBFH:FDEFHG7CC;FEHFEEFFGGFHGGCFCHH=FGCEFG5CHFFGCBFFGBCF>AHHABFFEG7BGBG<FFGG=GBFBBGBCBGEGCBGGFF?BFGF;BGB<AF@@FDGBGGFFCGFBBFEGBBGBFEECEBGFFCFBGFDBFFGGBEFFFBGFFB@FFBBBBFE@EGBFFFFFBFDFBGFBBDBB=CC>:>>>=5AC	A	202	G	166	90	95	112	71	0.01633
6	30997352	A	352	gggGgagaaAAAaaGaaagaaaaAAAaAgaGGAAGGAGGaaagGGggGGGGAAaGaaagGGGaGAGGGaGAaAGAaaAGaagAGgAaaGAagAAAAgaAaaGaAAaaaaAAgGGaaaAagaggaAgaAggGAGAAAgAaaagGGAaaGGaggGGaaGAAgaGGaagAgGAGAGggAAAAGaGGAGAGgaAGAgaaGaagGGAGGaaagaAGAAaaAgaGGaaAGGAGaggaGAagAaGAagGagAAGaggaGAaaGggaGGGGaagaAGaAAgAGgagGAgAgAgGAAgGGaaagGGgAgGAAAaAaggaAagGGgaAaaagaGGAAaggGAgGGAgGAGGggGgGAGAgga	A?C?@<A?B@=?EEDDEFBFFFFCCEFDBEHHECDH9FHFFFCHHCCGHHHCEFHFFFCHHCFB;HGCFCDFEHBFFEHFFCDHCBFEHD=;EEEDCFD@FAGEAFFFFEE@BHEG@EGDGBDGEDGEDDH9HE?BDE:FFDGGEDGHEGDDHHG=G5E>GGHGGD5DHEHEGDDEE<EHGHHEFBHCBEHBDFGHDDDCHEHFFGGDGECEEG<BCGGGGCEGHDGGD6GGDGDDGGEGDGGDDDGCADGGEGGGDDEGGGGGGDGDGGDDEDFCGBGDDDDDDGCDDBGGGDCGGBDDGDBDGA?DDGDGDF>CED@GFDGGGEEEBBFA@DD@?C@DC??B8?AC@AAD	A	189	G	163	87	93	102	70	0.04264
6	31238053	G	53	GgGggGgggGgggggggggggggggggggCgGgggCGggGCcGGggGgcgCGg	C@BBBACCFHFFFFFFCFFF>DFGGGGFGGGGGGGFGGGFFHGGFGGEEGFDB	G	47	C	6	11	4	36	2	0.04699
6	31238372	C	47	cCcccCCcccCGcGccgcggcGgccCcGcgCGcgGGGGGcCCGCccc	?>AABFGBBBFEBEBBDBCDCEDCCGADCCGDCDDD@DDCFEDECC@	C	30	G	17	9	11	21	6	0.03203
6	31238930	A	79	AAAAAccAacacacaaAacaAaAaAacAAAaAAaaAaccAaAccaacaaaAaaaaAaaAAAAAcaaAaAaAaaaaaaAA	AB@>>?@FFBFBFBFFHFBFHFHFFFAHHHFHHFFHEBCHGHCCGGBGFGHGGGGDFGGGGGGCGFGBEFGFGGGFE@?	A	66	C	13	30	0	36	13	0.00125
6	31323960	G	39	gggcggcgggcgGgccgcGccccGGGGgGgGgGgGgGGG	>>GEEFFFFFFFIFEFGFHEGFGHHHHEFGGGG6GGGGB	G	29	C	10	13	0	16	10	0.01606
6	31324144	T	56	TTTTTTttaatTTaaaTttaatattTTTTTtttttttTTTTttTtTtTtTtttttt	@@@DEBBDDDD=FDDDFDDDDDDECFEFFEEDEEEEEFFBECEFEEE<EECEE5EE	T	48	A	8	22	0	26	8	0.01709
6	31324151	C	54	CccttcCCtttCccttctccCCCCcccccccCCCCccCcCcCcCcccccccCCC	BA:EEFAGDDDGGGDDGDHFGEG5HGHHHHHFGGGHBGEGHFHFCHHHHAH@AC	C	46	T	8	19	0	27	8	0.03990
6	31324154	G	54	gagGGaaaGggaagaggGGGGGgggggggGGGGggGgGgGgGggggggggGGGg	@=BGFDECHEFDEFDFDHGHHCFEEEFFFHGGHGGHFHFHGGDGFFFEDFFDE@	G	47	A	7	19	0	28	7	0.04362
6	31731014	C	36	ggcGggCccgCgcccgCgcgGCggCCCCCCGgCCgG	FGGHFFGGGFHFFGCGGFGGGGG<FGFDFFFFBB:6	C	19	G	17	12	4	7	13	0.02277
6	32487268	A	72	gAaaAAAAaAAGAagAGaaaaAAAAAagagaAagggaaaaaagGaagagagaggagaAgAgggAaGggGAAg	C@CDFFFEDFFEEDFFEDDDDFFFFFDCDFDFDGGGEEEEEDFEEBGEGEEADBCEFEFEGGFEEDDGCDCD	A	46	G	26	20	5	26	21	0.04345
6	32522494	C	58	CcCCCCCCCCCcCCCccCCCCcCccCccCcCCCccCcCCcCCcttcccttCtCCCCtc	GBGGGGCEFGGBGGGBBGGGGBGB7DBBFCGGGBBGCFECFFCGHCC>GHFHFFF;B@	C	52	T	6	33	0	19	6	0.00438
6	32549497	G	111	ggGgGgAAGAgGgGgAgAgagGAggaggGggaGGAggAgAaAAGgAgGgGaGGgaAggGAGgGaGAgGGggGAGgaGGAAGGgGAAGggggAGAAGAggGAGgGGgGGGaG	C@=C@CGFACFCECFHFBFEFD?FFEFFCFFFCCHFFEFHA@HCGH:CGCFCCDG@GGCGBG8GCCG;BGGBG;GGABGG;BGBGGBGGGGGAGGBGGGAGAFC@C>><=C	G	77	A	34	38	25	39	9	0.02238
6	32552029	A	167	aaAAAAAAAAAAaaAAAaAaAaaaAAaAAAATTAAAaatatataTtttAAAAaaaaaAAAaaAAaaAaAAaAAAAaaAaaaAAAAaaaaAaAAAAATTtttAAaATAAAAtTAAAAaataaAATAtaaaaaTatttttataaAaaAAaAAAAaAaAaAAAaAAAAaa	DDDFB=FEFFBDDDFFFDFDGD@DFEDFFFFFFEBDADADDDDCBDDDF>FDDDDEEFEFEEFFEC:ACEDFFBFEEEEEDEFFFE:DEFAEEEEEEAEEEFEEBEBEEEFCEEEEEDDEEDEEDEDEEEDEB8BCC>@>?EEEBEEBDDDDEDDC@BCC=AAC?>B	A	140	T	27	81	9	59	18	0.02166
6	32552059	G	181	GGTgTGGGgggggGggTggGGggGgGGgGGGGggGgggGGGGggggGgGGGGGGTTtttGGggGTGGGGtTGGGGggtggGGTGtggggggTgttttgtggGggGGggGGGGgGgGgGGGgGGGGgggtgtGtggGGttGGtgGGgggGGtgGGtgGTtGGgGgttttgttGggggGGgtt	BACC@@A@CCGFFEECFFFBDFFEFEEFEEEEFFC?FEFEEEFFFFDFEEDEDEFFDEBEEGGDFBEE6;@D?DAEGEGGAEFDEGGGGGFFEB5EEG6B>AGDEDGCDCDDECGDGDDDGDDDDGEGEGE=BHGDDCEDDDFDDGGGDDDFDDCGCEEDCED?D:8BC@BAAB@:>>B8B	G	143	T	38	75	10	68	28	0.00567
6	32552067	C	190	CcCccCCccCcCCcCCCCccCcccCCCCccccCcCCCCCCTTtttCCccCTCCCCtTCCCCcctccCCTCtcccccccTctttttctccCccCCccCCCCcCcCcCCCcCCCcccctcctCtccCCttCtCtcCCcccCCcCCtcCTtCCcCcttttcttCccccCCcttCccCCCCCCCCctcCcCccc	A?>CD@AGFDEDDFDDDDFFDBFFDDDDFFFFDFDDDDDDGG=EEDDGFDGDDDDEFDDDCEGEGGDDGCFFFGGGGFFG:7EFFGFGGDGFDCG:DDDDGDGDFDDDGCCCFGGFFFGFCFFGCCAFCE@FGCCG=GCCGCCEGCDFCCGCGFDFEGFFCGGGGBBGEFCFACDCBAAA@;A@A??DCE	C	153	T	37	81	7	72	30	0.00019
6	32552072	T	186	ttTtTTtTTTTtttttTTTTttttTtTTTTTTGGgggTTttTGTTTTgGTTTTttgttTGgtttttttGtgggggtgttTttTTttTTTTtTtTtTTTtTTTttttgttgTgttTTggTgTgtTTttTTgtTTgtTGgTTtTtggggtggTttttTTtggTttTTtTTTTTTtgtTtTtttgTtTt	C?;@>BEDD?<DCDDDEEFED5DDFDFDFEEEGHDFFEDBD:H@EEDACEEE<BDFDDEHFDCCEEDDGDFFEFFDGDDCEEEDEDEAEEAAE9DEEEEEECDDEEGDEG;G<CDDEGDGDGEDDEEDCEFDDGEDFG@DEC;EFEGEGGDEEEEDDEGGDEEDDDADC@DC=GEDEDACD?C>CB	T	147	G	39	76	7	71	32	0.00013
6	32552112	A	172	aAaaAAaaAAAAaAaAaAAAaAAAAaaaagaagAgaaAAggAgAgaAAaaAAgaAAgaAGgAaAaggggaggAaaaaAAaggAaaAAaAAAAAAagaAaAaAaAaaaaaaaAAAAAAaaaaaaaAaAaaaAaaaAaaaaaAAAaaaaAAaaaAAaAAAaaaAaaAaaaaAaa	AB=BEFE<6FHHFEFHFHGHFHHHHFFFDFFFFHFFFHHCFHBHFFHGFEHHCFHFFFHBGAGGGGGGGGGFGGGGGGFGGGAGGHHEFHHGHHGFFHGHFFGHF5GGGGFFFHFFAGGFGGGGG@GAGF=GG5DGG=HHGGGGGGGGGGGDCGGGGGGGGFEEDB@@?CD=	A	152	G	20	69	1	83	19	0.00040
6	32557478	C	80	cCCcCcCcCCCaACccACCcCcCCaaCCCccCcaCAACCCcaAaaACcACCcCcaacaaacaacCaaacaaaccaccccc	?>EA:AEBG?GFFFBBFGFBGBCFFFEFGBBFCG>CFGFGCGFGGFFCFGGCECGGCGGGCGGCEFFFCGGGCCGC@C>;	C	52	A	28	26	7	26	21	0.03492
6	32557506	T	61	TtTTttttTttCTTCCCttTttTTtTTCtCttttttttttcTtttttttttttttttTttt	C?A?CBDFGAEDEGDDCEEFEEGGEGGDEDEEEE@EEFDEFGEEFFFEDFFCE:FFFF?AB	T	54	C	7	13	6	41	1	0.00273
6	32629859	A	83	gAGGgaaAaAGaagaGGgaaagGGagaAGGaGAagAgaagagGGgaaaAaGaaaagAaAAaAaaAaaaAaaaaaaAaAaAaaa	?;;=@BDDFFAEFFF@CFEFFFCCFFDBCCECHFFHFFFFFDCCFFFCHGCFFFGGGGHHFHGG=GGFG@GGFGCGEGGFDCC	A	58	G	25	16	13	42	12	0.04498
6	32713598	T	187	TTttTtTTTttTTTttTTtTTTttTTtTTTttTtTTTTTtTTTTTTTTTTtTtTTtTTtTttttTtTttttttTTTtTtTTTTtTCTttttTtttTCtTTttttttTttTTttTttTTTTTTTtCttTTttTTtttCttCTttTTtttCttttTtTTTTTCttTCttTTtCTCTTTtttttTTTttt	=>AA?CCCDFEEDEECEEEEEEEEEDEEBEEEEDBEE@ADEEEEEEEECEE<EEDEEEEEEEDFEDEEEFFFFEEEFEEEDDEFEGDFF<DEEDFEFBEEE?FEFFDDCDDFFAFFDDDDDCCFFFEDD9FDCGFFFFFFDDFDDDDEFFEFFDFDDDDDFEFDFFFDCEFCFEDDBA?A@?@A?CB	T	177	C	10	91	10	86	0	0.00202
6	32713602	T	189	TTttTTTttTTtTTTttTTtTTTttTtTTTTTtTTTTTTTTTTTtTtTTtTTtTttttTTtTttttttTTTtTtTTTTtTCTttttTtttTCTTttttttTttTTttTttTTTTTTTtCttTTttTTtttCttCTttTTtttCttttTtTTTTTCttTCttTTtCTCTTTtttttTTTtttCtTtcTtC	@?CDFGGFEGGFGGGGGGGGGGG>GGGFGGFGGGG9GGHGHHGGDGGG?GGGGGGGGGGGFGGGHHHGGGGGGGGGDFHGDGH@GEGHAHGCGDHGHHHHGGEEGGC;HHGGEEEFFHCHHFFBHGFHHHCHHCFHHFFHHHCHHHHFHFFFFFCHHFCHHFFHCFCFEFHHHHHEGGGD@A?C>=D@C	T	176	C	13	91	12	85	1	0.00695
6	32713608	G	202	GGGggGGgGGGggGGgGGGggGgGGGGGgGGGGGGGGGGGgGgGGgGGgGggggGGgGggggggGGGgGgGGGGgGAGggggGgggGAgGGgggggGggGGggGggGGGGGGGgAggGGggGGgggAggAGggGGgggAggggGgGGGGGAggGAggGGgAGAGGGgggggGGGgggAgGgaGgAAAAAgAgaGGGggGGGa	>>;AA==B>@7DDCCFCCADECF8CCCCEAC@CBCCCCCCFCFCAF@DEBFFEF>CDCGFFEEECCCGCFCC@BFCFCGGF@BFFG@HABCGBGFGCFGCCGD=GFCCCCCBBFHGFCBDGBBGGFGGGGBEFBBGGFGFFGFBGBBBBBGGFBGGFBBGGBGBBBFGGGFBBBFE6FEBFEBFGHGGGEFBB=?<@>CC@C	G	182	A	20	95	17	87	3	0.00769
6	32714164	T	119	tTTTTTttTttttTTttTTTTTTTtTTTtTTttTtTtTtTTTtTtTTTTTtttttttTTTttTTtttTttTtTTTtTttTTtCtCttCTCtttCTtcttTCtTTTttCttttTtttttt	ABABEEFEDEEEEGGEEFGDGGGGBGGEAGGEEAEGEGDFGGFEFDGGGF?FFFFFE=GFEEFGFFCGFFFFE=GFEEEGGE>FCCFCFCGGFC@FEEFFCEFFFFECFFFFFED@?>>	T	111	C	8	52	7	59	1	0.03219
6	32714168	A	118	AAaaaaaaAAaaAAAAAAAaAAAaAAaaAaAaAaAAAaAaAAAAAaaaaaaaAAAaaAaaAaAaaAaAAAaAaaAAaGaGaaGAGaaaGAagaaAGaAAAaaGaaaaAaaaaaaAaaA	>>A?CEEEEEFF6DBEEEEFEFEEEEFF7FEFEFEDEGEFEEEEEGGEGGGFDDEGGEGGEG?FGEGEBEGE=GEEGFGGGGGDGGGGGCGH7GDGGDCDGGGGGGGDGEFCFB?BB?	A	110	G	8	50	7	60	1	0.02833
6	32714210	G	107	GGgggggggGGGggGggGgGggGgGGGgGggGGgAgAggAGAgggAGgaggGAgGGGggAggggGgggggggGggGgGGGGGgGggggGgggggGgGgggGGggggg	EEC?@A8BCHGHCBHBBGCHCCHCGGHCHCCHGCFCECCEGDCCCEHDFCCHEDHHHDDEDDDDEDDDCCDDGCD;DHHFGGDHDDDCFEDDDDGDGDD:GGCDCB@	G	99	A	8	35	7	64	1	0.00574
6	32724324	T	133	TTtTTTTTtttTTTTTTtTtTTtTttTTttTTtttttttttTtcttttttTTtttccctctCCccttcTccttctttTtctccCcttcccttTcttccccTctctTttcccCtttCctccctcctccttttct	C?AAABBDEEDCEFFFFDDBFEBCDDFFDDFEDBCCDDDCBFEFDDDDDDF=DDDGHGEHEGFHHEEHEHHEEHEDEEEHDHHGHEBHHBBDFHEEHHHHFHEHEECEGBHEEEBFHFHHHEGHEFG@??=E=	T	91	C	42	29	5	62	37	0.01793
6	32729459	C	163	TTTTCCTTTTCtccCTCCCCCTCCtCCCtTtTcTcTTcTtTcccCTTttTTTTcCTccCTcCCCTCCCTcTTTCtTctCCTtcCTTTctTcCTCCCCCTCTCCTTCCTcTccCTttTTTTCTTTCTCTTcTcccCCCccctcTTcTtctCCTccCcTCTTTCt	C?A?<DFEFFFDGGGDGG@GGFGFDGGBDEDFGFFFFGFEFGHGGFEE?FEEF<GFGFEFGFFGF9GCEHFFFFEDHEGGCEGFEEEH7EHFEFEEEFEFEEFEEEFEHED8EEEEEEEEFDEEEEEEEFEHHHDEECHHEHEEHE6CBGFEGGCC@@CC?@@	C	83	T	80	50	63	33	17	0.01140
6	33647594	C	64	CAACCCCAACACAAAACCCACCcccAAAAcCACCCcACCCCCacACcAAccAAACCACccCCCC	GFF@GGGE?GFGFFFFGEGFG=CCC=EFEBFECFECDFFFFFGCAF7EECCDEDFFEC?:=B?C	C	40	A	24	29	23	11	1	0.02303
6	40400288	C	95	ccCCcCCTcCCTctctCTCTTTCccTtctTTTCTCCccCctcTctccCcTcCTTCCTTTCTcCTtTcCCTCcTTcCCTCTtTCcTTCTcCTTTCc	A@?EBGG>5GGFBGBGGFG@FFBB=FHCHEBCF?FGCCECHCECGBCFCDCEE?FEEE?FECEEGECFEEECE?BCFBFEHEDBEDFC>A8BBA;	C	54	T	41	29	33	25	8	0.00886
6	47646842	A	82	AaagAAAAggAAgaGgAgGgaaaaggagAaaGagAgAAaAgAGgaAAaAAgAaaaagAgagggaaaAagGagagaaaAagaa	ACECHHHHCCHHCFCCHCCCFFFFCCFCAFFCACGCHHFHDHCDFHGGHEDHGFGGDCDGCDCGGFGFABGDGDGHGGGCGF	A	53	G	29	22	5	31	24	0.02909
6	57415309	G	70	ggggggcGccgcggggGcccgGccgGccgcgcgcgcgccgcgcGgcgggcgggcgGGcggGggggggggg	C@BBABFBHFFGFFFD9GGGFCGFFBFGFGFGFGFFFHGFGFFCFGFFFH>DGGGBCHGFBGFEGGE?B?	G	47	C	23	8	0	39	23	0.04614
6	57467100	G	92	CCCGCGCGGCCCCGGCCCgCGGGGGGCCGGGGCCGCCCCCCGCCGGCCCGCcGGGCcCCcCGcCGGCcCCCcCGGcCCGcGGGGGGGGCGCG	AGGGGFGFFGGGF<GFGGEGGGGFGFFGFFFFFFFDFDFFFFCCFEFFFFFHFFFFHFFHFFHFFFFHFFFHFFFGFEEHFCEBB?CBCC??	C	51	G	41	43	40	8	1	0.03957
6	57472316	G	106	GGGGGGGGGGGGGGGGGGGGGGGGGGGAGGGGAGAgAgGAGgAgGgAGAgAGGGgGGAGgggGGggAGGgGGgGGGgGAggAAAGgGgAgGAagGgGgGGggGAAg	GGFFFFGGDGFGGG<GGGGGGGGGGEGF9FGDFFFGFFGFGAFGFGEGFGEGFFGFFEEGGGFFGGEFFGFFEFFF;FE7GEDEF?FGDGEEFFGFD@BC<?BC@=	G	86	A	20	60	19	26	1	0.02153
6	88140811	C	122	AACCCCCCAACaAAACcACcACCACCAAACCcCccAAaCaAAAACCaCAAACCCCaACCCCACCAACCAaAcCCaaCCCCAaaCCccCaCCCACaCCCCACaCacCaaCCaccCacCCaccc	B>?@FFFGFFFDFFEFGBBGEFFFFFEFFFFHFHHFEEFEFFFFEFEGFFFGGFGEFGGFFFFFFEEFEDEHEFEEGEEEDEE<FGGFECFFEF?EFFEEFCEE>DEEFFEHH7CADCAEE@	C	72	A	50	57	31	15	19	0.04256
6	109993291	G	64	agaaaaaaaaagaaaaaggaaaagagggagGgGGaaagGgGagAAaGagaGgAGGGaagagggG	AACCCBDEFEEAFFFFFFFF@FFDFFFEFFFGDGGFGGGGDGGF:GFGGGFGEEFF;GGEA=??	A	34	G	30	3	11	31	19	0.01353
6	129478893	A	107	AaAAGaaAAaAAaAAaaaaAAGAGaAGaAGAaAGAGAAAAAAAGAAaAGaGAAAAAAAaaAGaGAAGaAGAaaGaaGAGAGaaaaaGGAaAaaaaaAaAAaAaAGGa	@EEEHFFCEE@EEEEF<DEAEHEHEEHEDHEGEGEBEEDDDEEHDCDCGFGDDBDDDDGEBGGGDDGFDGDGGGCGGDGDGGGGGEFGCGDGGGEFDFDCC@=ACC?	A	85	G	22	48	22	37	0	0.00003
6	129478911	G	125	GGgGGGgGGggggGGCGCgGCgGCGgGCGCGGGGGGGCGgGCgCGGgGGGGGggGCgCGCgGCGggCggCGCGCgggggCCGgGgggggGgGCGgGGgGCCgGgCGggGGggCCcGCCgGgGgcg	CDA>>GCGGFBCFGFGGGFGGCG=GGFGGGAGDGGFFGGGGGGGGFGF9GGFGEGFEFFGGGFFGGFBGCFFFF@GGGFFFFGFGGGHHFGFFFGEFDFFFGFGFFGGFFFGFFGEFFFGFEDA?	G	96	C	29	52	27	44	2	0.00006
6	148829910	A	48	GGAGGGAAGAAAGaGGGGGGGGGaGGAGAGAGaAGGAaAGAAAGGGGG	EEEEEEE:DFBEEFEEEADDEDDGDAEDEDEDGEDCDFDDD@69AC??	G	29	A	19	29	15	0	4	0.01992
6	150343148	A	86	AAcAcacCaAcccccAcAacAAaAcAAaAccAcAAccaacAAaaaAcaaAaAAaaaaaaaaAaAAaaaaAaAaaaaaaaaaaaaaa	?;<=?B@DD;ACBA;EAEFBFFFFBFFFFBBFBFFBBFFBFFFFFEBFFFFDEFGFGGGGGFFFFGFGGEDEGFGGEFGEFGGBBD	A	67	C	19	26	1	41	18	0.00473
6	152420095	G	80	ggGgggGgagagaaggaGAgGaGagaaagggagggGgGaGGGGGGAaagaaagaAaaagGagaaAgaaGgggggggaaaa	A@;AAA?BEBFBFFCCFCHCDFDFCFFFC@CFCCCCC9E:CB<CCGGGCGGFDGHG:DCCGDGGGDGGBDDDDDDDCBCC	G	46	A	34	15	4	31	30	0.03596
6	155565090	C	62	CTTCCCCCCCCTtCCTCCCCTTTTtTCttcCTTcTCTTttttcCCCTcTTttCCCCcCtCCT	GGGBDGGBFFFADEEGGEGGGEGGEGFEEHGGGHFG<GED7EHFFAFHFFEEFFFFAFEABA	C	33	T	29	28	18	5	11	0.04832
6	155569168	C	116	CTctTtTtTttttCTCtTCcCTcctCTCTtCtCtcTCctccCtttTcTTtCCTttcCCCCTttCCtcCCTTtTtCtcttTTtCtCcCCctttcccccCCtCCccctCcTCCcCTct	ABC??B@DCD5<GFGGFGGBGGBBGGFGGGGGG<BFDBCBBGGGGEBGGGGGFGGAFGGGGHHG;HCGGFCHGHGHBHHDEHGHFCFF6HHIACCCCFBHFFCCCHFCFDCBDC==	C	59	T	57	34	22	25	35	0.04375
6	158923434	G	120	CgccccccCcCgCcgggggcGgcGGCcgccgGcccCggcCGgGccccGGcgcGcGCCcGcGccGCGggCCgcGcCcGGgcGcgGcgGcgGCGcccGcCGCcgCGgcCcgcCCccGcCGGg	ACC??BBG>FDECFFFFFFFCFFCADFFFFFAFFBDFFFECFCFFFFCCEFECG<C7GAGBGGCDCGGDDGGCFDFCCF9CGGBG7BD>BCBGGGBGCBCGGCBCECGGFBBE@BFC?@B	C	67	G	53	21	28	46	25	0.02457
6	160132250	A	26	AaaaaAaaaaaaAaaaaaACACCCCC	>A??=GEECFFFHGGG:GGCGCCCBA	A	20	C	6	5	6	15	0	0.00201
6	160133337	T	112	TtttTTtttTTTtTTTttTtttttTtCTtTtTttTtTTCttTTTtTtTTCTTTttttTTtTTttTttttTTTTTtTTTCTtTTTttTttTTttCttTTTCtTtTTCCTCtTt	BCDDC=DDCGGGD9GFDDGCDDDDGEDEBFEGDDFEGDADDDGBEGCGG;GGGDEE7FF;GFC>FBE6EFFFEGEFFEFFCFFF?CFEEFF@9FB?FFFF8GACDB>CA@C9	T	103	C	9	54	9	49	0	0.00468
6	166576161	T	49	TTttaaaaTAaaTTTttTaaaTtAtaaaaTtaaAataTtTtaatttaat	CACCCDDEDHEEGGGEEGEEEGEHEEEEEGE@FHCFFGFF9CFEFFDFE	T	25	A	24	11	3	14	21	0.02548
6	167411314	T	44	cCcccTTtcTcTtTcTcttTTTTTTTTttttttTttTTtTTtTt	BHBBCEFHCE>DHEDECHHEEEDEEE7HFHHH7EHHDDFDBBB@	T	35	C	9	20	1	15	8	0.02269
6	169632219	G	252	AGAgggaGgGAGAAGgggGGGAGAGGGgAGGgAggGggGGAggAGGGaaAGGgAAaaGGGggaGAGAAAGAAGgaGaGGAGGgGGAggggAgGGGGGggGggAAGGGGGGgagAAGAAGGaGGGggGAAGGggGgaaGAgGaaaaAaggaAaaggaAGGAGagAGGgGGgaAGAgGgggAggGAAgggGgaggAaggggGgAGgAGgAGGGaAGAaAGAggaAAGGGgAGAAGgaAggggaAAggAgAAGGA	A=@@@CCAFCFEFFEFEFEEEEEFEAEEFEEBFFEEEDEEFFDCFEEE=GEECFBEEEEEFE=EFEE9FEFFEFFGDEEEEEDBEFCEFGEGEDDEEGFDE=EFEEEEEEF<FFFCEFEEFEEEFFEEFEDEBEG5EEEGEFFFFEFGGFEFFFFFFECEDFFFDDECDCFEDEFDFGFEGFDEEHGFDBFFFEFGFFFDGEDGEDGEDDDEEDEFE6EF@FDEDDDGEDEDCGED6FFFFDFDDDB?ABC>	G	160	A	92	86	62	74	30	0.04593
6	169648767	G	168	aGAggggAgGagGGaGggGGaaAGggggAgggagGAAgaaggggAGgaGgaaAGggAgagaggggggAGgaAggaagAagAAGGgAGaaAGAaGAgagGggaGgggGAGGAaAgAAgAGgagGAaAGaagAGagagaaGAAggggAaaagAgggAGGggAGGgAAGGA	?;@@@A@ECBEFCBECFFCAFFFCFFFFHFFFFFAHHFFFFDFFH>FEDFFEHC6FGFFFEFGGFFDHCGGHGGGFGGGGHHCCFHCGGFCHFCHBDGB?GFBGCECGCCHG7GGGGGBGGGBGGGB=DHGBGGGGGGBGGGGGGG;GGGFEGCHBCEEC?=<@BCC?	G	98	A	70	34	36	64	34	0.03899
7	810219	T	102	CCCctcCTtTcCtttCTctTtTTCCCCtCtCctTCCCCCtctcCtTttccctCcCCttTttcCcctcccctcttcttcccttcccCtccTctctttTcCttt	D@<?;>B<HFBFGGGGFBGFGFCEGFGGGGFBGFGFFGFGBGBFGFGGCCCGFCEEHFFHHCECCHCCCBHCHHCHHCCCHCCBCEACCE@GBGHGECDHD@	C	55	T	47	24	11	31	36	0.03791
7	5965381	G	34	gGaaaagaGGGaaaGGgGgaaggggaggaaggag	@EDEFEFFGEFFFEEGGGGGGGGGDFGGFEGGFB	G	20	A	14	7	0	13	14	0.02621
7	6204999	A	130	CCcCAcCAAAcAAAAAaAAACCAACAAaAACAACAaCCCAAACcCaCAaCAACcAAACcaaAaacCaCacAacAACcACAAaaAacAccCcacaAAccacAAAACAAacCAAAacaAcAAAacCcccaaA	A>BDFADHHEBDC:@5F;CCDBHHDAHFAHCH;@GFDDDGCEDBCGCHGDHHDCHHHCBGGHGGAAGCGCGGCGGC9GCGGGGGGCGBCCCGCGGGCCGAGGFFBGFFCCFHHEBEF?DD;B;@<:<;@C	A	79	C	51	55	26	24	25	0.04164
7	6820535	A	91	GAaagaAgaaAgAagaaAAAaggaagaAggAAgAaAaagAggggggaaaagagaagagAgagagagaaaagaaaagagagggaagaaaaaa	B?CCAB?CCDEFFEEFDFEFDFFFFFFFFFFFFFDFFFFFFFFFFFFFFFFFGF<FGFFFGEE@GGEGEGGFGDEEGGD?CGGGCGFGFGF	A	58	G	33	14	1	44	32	0.00836
7	6854372	T	214	TTtttTTTTTtttTTTTTTTtTTTTTTTTTTTTTttTTTtttTTTTTTtTTTTTTTttTtTTtttTTTtTTttTTtTTCtttttttTTtttTTtttCTTtTttTtTTTTttTtTTtttTTCTtCTTTTtttTTTttTTTttttTCCCTTttttCTCttttTTtttTTttTTTtTTtTTtTTtTTttCTTTtTTTttttCTCCttTCTCCttttt	>:FGGFDEFEFGGCFCFFF?GEEEFFFFFFFFFFGEFEBGGGFFAEFFEFFEFFE8HHEHEFHHHFEDHCFGHFAHEFDHGH=HGHFFGDGBFHHHGFFGFHHBHFDEEHHEFEDHHGEEEEHFEEEEHHIEEEFFEEEHIEHE?FEEEHHHHFEEFHHFEEHHHEEHHEDEHCEHEEHEEHEEHHEEDBGDEEGHHHDEGEGDCBBA@@@@C@	T	198	C	16	111	16	87	0	0.00025
7	6854511	C	92	cgccgcCcgcgCCCccCgCcCCcCgcCCccgCgCgccgccCgggcggcccCgccgccccccCgCggccccccccCcccccccccccgcCccc	??==B?CBCBBEGGBBECGBGGBGCBGGB=CGCGCABCCBGC=CBC@@BBGCCCDCCBACCFDDDDCC?ACA:CFCCC;CCC@CCCDBFB?>	C	71	G	21	19	0	52	21	0.00512
7	29720404	A	81	aAAAagagaaaaAAgAaaaaggaAaaagaAAAagaAggAgagaagAaagaggagAAaAgaAaaaAaggAaAaggaAAAaag	=>?ACEDEDDEECFFEEDEEFEE:EEDEEBDFFGFFFFFFFEFEG?FFGFFFFFFE;DGFEFF?EFHHBGEFFGFEDC?@:	A	59	G	22	23	0	36	22	0.00020
7	38389291	T	133	TtTTTTtTtTTTTTtTTtTTTTtTttTTtTttTtTtTttTtTCCCCtCttTTTCCtCTTCtttTTttttttCtTTCCtCCttCCTCtCttcCtCTTTTCTCtCTtTCCCCttTTCCTCTcttCTTttTtttTt	CCEEED:EDDEEDDDEEDEFEDDFDEEEDEDDEEEE9EEDEEFGGGEGEDCEEGGEGEEGEEECEEEEEEDFEEDFFEFFEEFFDF:CEEGFBFCDDCFDFEFDDDCFFFEBDDFFCFCHDEFDD>=@@==AB	T	100	C	33	51	31	49	2	0.00000
7	39606107	G	175	GGaagGGGAaAaGGgGaAaggggaAaaGagGGaaggGAAaAGGAgAAGAGGAGgaaaaGGagGagggAAaAagagaGGAaGGaGaGGggaGGaaaaGAaggaAaaAGAggagggGaaaggagaGGgaAaAggggggaggaaagAaGGGgGgGggGgaaagAGGGAgagGGagaag	>6:BC@<?GEFEC=DBEHEFEFF:HECCEECCEEEECHGEHCAFFCHCHCBHCFEEEEC;EE>EEGGHHFHEFDFFCC<FBC>CFB?FGFCCFFFECHEGFFHEFHCHGDFFFFCFFB?GFFFCBAECFFFGFGGBFEFFFDECF8?>GBEAGFBGDEEFGB>BFFFFABEDBAB	G	95	A	80	46	25	49	55	0.03019
7	44081449	T	126	TTTTTTTccTtTTTtTTTTtcTtTTtTttttTTTTtcTTTTTTcttTccctTTTctttcTTTtttTTttttttttTttTttttTTTTttTTTttTttttTTtttttTttTtTTtttttttttTTtt	BD?DB@BC>;DADGGFGGFGBGGGCGG?GGGGFHGGBEGGGGGCGGGCCBHGFFAHHGCFGGHGFGGGHHHDHGBGHHFHH:HFGGFGEFGFHHFHHHIFFHFIHEFHHFHDEDHHGHHHFDDAC>	T	116	C	10	56	0	60	10	0.00224
7	45142834	G	30	gCCGGGgGCgCggCCCCgCCCCcCGCCGcC	>DACCCGBCBC?<CCCCGCCCCECABBCCC	C	18	G	12	16	6	2	6	0.03415
7	48965141	A	117	aaAaAaaaaaAaaaaaGAAAAaaaGaAaaaaAAGGaaaaAaAaaAAaAaaGaaAAGaaaaaGaAaaaGAaGAAaAAGAaGaAGGaGAAGGGAGAAaaGAAGGAGAaAAAAAAaAAAA	CD:C?EFF?EHFFFFFCHHHEFFFCFHFFFFHHACCFFFHFHFFHHFHGGCGGFH;GGGFGCGHGGFCGGCHGGGHB9ABFGB9BBEHBBBGBGGGFBGGBBGBGGGFCGGGGGEEE	A	95	G	22	44	22	51	0	0.00000
7	48965308	G	138	aggGaGgggGaggGGGGaGgGGagaGgGgagaGggaGaGgGagaGgGgGggGgggagggggagggggGgggggggGgggGGGggGgGGGgGggGgGgGGgGGGggggGgGgGggGgGGGgggggGGggGGGgGGGGga	ACA?C;A@@>C>ACFGGFGCGGFCFGCGCFCFGCCFGFG?GFCFGCACDCBGCCCFC:CCCGDCCCCGDCCDDDDGDDCDGGDDGDGGGDFDDDDGDGFDFFGBD?DFDFDFE@FDFFFDDDDDFFDDFEFBDBB?AD	G	123	A	15	53	0	70	15	0.00049
7	48965427	A	234	AAaaAAAAaAaAAAAAAAAAAAAaAAAAAAaAAaAaaAAaAAAAAAAAaAAaaAaaAAAAAAaaAaaaaAAAaAAAAaaaaAAaaaaaAAaAaAGAAAaAAAaAAAGAAAAaaGAGAgAGaaAAAAAAAAAGAAAAaaAAAaAGaGAGAAAAGAaaaAGAaAGAGGaAGAAAAAAaAaaaGAGaaaGGAaAaGAAAAAaaGAGGAAGGaGaAAaaAAGaAGaaGGAaAaAAGGa	@>BCCCEHEGFHEHHGGHHHHHHFDHHHHHE;HFHFFHHFHHHHGHGHGHHGAHGGHHFGHGFGHFFGAHHHDHHHHGGGGHHGGGGGGH;GDHAHGGEGGGDHGHBGGG@DGBGBGDGBBBEGGGGGGGGBGGGGGGGFG;GBFBGBGFGGBGGFGGBGGGBGBBEGBGGGGGGGFGG@BGBFGGBBGGGGBGGGGGGFAGBAGEAAGBEFHF@DF@CC@BA>=BBB@CCC?C	A	201	G	33	132	32	69	1	0.00006
7	48965435	C	254	CcCCCCCCCCCCCcCCCCCCcCCcCccCCcCCCCCCCCcCCccCccCCCCCccCccccCCCcCCCCccccCCcccccCCcCCcCTCCCcCCCCcCCCTCCCCccTCTCtCCccCCCCCCCCCTCCCCccCCCcCCcTCCCCCCCCcccCCCcCCCTCcCCCCCTCCCcCcccCCCcccTTCcCcCCCCCCcCCCCCCTCcTcCCccCCCcCCcccTTCcCcCCCTcCccCcCccCTCCccccCCtccCcccCTT	AC?@CDDEGEEGEAGFGGGGB:GBGBBGEBGGGGGGEGBGGC6GB>GFDEGCC9CCC=DDGCGGGGCCCCGGCCCCBGGCGGCGGGGFCAGGGCFGFGGGGG:CF9GFHFF>;AFGFGGGEFFF5FFCCGFF:FFCFCCFFFFFF@CCFFFCCFCFFCFFFFEEFFFBDCAACFFCCCDFFCFCFFFFFFCFFFFFCFFCDCFFCCFFFCFFCACFFFAFCFFFECFACEBFB?BCBC??7?9B@<;A>;;CCC	C	234	T	20	154	18	80	2	0.02575
7	55560207	C	82	tcTTttCTCttcttcttCcCCttccttctCtttctttttctCctttcttccCtcCttttctctcccccCtctccctccctcc	A<@EGGBGCGG>GGBGGDBDDGG;BGGBGDDGGBGGHGGCGDCHHHC;ECCCHBDH=EHAGBHCCBCCDHC@C8CHABCHC?	T	42	C	40	3	10	39	30	0.03536
7	63679733	A	53	GGAGaAAaAaGGAAGAGAGGaGGGaAgAGAagGagaGgGaGAGaGGgAagGGa	CDFEDBFFFFEDDF?EEFE;GEAEGFDECEGDDGDGDDDGDEDGDD@DA?A@D	G	28	A	25	22	13	6	12	0.04916
7	65159983	A	35	AGGAaaAaAAAGAGAGGGGAGAAAaGaaaGAaGaA	=GHBFDEFEEE;EHEHGHGDGDCDFGFFFGDFG?@	A	23	G	12	14	12	9	0	0.01458
7	65228273	G	123	GGGGGgGggGGgGGGGGGGgGGggGggGGGgGggGggGgggggGGGggAGGAggGgGgGGGgGggGGAGGgGGgGgggGGgGGgggAGGAggGgggAGggggggAAgggGgggGgggGAaggg	@=@BDEEEFEEF<E@EEEEFEFFEEF79EE=EFFEFFEGGGFGEE@AGFDEFGGEGEGEEEGEGGDDEDEGDEGDGGGDBGD?GGGEDDEGFDGGEEDGGFGGGEEGGGDGGGDGGEDF?@DD	G	113	A	10	53	9	60	1	0.01673
7	99816275	G	79	gccccgGgGcgcggGgcGcgcgcgcggcggGGccccggcccGGGggcggGgggGgGgGggggggggggggggggggggg	CBDDDF;FCDFDFFBEDADFDEDEDFEDFE@CDDDDGEEEECCCGGEGGCGGCCGCECGFEGFFEGG>GFEFFFGFCGE	G	59	C	20	13	0	46	20	0.03127
7	99816285	A	79	aAtataaAatAtatatataataaAAttttaatttAAAaataaAaaaAaAaAaaaaaaaaaaaaaaaaaaaaattattat	C>A<@CDEDCEDDCDDDDDDDDDECDDDDDDDDDEEEDDDDDECDEDCEEEEEECDEDEEEEE?EEECEDEEECEDA>=	A	58	T	21	12	0	46	21	0.02969
7	102023153	T	29	TTttcTccccttccTtTcctctTtTTttt	CEFFD9DCECEEEEGF6DEF8FFEFFEED	T	19	C	10	8	0	11	10	0.02652
7	102023159	A	29	gAggGgggaaggAaAggagaAaAAaaaAA	C;6EBFE8EDEFHFEFGEFFGFGGFFEGC	A	17	G	12	8	1	9	11	0.04317
7	102136550	G	145	AAGAAAaGAAAGAAGAAGAGgGAAGAAAGGAGGAAGGAAAAAAagAGAAAAAAgAAAAAGAGGGAAGAAAAAAGAAGAGAAAaAGGAAAAAAGAAgAAAGGGAGAGAAAAAAgGAGaAgAAgAAAAGAgAGAGgGgaAagAGAAG	BA@GCHFCGHHCHDAHFCHCFCFHCHBGBCHCBGECCHD@HGFFGHCHHHHHHGFHHHHCG?BBHHBGH:GGG<HEBGBGGGGB@BGGFGGFBGGGGGGBBBGBGBGGGGGGGBGBGGGGGGGGGF@F@FAFAF?BBB?@CAA?@	A	95	G	50	89	39	6	11	0.01209
7	102948040	T	121	CTTCCCCCCCCTTTCCCTTTCCCCCCTTCCcCCCCTcTCcTTCCCTtCCTCTTcTTTCTCTTTCCTCTCCTccCTCTTCTcTCcccTTTCTTcTTtcCtCTTccCTCCCcCCCCCTcTCTT	@=?FGGGGGGGEEE;GGEEEDGGGGGEEEGHGGGGE=EEGEEGFGDEEFDFEDHCDDFDFCCDFFAFCFFDHIDDFDDFDHDFHGHDDDFDDHDCEHFEECCGHECAEEGDCDDDCECAA?	C	71	T	50	55	47	16	3	0.02061
7	107822396	G	78	agGaGaggaaagggagaaGAAGgaaGaggGaAGAGaAagaGggagaaggGggaaAGGggGaGaggGaGaaaAaaagaa	CABFGFCCFFFCCCFCFFGFFGC=FGFCCGFFGFGFFFDGADDF5GGDDFDDGFFFGDDGGGGDBF=FGGGEEGD>?D	A	39	G	39	7	16	32	23	0.04572
7	128119379	T	253	TCTttTtTTtTTTtTtTtttTTTtttTttTTTTTTTTttTtTTttttttttTTTTtttTtTttTTTttTTTttTTTtTTTttttTtttTTTTtTtTTttTTtTtTTTtTTTtTTttTTTTTTtttTTtTTTtttttTTTTtTttTTTtTttttttttTTtttTttttttTTTtTTTTTttTttttttTtTttCtttttTTtttTCtttCtttTCttTTCTTtCCCTttTCCTCCtCtttttTTttTTttTTtt	?ABAC@DBA<D?CEFGEGGF9FFGGGGFGGBGGGGGEGGGGGGGGGGGGGGGCGGGGAGGGGGGGGGGFFGGGHGGGEGGGGGGGGGGGGGFF<HFGGGGFHGGFGEGGGGHGCHH:GFGGFHHHGGDGFDFHFHHGGGGHDGHFFGH@GHGHHGHGFGCHHFH:HGHHFFFGFFFFFHHFAHHHHHFHGHHFHHHGHFFIHHFFHHHFHHHFFHHFFFFEHFFFEHGFFFFFFHEHHHHHFEHGDBA@AA@@	T	239	C	14	113	14	126	0	0.00008
7	128119380	G	259	gGgGGgGGGgGgGgggGGgggGggGGGGGGGGggGgGGggggggggGGGGgggGgGggGGGggGGGggGGGgGGGggggGGgggGGGGgGgGGggGGgGgGGGgGGGgGGggGGGGGGgggGGgGGGgggggGGGGgGggGGGgggggggggGGgggGgggggGGGgGGGGGgggGgggggGgGggCgggggGGgggCGCCgggCgggGCggGGCGGgCCCGggGCCGCCgCgGggggGGggGGGggGGggCGGCGggg	C@BB@@C>C>DBFGGFFFFFFGEFHCHHHHHFFFGFHHFFFFFFFFHDGHFF@FFHFFCHHFF@HHFFHIHFFHGFFFFBHFFDHHHHFGGHHFFGFFHGHHHDHHHGHDGGCGGHGHGGGHHGHHHGD7GFHHHHGHGFHHHGGGGGGGGDFGFGFGGGGGGHHFGGGGGG<GGGGGGGGGBGGGCGGGGGFGGHGCGCCFHHCGGGGCGGGGCGGGCCCGGGGCCGACGCG<GGGGFFGGHF@AADD@?ACAC?<DE	G	242	C	17	115	17	127	0	0.00001
7	128587374	G	34	gaGaGaGaaGgagaGggGGGgggggGgGGGGGgg	AC>CCF>FFCCFCFCDDC;CCDDD?B?DCGGGDD	G	27	A	7	14	0	13	7	0.02621
7	129330353	C	131	ccTCTtTCtcctccCTtTCtCCtccctTTtcttttCtttCCTCCCCTCCccCCCTTcCCCctCcCccTCccttcctTccCCtttttctCcCtctcCCctttcCCccCcctttctcttccctttcctcccTt	C>?B>EBFHBBGAAGGGGFGGGABBBGGGGBGGGGGGGBEEEFGGGFEFBBGGHFG?DGGBG>BGCBGFACHGBCGFCCGFHGFHHBGGCGBBHCGGCHDHCGDCCFCAHGH;GCHFBCCHHHCAD?>=AA	C	76	T	55	33	14	43	41	0.04271
7	141537942	T	126	tTtTTTTtttTtTtTttttTTttttttTTTTTTttTtTTTttTTTttTTtttTTTtTTTTtTTTtTTtTtTttTtttTtTTtTTttttttTTttTtTttTTtTttTtTtTtTTaattaaaaaaAaa	@?B?BBADEDFEGEGE>EEGGEEEEEEF7HGGGEEGEGGFEFGGGFFBFEFFGGGFGGGGFGGGFGGF>FGFAFFFFFEFFFFEFFFEEEFFFFDFFEEFFEFFEFFFEFFGFDCEDC<?A@@ABC	T	115	A	11	57	1	58	10	0.01091
7	143097100	A	81	AaAGAaaggggAAgaGgggAgAggagggAaggaAgaAaaAaAAaggagGAAaGGggAGaaaGgAgggAaAGAAAaAaAGAA	E?@=CCFFFFDHFFECFEEHFHFFEE=>GEEDFHEFHFEHFHGEGFEFCHGDBB=FHBFFFBGGGFFGFGBAGGFGFFBCC	A	46	G	35	26	9	20	26	0.00691
7	149318409	T	25	TTcccttTTcTcTctTctcTccTtC	;AABBGGEFBFBECHFAHCFCCEHE	T	14	C	11	9	1	5	10	0.01188
7	149318703	C	36	tcCtCccctttCCCcCttcCcttCccctcCCctcCc	B5GDGFFFEEEGGGFGEEGGFBFGFGGFGGFFFFFG	C	25	T	11	11	0	14	11	0.01503
7	149417230	G	82	gGgAGAGGGGGAGAAGGGggGGAGgAGGagAAAGGGgGGGgaGAAAAaGgAggagaAAgAggggAggAgggAgaaAggAaGA	EGFEHEHHGGHEHEEHGHCFHHEHFEHGGGDDEH=HGHHHFGHEEEEEHGDFGGGGDDGDGGGGDEBDEGGDGGGEFBC?C?	G	50	A	32	25	24	25	8	0.03714
7	151945101	G	530	GGgGGGGGGGGggGGGGGgGGGGGggggGGGGgggGGGGggggGGgGGGGGGgggGGGGGgggGGGGggggGGGggGgGGgggggGGGGGGgGGGGggGGGggggGGGGGGGGgggGGGgggGGgggGGGGGggggGGGGGggGGGgGGGGGGGggGGGggGGGggggGGgggGGGGGGgggggGGggGgggGGggggGGGGGGggggGgGGggggggGGGGGGggGGgggggGgGGGGGgGggGGGGGggggGCGcgggGGGCCgggGCcGCGCGgggCGCGGGggGCgCGGGGgGGCgCGGGgggCgCGGCCGCggCGGggcCCCgGGcggggggGGGggGGGGCgggggCGgggCCGGCgGGGgggCGGGgcGGCgGGGGGGggGGcggcGGgggGgGcggggGGGCgggGGgcggggggggGCCCGggGCGGGgggccgcCcggGGGgggGGggggGggGgggcgggGgggggGggggggCggGGGGgggggggGCGGgggcgGgggGcgcgcggggGgggcgggc	DBC@DB?D=;?6;BBAABBCAACDCCDDEFFFCBCGGGGCCCAGGCCGGGFFCCCCGGD:CCCGGGDCCCCGGDCCGCGECCCCCGGGGGGCGCFGCCGGGCCCCGFFFFGBDCC?HHFB?CGFCCCGGG:GCCCCGG>GGCC?GGCGGGGFGGCCFGGCC?G@=CCCCGCDDGGGFGGDCCCCGFDCGCDCFGCDCCGGGGGGDCCCGCFGCDDDDDGGGGGFDDDGDDDDDGDFFFFGDBDCG>GFGDDDDGGGCDDDGGG?GDDDGG@GGGGGCCDGGGGGGDDGGDGGGGGDGGGDAFGGDDDGDEFGGGGGDDD?:DDCAFGDGGADDDDDAFFF?DFGGFGDDADCFFDD7FFFFBDEF@D>DFFFFDCFFFDFC?FFCDDFFCEECFFDEBFEFCDDDDA<F@DDDFFDCDDDDDDDDFFFFFBBFFF9ADDDBCDCACDDFFED8DFFDD:DFDDFDDDCEDDCDDDDDFBDBDDDCCCGFEFCCCA@@A>BDC=??=?=<<>?<?5=><<8:CA>A=:AA9	G	474	C	56	235	36	239	20	0.04722
7	151945140	C	475	CTTCtCtTCctccctTTTCCCttCTtccccCtTCCCTtTcTCTTTctccCCTccttCCCCCttcCCcCCCCTttcCCCTTTctCCtCCTTTcCCCtCTCCcctCtCCCCCTCccCCTcccCCCtCTccttcctCCCtcCTTTCtctctcCCcttCCTTCcCCCtccCTTCccTCCcCTCCCCttCCccccCCctcTtCcccccCCTCctcCTcctcctcctcCCCCttCCCCTccccccccccCCCccTCttccTttCcttcctcCttccttCttttctCctCTCCttctcttCCCCtctccCtccTccctcctctcTccccttccCCccccCTCCcccttcCtCCccctCCtctttCCttttcCCcccctCCcctctCctctttccctCtcttccttccccctccttcttcCctccctccttccctcctCCccctcccttCCCctcCtctcctCccccCCCCctccctccCccC	BBBCC?B@A8D>?@DCCCB@BDE?EHCABAFGDEEEFFFAEEFFFAGBAGFFBBGGGGFFFGGBGGBGFFFFEGBEGFFECBGGGGGGFFFBGEEGGFFEBBGGGFFDFFFFBB?FEBBAGEEGGG@BG:BBE9FGGBGEFFDGBG;G@GGBGGGFCF=BGFAGBBFFFGBB;GABGEAEFEGGGGCCCBFFBG>EDFCCCBBGEEGBGCAFCCHCCHCCHCGGFEHHEDG9FC9CCCC@CCCFGFCCEEHHBCFHHECHHC>HCEHGACHHGGHGHCHGCHGFFGHHCHCHHGFFFF=HCBFFCCECCCHCCH?HCEBCCCGHCCFDBCCCGFDFCCCHHCEHFECCBHGEHCHHHFEHHHABFEC=CCGFECCHCHECHBHHG>CDIFGAFHAAHHC7CBCHCCHHCHHCF;CACCHACHHCCCHCCHDFCCCHCCCHHBFFBHCFCCHCCHECBA?BBBB>C>=>C=<A<6?	C	313	T	162	139	45	174	117	0.00049
7	151945204	G	247	agGaGGggaaGGaaaaaGGaaagGGagaaaGGagaaaGgaaaaagggaGaaaagaaaaaggaaaaaaaaaagGgagagaaaaagggaaaaGGgggagggaaGGGgaaGagaggaGgagggGGGGaaggaaggGggGGGaGaGagaGgaaGGgggaaGGggaGagGgaGGaagaGGGGgGggGGGggggggaGGgGGgGGgGggGgggGGagggGGgaggaGgGaGGGGGGggGgGGGgGGGggGGaa	?@@=BAABAACACBBDCGGEDEFGGCDCCCFHDEDCCHFDDDDCEFFDGDDDDFDDCCDFFDDCDDDDDDDFH>DF=FDDDDDFFFDDDDHHFFFDFFFCD@G@FDDIDFDFFDHDDFFFHGHHEEFEEEFFHFFHHHEHCGDGEHGEEDFGGG=EHHGGEHDGHGEGHEEDEHH=GGHGFFHGG>GGEEAGGGGGGGGGGGGGFGGGGEGGGGGEEFGEFDGEGGGFF@GFFFGFED@DDBBCC@B	G	157	A	90	77	0	80	90	0.00000
7	151945215	T	212	tttTtctttttttcttcctcttttttttttttttcttttttcctTTtttttttttTTTttcTttttttTtctttTTTTctttctttTttTTTtTtTtttTttcTTtttttTTtttTctTttTTctttTTTTtTttTTTtttttttTTtTTtTTtTttTtttTTttttTTtctttTtTcTTTTTTttTtTTTtTTTttTTtttttTttttcTT	C??BB>CC>CDBB>@D?@D@HGHGHHG@FGFGFGAFGGGGGAAGFGGGGGGGGGG>GFGGBGGGGCGGGGBGGGGGGFBGGGBGEFFGGHGGGGGGGGGGGGBGCGFGGHFFHFGFBGGHHGGCHHHGGGFHGHHGGGHHGHGGHGG=GGHGFHFHHFHHHFFHHHHFFHC9HCDHFCEFEFFFHGFHEFFH<FFFHFFGHFHHEGGFD=CC	T	194	C	18	67	0	127	18	0.00101
7	151945228	G	190	GGGggaGggggggGgagggGGGGagggagggGggGGGgGgGgggGggaGGgggggGGgggGagGggGGagggGGGGgGggGGGgggggggGGgGGgGGgGggGgggGGggggGGgagggGgGaGGGGGGggGgGGGgGGGggGGgggggGggggaGGGGggGGggggGgggggGggaGGgaggGGGGgag	CD<C?C@BBABBCEECFFEGFGGDFEFDFFFFFFGGGFFFFFFFFFFDGDFFFFFGGFFFGCFGFFGFDFFFGGEFFGGFFGGGFGGGGFGGGDDGF<FGGGGGGGGGGGGGGGGEBGGFBGEFFFFFBEGFGFFFGEFFGGFFGFEGGFEEFGEFFFAGGFFGGGGEGGGGEFFFDDECACB>BC?B9A	G	177	A	13	76	0	101	13	0.00189
7	151962077	C	109	CCCcCCCCCCCGCCCCGCCCCCGCCCGGCCCcGCCCCGCcGGGGCCGGCCGGCCGGcGCGCCGGGGGCCGGGGGGCGGGGGGGGCGCCGGGCGCCGGCGCGCcGGGGCc	>AE9EGGGGGGGGFEFCFFFFFGFF9GGFFFEG?FFFG>EGGGGF;DGFFBGFFGG5GAGFFGGGGGFFGG;GFFEGFFBFFGFEGEFGGFGGFFGFADCAA=B@???B	C	58	G	51	52	51	6	0	0.02888
7	151970856	T	156	TtaaTtaTTtTTaaAtTaTtTTTtTTtaaaTaaaaaTTTaTaaaTTtattTTTtaaTaTTTttaaaaaataTTaaaaTaaaaaTataAataTTtttttaTaAtaTAaTaaATAaaatTttatattTTTtTTTttTTTTttTTttTTTttttttTTt	CCD8BEDDDGFBFFFGFFFGFFFGFD:FFCFEFFFFFFFFEGFFEEGEHHFFFGGGFGFFFHHEEGGGDGEFFFGFFFEGGGFEGHGEGHGEEHHHHHEFDEHGEEGEEGDEEGGGHEGFHIEHHAEEHEECHHEEEEHHEEHGDDEH6GGGGDCC	T	97	A	59	55	6	42	53	0.00000
7	155255332	T	170	TTTTCTCCTCTtTCCTCTCCTTTtCCTCCTCTTctttcTTTTCCCTTCCCCTTCTcCCTtttctCTCTctctCtTTTcCtctcCtttCCTCtTCttttcTTttttCTtcTcTcttCcTtTcCtTCttttTCccCCCcctttcCcCtttTcTttCCttCCttctCctttcT	C=B@;CABECEEA?DDDGDDGGGED?GD@GDGHFEEEFGGEGDDD>GDDDDCGDGFD?GF<FFFDGDFGFGFCFFGGGDFGFGDFFFDDADFDDEFE<FGGFFFFDGBGEGFGFFCGFFFCCFFCGEEFFCGGCCCGGEFFGCFCCFEFGEDECCCEDDE@B?@BAA>A?	T	97	C	73	46	48	51	25	0.01989
8	1581299	C	39	gcgggcccgCgcggcCgggcgggcggggccggcgggcgC	?>CDECCCEGFDEEDDFEEEED:EG?AGEEFEEFFFEGB	G	24	C	15	0	3	24	12	0.04979
8	2056421	C	42	TTTTCTTCTCCTTTTTTTCTCCcTcTTtTTCcTcCcTCCCTT	DEEEGEDGEGDDEEDDDDFDFFEDEDDFDDFEDEFDEF6BCC	T	25	C	17	24	12	1	5	0.03185
8	9436580	C	40	TttcccTtTctctTcctcctctccttcccctccttccctc	BBEEFFGEGFEFEEFFEFFEFEFFFFGGGGEGGFEFGEFG	C	22	T	18	0	4	22	14	0.03348
8	10465748	T	76	tCtCcctTCtCtCCttCTTCctCCCtCTCTCtTCTTTttTTctcttTtttccctttcTCCtccTTtCcttCTCCCt	BBFEDDEFGEGEGGEEGABGDEGGFFFFGFGFFE@FFFFEFEFEFDEEFFEDEFFFF?EEFEEE;FFEEEEDBBAB	T	42	C	34	16	22	26	12	0.03715
8	11619397	G	148	AAagGgaaAggGGagGaaagAgGaggAGgGAgaaAAAAAGaagaAaGGaAaGGaAGGAgaAaGgGGAGGaAGaaAAgaaaGGgaGAggAgaAGaagaggAgaGAAaaAaAaAaGGaaaGGGGaaGGGAAGGAaGAaAaGGAggaGGgg	BFCC;=AACAA>=CC?EGGFHEAFEFHCFCHFFFHHHHHCFFFFHFDAFHFCBFHCCHFFHFCFCCHCCFHBFFHHGGEGBCGGCHGGHGGHCFGGFFGHG6CHHFEGFGGFBBBGFGBBBAHGBBBGGBBCGBGGGGBBGEDB=>AE	A	80	G	68	35	41	45	27	0.04946
8	11666219	T	33	TtTTTTTTttTTTTTTTTTTTTTTTTCcCCccc	>EEEEAEEEEFDEFFFFFEFCEAFE8A>C?BBB	T	26	C	7	23	3	3	4	0.02294
8	11666224	C	42	cCCCCCCCccCCCCCCCCCCCCCCCCCGGgGGggggGGgGgG	C9AAACEEFEGGGBGGFGGGEGECGG>EEEGFEFFBBC:?@C	C	27	G	15	24	8	3	7	0.02015
8	21974032	A	54	AacaAccCccAaacaacacAaacAccAAaccAcaaaAAAaaaacaacacacacc	;9ACDDD7DCF;EDEDDEDFEEDFDDFFEADFDEFFEFFBFEEEFFEFEFC??=	A	33	C	21	11	1	22	20	0.01814
8	27743401	T	26	TTGGGGTGGGTGGGGGtTGGtGtTTG	GGGGGCGBGFDFFFFFEEFFEFEECD	G	16	T	10	16	7	0	3	0.04615
8	37455990	G	30	gCgCCCCGggggCGCGCGCCgcCGCcgCGC	D@F=GDGGFFFFGBGEGFF8GHFFFHGFFF	C	16	G	14	14	6	2	8	0.01869
8	41355096	C	90	TCTCCTTCTTTTCTCTTTTCCTCccTTCTcTTcTCCCCTTCCCTCCtcCCccctCTCTtCctTCTTTctCtTTcCTTTTccccTTtccTc	>?AFGEEFFE@EHEGECCEEGEEBBEEEDCEECEGEG@EEFFGDFFE=FFC=CHFCFDIFAHDFDDDCHFHDDCFDDDC;>>>A<C>>@;	C	45	T	45	27	38	18	7	0.01760
8	46844861	T	35	TGTTTtttttTtttgtGGtttTGTtGtGtTTttTT	A@CDFEECDEFEEEFEEDEEEEDDEDEDEEEEEEE	T	28	G	7	11	6	17	1	0.04075
8	101719121	G	226	gGGGgGgGGGGGGGGgGGGGGggGGGGGGggGGGGGGGgGggGgGgGgGGGgGgGGgGGgggGGggGGggGgGGGggggGGGGGGGGgGGGGGggGGGGGGGgGggGGgGGGGggGGgGGgGGGgGGGGGGGgGGggGGGGgGGGGGggGGGGGGgggGggGGggggGGggGgGAGGAGgGaAAAAAAAaaaaaaaaagaagaaGGGGGagaggGGGGgaGGGGaa	A=>?CBFCC7CAC=?FCCCCCFEB>C>C@FFCBCCCBAECCEAFCF>FCCCE7GCCGCBFEFCBFGBCGGAGCCAGG7ECCCCCCCCAB@CCCGFCCCCAB9EBFGBBGBBBBGFB@EBBEBBBGBB@BBBBFBBEEBBBBGBBBBBFFBBBBBBGGFBFGBBGEFGBBEEAD?DAAFBFAEGGGFGFGFFFFFFEFFFFFDFEBA@@@?BABB>??>6==AA@A?	G	198	A	28	132	9	66	19	0.00067
8	101719138	C	238	cCCCCCCccCCCCCCCcCccCcCcCcCCCCcCcCCcCCcccCCccCCccCcCCCccccCCcCCCCCCcCCCCCccCCCCCCCcCccCCcCCCCccCCcCCcCCCcCCCCCCCcCCcccCCCCcCCCCCccCCCCCCcccCccCCccccCCcCcCTCCTCcCtTTTTTTTttttttttttcttcttCCCCctccCCCCctCCCttCcccCCcCtcttCccCCtcCccccccccctttCc	C?AAA?>>==?DEBEFA:AAGBEBGBEFFABGBGGBGABBBDFBBGG@BBBGGGBCBBGG;GGBBGG;GGGGECBDFGFDA9CECCGEBGGGG9?GGAEGCFFGBFFEDFEECADCCCGFFF@FFFFFBCFFFFFFCCCFCCFFCC>CFFCCC=DFFDFDFHEEDDDEEEGHHFHHHHGDHHAHHFFFFCFCCFFFFCHF9FHHFCCBFFCFHBGHFCCEFHBECACCCABA@EDDB<	C	203	T	35	123	9	80	26	0.00017
8	101719201	A	289	AAAAAAaAaaaAAAAaAAAAAaaAAAAAAaaaAaaAAaaaaAAaaAaAAAGAaAgGggggggggagaggAAAAgaaaAAAAagAAAgAaaaAAaAgaggAaaAAgaAaaaaaaaaagggAaaAAAaAaAAaaAaaaaaaaaAAagAAaaaaAAAaAagAaAaaAgAAAaaAAaaagaaAAAAaAAAaAAaaAAAAAaaaAAAAAAaaaAAAaaaAaaaAaaaAaaaaAaaaaAaaAAaaaAaaAAAaaaaAAAAAaAAaAaaaAaAAaaAaAaAaaaaAAaaaaaaaaA	CCCC>>C?B=CAAABD:DDEECGDEDFFEEEFFFDFFEEEFFFFDFFCFFEEFFFEB>ECFFFFFFCCFFFFF>FFFDE=FFFF:EFFFFEFFFGFFFFFFFFFFFFGFFFFFFEBGFFFEFFEFEFGFFFGF@<GGEGGGFBGGEEGFEGFFFGFGGFFFFFFFFFEGFFFGGGFGFDFFFGFEFGFEGBFDEFDGGGEFEEEEGDFEEEEG?EGGEAGGGE?GGGEGGGCBGGEEGFFEGCEEC?GAGEEEDEGEEGEGGEEGEEGGEGEGDFFGEDBBAAA?@@??	A	261	G	28	127	2	134	26	0.00001
8	101721705	G	122	GGGGGgGGGGGGGggGgGGGGGGgGgggGGGgGGGggGGGGgGggGgGgggGGGGgGGGggGgGGgggGgGgGGggggggGGgGGGGGGGgGGGggGGGGgGGgTggTGGTgGTTTTTTTgg	CBHGHFHHHHHHHFFHFHGGAHHFHFFFHHHFGHHGGCGGHGHGGHG=GGG?HHHGHHHGFHEAGGGGGGGGHGGGGGGGGGGGGGGGGGGGGGGEGGGGGFFGCFGDFGCEFDCCBBB@@;	G	112	T	10	68	10	44	0	0.01341
8	101721727	G	152	GGGGGGgGgggGGGgGGGggGGGGgGggGggGgggGGGGgGGGggGgGGgggGgGgGGggggggGGgGGGGGGGGgGGGGggGGGGgGGgAggAGGAgGAAAAAAAgaGgagAAAggAAggggAggagAGgaAGGagggGaggggAggAAAg	DC<B@CAHBCCHHHCGHGCCGHHHCHCCH@CHCDCAGGHC;HHCCHCGFDD=GDHDHHCDDDDDHHDHHHHHHFHCDGHGDDHGGGDGGDDDDEGGDDGDDCDDDDEGGDEDDDDDDDD@DDDDDDGDDGBGDCGEDCCE@@AAAA>>CC?A	G	124	A	28	62	22	62	6	0.00634
8	101721839	C	183	acACCccCCCaaCCAcAaaCAcaCcaCaaCCcCaacACCcaCcACcACCCCCCcccaCaCCCcCccaCcaccaCCccccCccaaCCCccCCCccCCCccCcccccCCcccccaaCacCCCcccaCcccCcCcCCcCccCcCaCcaCCCCCCCaCCccCCCCcCCCccCCCcCacCCCcccCcc	C??@@CCDCCCEFFEFDCBFFGC;GDFDDGGGGDDGFGGGDFGFGGFGGGBGGGGFCGABGGGGGGCEGDDFDGGGGGGGFFDCGGGGHFGGHGGGGHHGHH@HHGGHHHBGE;GEHGGFHGHEFHHHGH;HCFHC6HFHFEEIDFFFFFBFEFFHEFFFFGDFFHHFEDGE>FFFCBBCACE	C	149	A	34	81	7	68	27	0.00049
8	101721870	G	159	aGGggggGggaaGGGggGGGggGGGggGgggggGGgggggaaGagGGGgggaGgggGgGgGGgGggGgGaGgaGGGGGGGaGGgGGGGgGGGggGGGgGagGGGgggGggGagAaggggaggggggggaaggggaggggggGggggggggggggggagg	?87BBAB@FFEDCC@FFBCCFFCCCFFCFFFFFCCCFFDFFFCFFACCFFFFCGDFCFADCCGCFGCGCG<GFBCBBC8CGC?GACCCG<BCGGB?BFBFGCBBGGGCGGBGGGGFGGGGGGGGGGGGGG=GGGGGFGGGGBEEGEFGFGFEBBEF<DB	G	140	A	19	54	1	86	18	0.00368
8	101721899	C	120	CcccCcCcCCcCccCcCaCcaCCCCCCCaCCcCCCCcCCCccCCcCacCCCcccCccCacAaccccaccccccccaaccccacccccccCcccccccccccccccacccCccaCacccCC	DCBCB>CG?GFGFFGFGFEFEGEEGGFGFEFF>GGGFDDGFFE<FGFFGGGGFFGGGGGGEGGGGFFGG@GGGEG?GGGGGGGGFGGB:GGGGGGFGDFGGFGGGEEGGFGGGFG;GFC?	C	106	A	14	38	1	68	13	0.03452
8	106813518	C	84	CcCgggGCgggggcgcggGGcCCCggGGgGCcccGCCCcGGCGCCCGCgcgCCcgCCgCCgcCGGcCCGCcgCCcCCCcGCcGg	>DCEEDEFFFF7FGFBFFEEG@GFGFEEGDEHHHEEGGGEAFEFFECE@HGEEHGEEGFEFHCDDHEFDFHGEEHEFEFCCB>B	C	47	G	37	31	16	16	21	0.04758
8	119296422	A	42	CCCACCCCCcAcCAAccCcCCcACACCAcACACCAACCcAAc	ACDHADDDDCHECHFDEAECCEFCECCGEGCGBCFDCCABC>	C	29	A	13	20	13	9	0	0.03817
8	134052225	T	75	CTTTTTtTTTTTTTTTTTtTTTTTTTttTtTCTTCCctTTCccCCcCtttCcccCCTtTctTcTcctCccTTTcc	AAC5GGCG@GFG<GFFGGEFFBFEDEE>FEFFCFFFHEFFFGHFFEFDDEFHHGFFEDEFDECBCC?ACBA??EB	T	48	C	27	36	12	12	15	0.01209
8	142445364	G	169	AGgAgAaGAgGAAaGaaAGAaAAgaGGaaggGaAgaGaGGGaaaAaagAGGaGGGaGagAaGagagGGAaggAgGagAgggGGaaaAGGAAGGAGgGAGggaagaGGaaGGgaaggaagGAaGAAGggGgGAGaaggAgaaAaGGgaaggggaaGGGgGggaAaGaGAg	=<BBFFFAHBAHGEBFFHBHFHHF?CCFFFFCFHFCCFCCCFFFHFEFHCCFCC@FCFFFFCFCFFCCAFFF@GCFFGFFFCCGGF=BBGGBCABGCH@GGGFFGCCGG=AGFGGGGGGCG>BHHBGFBGBGBGGGG?EGGGGBBGEEAGGGGGBAABBGFEDA:BCCD	G	90	A	79	49	30	41	49	0.04431
8	143959857	C	44	CcccccCcCcccccCccccccCcCcCccGccCGCcGGgGccGcg	C??=?BEBFBBBBBFBBCCCCGCGCGBCEC>EDEACCBA<CC>:	C	36	G	8	9	6	27	2	0.01255
8	144940230	G	126	gggGgGgGgggggGGGGGGGggGGggggGgGGGGgGggGGGGggggGgGGgGGGGggGgGGggCCGCCGGCCccGCcgCCCCCCCCCCCCCCCCCCCCCCCCccccccCCgCCCCGCCGcGcGCCg	@DBGCGCGC@CCCGGGGFGGDD:F@DDDGCBGGGDGDDGFGFDDBDFD<FBFFFFDDFDFFDCFBF?FEEFFCCECCCFFFEFFFFFFFFFFFFFFFEFFFFCAC@CCEF?<FGGEBCC=C<AAA?	G	74	C	52	40	41	34	11	0.00477
8	144940300	G	201	gGGgGGGGggGgGGggAGGAAGGAAaaGAggAAAAGAAGGAGAAAAAAGAGAAAagaaaaGgAAAAGAGGaGaGAGgAaagAggAGAAgaAAgaGaAAgaaGAgaaggAAAgGggaAAagaagggaaAaaggGGGAaggggggagaaggAGgggAaAAAAaaAGaaAAAAgAgggaAaaagAAaagggaAAAgAGgAaGAA	B<BECCCCEECECCFBHCCGECCHHED@EEFFHHH9FHCCH<HEHGHHCICHFGEFEAEEAAIIGIAHCCECECGCGHEBEHGEHCHGEDCHFFBDHHFFE>HFFEGGGEEGBGFEHHFFEEFGFAEHFEEGBB<FFGEEFGFFFCFFFGBGEGGEGGGGEFGBFFEGGGFGEFBFGFFFFFFFEEFGFHHHFD@BC>C?C	A	111	G	90	68	38	43	52	0.01037
8	144944161	C	112	CTcccTTTTcTTccTcCtCcttccCTTctcTtttccccTccCTcCCcttcTcccTTcTCTTTCtTtTTctTCtTttctCttTCtcCtctCcTtctCtcccTTtCctTCCcTT	A?<=<>ACDBEDBBFBDGDBGGBBDDEBFBA=FGBBABGBBDGBEDCFHBGCCBGGCGCGGEDHGAED=;ECAEHHCBCFGFCE>CIAHCCFHCEC>C@?FFHCCHFBC>DC	T	58	C	54	32	18	26	36	0.02353
8	145008931	G	189	cGcccccCGccgCcgcggCccGCGCccgGccGCCGcGGCcccggcccGGgcCGcGcCgcGGcgcggccGcGggggGccgcGCCggCgcgGgccGGgcCcccgCcCGCCggccggGccGggGgGcGGcgCCcgcgcgggcgGCcGggcGCCggccGGCCcGcGCggccGGcCCgGccgGgccGCgGgCcG	?;:<<>>?<??B@CDCDDCABADCDBBBCBBCDDCBCCDB5BCCBB=CCCBDBBCBDCBCCBCB?CBBDBC@CCCCBBCACDDCCDDCBCCCCCCDCDCCCDDCDCDDDDCCD@CCCBDDBCCCCCBDDDCDCDCCDDCDBCCBDDD>CCD<CCBBCCCBCBCDDCCBBBCCDBCCD?C9A>B?5==:5	C	97	G	92	30	43	67	49	0.03608
9	13175987	C	37	tCtcttCtccCtttctcttttttttctcctctctccC	CACBCEGDDDGEEEDED=EDFEEE?DDDEEE7EFEE=	T	21	C	16	0	4	21	12	0.02756
9	33796660	T	76	TtTttTTtTTTTTTtTTttttTTTTtTtTtTCTCTtCTtTCCTCtTCTCTCTCTCTTtCTCCCtcTTtTCTTtTCC	FGFGGFGGFDFGG7HG8HHHHFG?DHBHEHBFDFFG@FFFDFFFHFFFFFFFFDFFEHFCFECFBFEGDDEDD:A>	T	57	C	19	38	18	19	1	0.01658
9	33796672	T	98	tTttTTtTTTTTTTtTTttttTTTTtTtTtTCTCTtCTtTCCTCtTCCTCTCTCTTtCTCCCtcTTtTCTTtTCCCTCTTtTCCTCCCctTTTTTTtT	C?AEDEFDB>EEEFFEDGGGGEEEDHDH<HCGEGEHEEHDDFDFHDFFAFDFDFDDHFDFFDFGDCHDFDCFDFFFDFDDHCDFDDFEGCDED9BB@?	T	71	C	27	49	25	22	2	0.01738
9	33796673	G	101	gGggGGgGGGGGGgGGggggGGGGgGgGgGAGAGgAGgGAAGAgGAGAGAGAGAGGgAGAAAgaGGgGAGGgGAAAAGAGGgGAAGAAAagGGGGGGgGGg	C>=BDGE9HFHHFFHHDGFFGHHGGHGFGFHHGHGGGGGGGGGGGHGGFGDGHGFFGGFGGBGGFGEGFGGDGBGGGGGGGGFCGGBGFGGFGH@EE<C?D	G	73	A	28	50	26	23	2	0.01043
9	34724987	A	261	AAAAAAAaAAaaaaAAAaAAaaaAAAAaaAaAAAAaAAAaaaaAAaAaaaaaaaaaAaaaaAaaAaAaAaaAAaaaaAaAaaaaaaaaAaaAAAaaAAAaAaaAAAAAAaAaaaaaaaAAGGaaAaAaaGAaAaGAAGAGaaGAGaaggGGGaaAGGAggaGGAgGAAaaaGGGAgaAggGAaaaAGaAAGaaGGGaaaAaggGGAAaAgAaAAAaAAaaAGAAaGAaaGAaaaaAGgaaaaaAGgaaaaAaAGAgaaAag	?=?;<@@DBBFEEEEFFFFFFFFDEEFFF@FFFFFFFFFFFFFFGE:FFFFFFFFFF<FFFFFFFGFFEFGFFGGGGFGEBGGGGGEGEGGFFFGGEFFGFG=FBFFFFGDGGDGFFGFFGGFGFGFAGEFGFGFEFCEFBGGFEGEDDDFFGDEFFE7DGFFEDFEEGGGGFFEDFEDDFEGGGDFHEEFHGFFFBFAEGDDFFEEEEDDGEEEGDEGGEFEEDFEGFFEFFGGDFDFG?FFEFCEDBBABA???=<CDA	A	213	G	48	95	33	118	15	0.00371
9	36276857	A	51	AGAAGAGAGGAGAGgAAAGggGAGAGGAAGAAGGAGGGGgAAgAGgAGGAG	=>EFEFGFFF?GFGGEEEFGG=EFEFFEEFEEF>DFFFFG?EGDFFCCBBB	G	29	A	22	23	22	6	0	0.03052
9	38621995	C	27	CTtCCTTTtttTTttCCTCCTTCTCCt	DA7FGFFEEBEFCEEEFEDFEDCCC9=	T	17	C	10	10	10	7	0	0.02606
9	68433522	G	75	AGGGgaaaaGaaGgGGggGagggGgAaGGaagaaGgggggGgggGgGGGGgGGGGGgggGGGgggGGGgGGGgGg	@DDFFEDEEBEEDFHHFDGEFCEHEEEH9EFFFFGGFGGGHGGFGGHHHGGG>GGDFGFGGGGFFGGGGFGFCCE	G	61	A	14	33	2	28	12	0.00799
9	68433537	T	77	ggTtTTttTgtttTTtGgTTggtggTtttttTtttTtTTTTtTTTTtttTTTtttTTTtTTTtTtTggtTttgtTtt	ABAEFGEDGFEEEGDEEFGBFFECFGEEFEFGEEDBFGGGGFFGGDFFFEFFEFEFCFGFFFFFFEFCFEFCE=A@C	T	65	G	12	32	1	33	11	0.01008
9	84530412	A	144	CCACcCaaACaaaaaCAcacaCcaaaacacaAacccaCaCaaAccCcCaccaAAaacCCaacaaCaACcCaCCACcaCACaACCAAacCAcaCCCACACAACAAAaCAACCACAacAAaCACCAAAAAACaaaCaCCAACAAAc	A>B>ECCDGCCDDD<DHCDGADGDDCDGDGDHDGFDDDDDE<HGGDGDEGGDHHEDFDDEEGEEDEHDHAEDDHCHE>HDECDBHGEH@GHEDCCGCGCGECGFGFCGGCCGCGFGGGECGCCGGGGGGCEEECEBCFDBAC?E	A	80	C	64	39	42	41	22	0.04506
9	90748566	G	112	GGGGGGgGGGGGgGGGGGgGgGGgggGGgGGgGGGGgggGGgggGGggGgggggGGGGGGgGGGGGGgGGGGgGGGgaGagagggGaaGgaGGGGGGGGGGGGGggggggGg	BCCCCCE=CDDDCC@CCCECFBCFGDCCFCCFCCCCG7FCCFGEBBFFBGGGFEBBBBAAFBBBBBBFBBBBFBBBBFBFFDFFDABE@CCC?CCCCBCC?CCCFGEE>E>@	G	106	A	6	68	0	38	6	0.00295
9	92017733	G	46	AGGAGGGAAGAAGGAGAGaGGGAGGGGGGGAAGGAGAGGGGGaGaG	DEGFFGG:FDFFG>FBF?GGGFEFCFFCFFEEFFEFEFEEFFCC>A	G	30	A	16	30	13	0	3	0.03689
9	95683228	C	50	gGGcgggcgCcCcggCcCccggcggGgCcCCcggCCCCCggggGgcgccg	?CCBDGFFEGFGFFFGFDFFFFFDFHGGGAGFGEGGGFFGGGGCDG@FA@	C	25	G	25	12	4	13	21	0.03216
9	117253973	T	69	TTcCtcTTTTtCTTCCCCtTCCTCCCCCCTTtTTCCCCCTTCtTCTTttttTTCTTtcCTtTtCTTtCT	AC@GGBEGGFGE?FGGGGGGGGEGDDGGGEGHFFFCFFF>FFEFFFFHHHBFFFFFHCFFH;GFEFEBB	T	41	C	28	28	25	13	3	0.04836
9	123923411	A	52	AAAAAAAAAAAAAAAAAAAAaAAAaAAAAAAAAAAAAAAAAATAattTtTtt	BFFDFAFFFDFEF5FEF?FFGFFEGEEE;EEEEEDEEEEDEECDGHH>CAAC	A	44	T	8	41	3	3	5	0.00102
9	125378014	T	56	tttttgtTtgTggggtgtggTtTTttggTgtgTgtgggtgggttgggggtttggtt	CB@B>ACBDCF8CCCGCGCCFBFFGGCCE@DCFCGCDDG=DDCHBDDDBFHHDDHF	T	29	G	27	7	0	22	27	0.01056
9	127818276	C	90	CCCccCCCttTttTCCctCTtCttTtTCtcTCCtccCCCtctctttcctctctTtttcttcttttctCCtccccctCcctccctcccttc	A<>DCBBBABDDDDGFGDFEDGDDED@EDGFEBDGGFGBDGEGEDDHGDGEHECEEBHEEHEEEEHEGGEHGGGHEFGFEHHHEGFGCBE	C	48	T	42	19	7	29	35	0.02050
9	131250111	C	45	CCCCCCCCCCCCCCCcCCCCAAAAAAAcCAAAAAcCcccACAAcA	GGAFFFAGGGGEFFFHFFFFEEEEEEEHFEEEEEGFHGGDFDD@A	C	29	A	16	22	16	7	0	0.03976
9	135765261	C	36	CCCCTTCTCCCTCTTttCTCtCCTTttCTttcCTCT	GE@GEEEEGFGEGEDHHFDFHFDDDHHEDHH=GCCA	T	19	C	17	12	16	7	1	0.04382
9	137674391	A	40	GGAAGAGGAgGGGGaaGGGGAaAaaAGGGGAAGGGGGgaA	C=HHC;CCHGACCCBFC@B<GEEHGFBB;BGFBAB?>:8C	G	24	A	16	22	10	2	6	0.04204
9	137674488	G	131	AAagGAaAaAAGAGGAGGGGGGGAAAaGaAaGAAAAaGAGAAagaGGGaGGAAgAGAagGaagaaaaagaaAGAGGGAGgaGaagAaGAgaaAGaAAAagAGgaGaAGAGaGaAAaaaAAaagggaAgGAG	BAAA?FEFFFFG@FFFGGEGGHGFEFFG@FFCFEEFGEFDFCGDGGFGGGGEDCFFFGDCGGDGGGGG>GGEGDEGFEFDGFG6DEGFEDGFEFGEEEG;EFDGFGDFDFGFGEEGGGEEGGCC@CC?CBC	A	79	G	52	41	37	38	15	0.03070
9	137742043	G	189	TGGgggGttGGGGggggtGtgGtgtTggggtgGGGtTtgGgTGGgggtGgggGgggGgggGGGggGgTGGGGGGggGGgGGGGGGgggGGTGGggGGGGGGggGGgGGggGGGGGGGGGGGGGGGGGGGgGggGGGGGGggGGGGgGgGGgGGGGGGgggGGGGGGGGagGGGGgGGGGGGGGgGGGGg	A@?BAA:@CDDADFFFFDEDFEDFDBFFFFDF?@@DFACEDBDEFCED@FFFDGFFEGFFEDEG@EGC?EB;EDGGBEGEEEDEEGGFEEEEEEFEECEEEGEDEEDDGE9DDDDDDDDDDDDDDDDDDFDEEDDDDDDGGDDDDGDBDDCDDDDADAEGCCDDCCDC6DDEDDCCCAA@>AB;CAC@B	G	172	T	16	113	6	59	10	0.03160
9	137742064	T	212	ctttTCTcTcTccCcccCttcTcttTCTttTcCTCCTCtcCTtTTTTTTtttTTTTttTTtTCTTttTTtTTtcCTTTtTTTTTTTTTTTTtTtTTTTTTttTTTTTtTTtTTTTTtttTTTTTTTTtTTTTtTTTTTTTTTTTtTttTTtttTTTTTTtttTTTTTtTtTtTTttTTtTTTTTTTTTtTTTTTTTTTTttttTTtTTTtTt	?CBB9A=BEA>BB@ABB<GFB8BGGDGGGDGBBG>CGGGBGFG9CG<GFGGGEEG?GEGGC@GFGGGGGGGGHC<EGG:BDFEFEGGGED>:GH@F:FGEHGD<GGGBGEHGFFFF5HHFFGGEFEFHCFCFIFFFFFDFFFACDFHHFFEHAFEFFFEHHAFFFFFHBHEHFFGGEEDEEBEEFFEDGGFEDDDDEEDEEEECDBC?C@?D	T	188	C	24	132	11	56	13	0.02115
9	137742124	G	318	tGGGGggGGGgGgGgGGGGGGgggGGGGGGGGggGGGgGGGGTGgGGGgGggGGgtgTTGGTgtgGGTGggGgGTggGGgTGGTGTTTtgGTGTGGTTTgggtTTgtGTgGtGTGGGGGTGGgtTGGgGGGGgtTGGGGgTGGTgtgggGgttTGggTggtggggGTTggGTGGggTtttggGgggtGGGTgTTggTGTTGgTGTggGGTTgTGTGgGGGgtTgGGTGTgGggGtgggTGgggggGGGgggTGGggGgTGGggggGTggTTgggtgggtGGtgGGgggGgggggGGggtgtggGgggggGgGTGGGtt	?>>86BB>==B?FBFC;CABCDDE>>CC@CCA=EC>CECCCCB?EC>CFCFE<>EEFGGCDGEEFBDHDFFCFCGFFCCEGCCGCGGEF9CFCGCBGGGGGGBGGFCCGFCECGC?CBCFCCFFGBAGCCBBFFBCBCCGGCC?G=EF<C>BEEBFEG6FFFFFGCGGECBGCCGFGFEEGFCGFFFBBAGFGFBFFBFGBFGCFGFBBFFEGBGB8BBBGFFGBBFBFEBGFBGHCGFB<5>D>BBBF9FFBBAFBGFBAGEGBBF?FFFDGCFF??FBBFDBBGG9BGFFFFAAGFEGD;EBFCC=B>?=???C@?	G	239	T	79	123	53	116	26	0.01862
9	137742231	A	179	aAaaagaAaaaagAAAAaaAAaaagagaAAaaggagAaaaAAGAaaGggAgaaggagAAAaaaaagAaaaaAaaaAaaaaAaAaaaAgaAaAAaaaaaaaAaAagAgaAaAaaaaaaAaaAaAaaaaaaAaaaaaAaAaAAAAaAAaaAAAAAgAaaaaaAAaaaaaaaAAAaaaAaAa	A=?AAABABAC>AEGFGFFGEEFEFFFEFHEFEEEFHDFFHH8HFFCFFHFFFDFFFCHHFEFFEFHFFEFGFFFFFFFFHFHFFEHFFHFHHDFEFFFGHFHG:GFCHDHGGGGGDHGGHEHFFGE@GHGGGG;GDGEGGGGGGGGFGGGGGDGFG=GGGGGE8GGFDFGF@AAB:@?	A	159	G	20	57	2	102	18	0.02230
9	137982232	T	83	GggggGgGGgGggGGGgggGggggggGggggtttttttttttttTttttttttttttttttttttttttttTttttttTtttt	E?@AAB@CBCGFEHHHFFFHFFFCFFHFFFFEEEEEEEDEEEEDEEEDEFFFFFEFDFFEE@FCCFFBDFECFE<FFFCEEB=	T	52	G	31	3	10	49	21	0.00328
9	137982236	G	74	TttTTTtttTttttttttttgggggggggggggGgggggggggggggggggggggggggggGggggggGggggg	<BA=CCEEEEEEE;EEEEEEFFFFFFFFFFFFFHFFFGFGFFGEGGGGGGGGGGGGGGD8GGGGDEGGGGGGFB	G	54	T	20	3	5	51	15	0.02948
9	139327573	T	91	TttttttttTtttttttttttTtttTttttttttttTTttTttTTTTTtttttTTttTTTtTtTTTtTttTTTTTTTTTTTTTcccccTcc	AC?BB=ABCFEEDEEDEDCCEGEE:GEECEEEEEDEGG=FEFDGBEDGEFFF:GGF@;GGFGFGGFFFFDCFFEFFFFFFEEEE>>;:A??	T	84	C	7	36	0	48	7	0.03934
9	139996710	A	127	aaaaaaaaaaAaaaaAaaaaaaAaaaaAAAaaaaaAAaaaaaaaAaaaaaaaaAaaaaaaaaaaaaaaaaaaaaaaaaaaaaaaaaaaaaaaaaaaaaaaaaaCCCCCCCCCCCCCCcCCCCCCCCC	CCCDBEDDDF@FEEEFEEFDEEEEFEFFFEFFFFF?CFFFFFFFBFFFFFFFFFFFFFFFFFFFFFFBFFFFECFFFFFFFFEFFFFFFGFFFFGEFFGGGGGEEFFFFFF@EEEFF@FEEEEFDDE	A	103	C	24	10	23	93	1	0.00000
9	139996713	A	121	aaaaaAaaaaAaaaaaaAaaaaAAAaaaaaAAaaaaaaaAaaaaaaaaAaaaaaaaaaaaaaaaaaaaaaaaaaaaaaaaaaaaaaaaaaaaaaaaaGGGGGGGGGGGGGGgGGGGGGGGG	C??=C;CBCCBCCGDFFCEFEEE>DEEFECC?EFFEFDE>FFFFEFFEBFFFFFFFFFFFFFFEFFFFEFFFFFFFFEFGFFFFFFFFFF<FFFFFFGGGGGGGGGGGGGG:GGGGGGGFG	A	97	G	24	10	23	87	1	0.00000
9	139996714	T	118	ttttTttttTttttttTttttTTTtttttTTtttttttTttttttttTtttttttttttttttttttttttttttttttttttttttttttttttCCCCCCCCCCCCCCCCCCCCCCC	AAAC=@?@@B;@B>BBCDECCGBGCBDDDFECDDCDCDGDDDDDDDDGDDDDDDDDDDDDDDD9DDDDDDDDDDDBDDDDDDDDDD>DDDECDDDEEFFFFFFFEEEFFFEEFEFEFE	T	95	C	23	10	23	85	0	0.00000
10	5032284	C	57	CCCTCtCTCcctctttctcCcCCctCCtttTCttttTtCcttccctCccctttccct	>EDFAEAFEDDEDDDDEEDGDFEDDDGEEFFBFEFFFFGEBBEEEFFFDEF@>ED??	C	31	T	26	14	4	17	22	0.02242
10	5041398	T	41	tCttttttTTCTCtttTTCCTCCtCTTTTTTtTTTTTTCCT	?G<GGGGGGGGGGGDHDFGFFGFHFFFFFFFHFFDFFFFBB	T	31	C	10	19	10	12	0	0.02063
10	9450066	T	55	ttttttttttttttttTTtTtttTTTTGTTTTTttTTTTTTTTTTTGGGGTTGGG	G@FGGGGFGGFFGGHGGGADHHFGGG<EDGDGFAHFF@FCFFFFFEDDCDDFCA?	T	47	G	8	25	8	22	0	0.01629
10	17365012	T	43	TAttTTTAtAAAAATTAttTTAtTTATaAATTtttAAtAatTt	ADFEFFEFEF>9FFFFFEFE@FFFFFFEEEEEFFFDDFDEEAA	T	26	A	17	14	15	12	2	0.02328
10	17365013	T	42	TAttTTTAtAAAAATTAttTTAtTTATaAATTtttAAAatTt	?BFGEEEFGFBFEFEEFEHEEFHEEFEGEEDDFHHEEDGGAC	T	25	A	17	14	15	11	2	0.04138
10	21805480	T	36	CccCCcCcCTTTtTTTTTTTTTTtTTtTTTTTTTTT	<CF6DFDFDF@F<EFEFFFFFFFDCFFFEFFFGEDE	T	27	C	9	24	5	3	4	0.04972
10	29759225	A	166	GAAAaaGAGGGAGGGGaGGaGGGGGGAGGGaAAGGGAAaaAAaAGAAAAGaaGaagAaAGGAGGGAAAAAGAAGAGGAGAaAAAAAAAAGGGGaAgGAAGGAGGagAGaGAagaaagAgAggAaaagGgaGGAAaAGaaaAGAAAgGgaAGGGGAaggAaaAAGGG	@EC@CCAG;CCHCCBCFCCFC9;CCCHCCCFHHCCCHHGGHGFHCHHHH>BGCGGDHGHBBGCBBG?GGHCGHBGBBGCGGHGGGGGGGBBB7DGDBGG@CHBBG?G>EBGFDGGFDGCGDBGGGGCBDGBBGGGFBGGGFBHHGC?:BB58>=BB<<B=?AC??C	A	92	G	74	59	60	33	14	0.02369
10	29783908	A	91	AAAAAaAAAaAAAaAAaAAAaaaaAAAAAAaGGGaaaAAaAaAGAGAaaGaaAAaAaaGAaAGAaaGaAaaAaaaAaaaaaGGGGGGGggG	FCCFAFHHFFHHGFHHEHHGFFFE<HHHGGFCCCGGFE5FHEHBHCHGFCGGHGFHFGBGGG>GGGBFGGGGF;GGEGGGFBBBBBBAGFC	A	72	G	19	37	17	35	2	0.00318
10	30317838	A	148	aaagGggagaGAgGAaaAaAgaAaaAggGGGgaGGaGAaGAgaGaagGaaGggGAGagGGGGAgaagGGGGaaGgGaGGaaGGAAagaaGgaAGGAgaGaAGGggaaAGgggggggAagaAgaGGggGGgaAgaaGaAagggGagaGg	CAC==<BDCGBGBCHFFHFHCFHFFGCCCCCCFCCFCHFCCCFAFFCCFFCCCBHCGCCCCBHDFFCCCCCGFCDCG@CGFC?CHBDGGCDFHCCHDCCFHC<DDGGGCDDDDDDDGHCFGEGBBDDBBDGGCGGBGGGDD>AB<@>@	G	83	A	65	43	20	40	45	0.01219
10	30978365	C	68	ctttccCttttttcCCccCCCCCCCCcCCCccccccCcCcCCcccCCcCcCcCcccccCCCcCccccC	@HGFBBGFGGGGGBGFBBFGGGGGE;BGG7BCACCCGCDCGFC?CGGCDC;CF>CACCFFECEAC@7B	C	59	T	9	28	0	31	9	0.00821
10	38645343	C	149	CCCCCCCCCCCCCTCCCCCCCCCCTCcCCCCTCCTCCCccTTCCCCTtCCccCCcCCCCcCcttcCCCCCccctCCCCtCCCcCCttCtcccCcCccCtcctCCCCCcccCCCcCCcCCCccCCCCCCCCCCCCccCCccccCcCCccC	B@>?BBBDFFFEFF=FEG9GGGGFFFB?GGGFFGFFEFBCEF?FFFFHGECCGCCGDFF=GCGHCGBFFFCCCHGFFFGFAFCEEHHDH:CCFCCABEDACCFFFEECCCFAECE8BFFECCEFFDEFFEEDEEBBGE@A>>A;BA8>?	C	132	T	17	95	7	37	10	0.02327
10	38645403	T	160	TTTTTTTttTTccTctttTcTtcTcttcTTTTTtttTTTcTtTTTtttTTTTTTTTTTTttTTttttTtTTttTTTTTttTtTtttttTtTtTTTTttttttTTttTtttttttttTTtTtTtTtttttttttttttTttTttttttttttttttttttt	B@==?BCEDCEGGEDBD9;GEDGEFDDGECEE?DDDEEEGEDDFEDDDEEEEEEEEEEEDDEDDDE?EDEDCDE9EEECEEEEEEEEDEE=EAEEEA@DEEBECEEEEEEEEEDEEDDEDEDEDCCD<=DEDEEEDDDE>DC;EEE@CE@DA@@?@6?:<	T	152	C	8	64	0	88	8	0.02205
10	43132398	C	130	tCCctCCtTCtCCTtTctCtttctcCcCtCtctctttCCCtCCttCttCTTCTccttcCtCccCcTcCTCtCcCTTCCccTCtCCCctCttcCccCTCtcttTTTccttccttccctTctctctCccccc	@A@>DDCEEFEFGEGGBGGGGGBGBGBFGGGBGBGGFDBBGGGGGGFGGGGGGCBGGBGFGBBGBGBFGGHECGFFFGCCGE9GGG@HGHHCGCBGFFH>GHGFF<CHI?CHHCCCHFCHCGBHFB=><?	C	74	T	56	37	16	37	40	0.01891
10	43292830	A	48	AAgGaaaaGGGAAGAAaaGggAGGAGAgaGGGGaGaaAGaGAGGGGaG	CAFCDFFFCACCDCHHFGBGGHCCHCHGGBCCAFAGG9B<BGB>A?D=	G	25	A	23	21	11	4	12	0.01349
10	49763677	A	30	aACccaCacaCcaaaCCaaCccaCcccCca	C<?B>FGFBFHBFGFFGFG69CFACCBECE	C	18	A	12	8	1	10	11	0.04921
10	81284847	C	53	CcccccCcccccTTTccCTcccTTTCccTcTcCTccttCcttttttCccttcc	AABDCCCDDDBDGGFDDDGDDDFGFD@EGDG6DGEEFFCEFFFF?FCDDDE??	C	33	T	20	7	10	26	10	0.03808
10	81284852	C	47	CcccccAAAccCAcccAAACccAcAcCAcccaaCcaaaaaCccaacc	?@CCCDHHHDDDHDDDHHHECDHDHDDHEEEE;CEFEEBACEEEFEE	C	28	A	19	6	10	22	9	0.03390
10	81319214	G	119	TtGgtttGGtgGGGttGGtgtgtttTtGGtgttGGGgtGGGggGgtgGggtgtggGtggtGtGgtGgggtttGGggtGttgggggttGGGtGGtgtggTtggtGgGggggggggggggg	B?@CD=FECDEEEEEEEEEFEFEEEFEEEEFEEEEEFEEEEFCEFFG?FFEFEFFEFGGDEEEFEDFF8FFFEEEG>EEF7GGGGFFEEEFEEEGFGGFEGEFD@DHEHGEGGGEGG@D	G	79	T	40	32	3	47	37	0.00011
10	81342361	C	66	CcCTccCCCCCtcctTcCTcCCtCTccCCcTtTTTctTTTTtCCTtCTcctTTcccccTcccctTc	DBDGBBDDCDE??BEGBDFAD>HCGACDDCDHGFFCHGFGFGDDFHBF5CHFFCDCBCECCCCGD;	C	39	T	27	16	18	23	9	0.04873
10	81993434	G	77	GtGGtgggGtGgGGtGGgGggttgGtGGGGgGggGgGGGGGGGGGgGgggGgggGggGgGGGggggGGGGgGGGGgG	HCFFDFDFFDHFFHDHHFIFFDDDHDHHHHFGGGHG>HHHGHGHHEHGGGHEGGHGGHGGGGEGGGFFG8FFGGGAC	G	70	T	7	42	0	28	7	0.00280
10	82276061	C	123	CtcCTctTTTCcTTctttCCtcctTTcCCcccttccCtTCccttCCctctTcttccctcCtcTtctccctctCCctccttttttttCtcccttctCCCCttccccCctctctctCtCtCCtCc	BC?B=<C>>=B>CDCGFFGGFBBFEEBEFBBBBG>BGGFGBBGGFHBGAGE?DGB7BHBGGBBGBGBBBGBGEEAFABHHHHHHHHGFC>AFGCHCFGGHHCBCCFCHCHCHCHF@FAFFHF<	C	68	T	55	25	11	43	44	0.04819
10	85974236	T	157	TttctcctCtCttCtTttCcctcCtttcccccCcCcccttcctccttTtccttctcTtttcccttccTctcccccTcctTtTtTccccctccTtcCTcccccCTcTtTttccctttTTcTtttcttctttTCcccctTttcTCCctcTTtTcctCcT	DA??B==B?B>EFBG@GGDBB8BDGGGBB:BBCBDBBBGGBBGBBGGH@BBGG@GAGDGGBBBGGBBEBGBBBBBDBBGGHDFFCCCCBGBBGFBDGBBCCC;DCGGDHHCCCHHHGGC?HFHC6HCHHCFCCCCCHFHFCFCCCHCFFHECBFB?>	C	79	T	78	13	24	66	54	0.03976
10	85974381	A	54	GAgAgAgAagAggAGgaagAagaagAagAgagaAaaagaAaaAagGgAggAaag	E@BDFEFEFFEF@BHFFFFEFFFFFEFFEGFGGEGFGGFEFBEGGHGDGGDBB;	A	32	G	22	14	3	18	19	0.03519
10	85981842	A	86	aGaGggGaaaaaaaaaaaaagaaAAAggaGaGgaGGgaagaAaAagAGaGgaaGAGAGGGGaaGAGAAaGGAAGaGagGgAAAGaa	=@CCEFEE<EEEEEEEEEEEFEEE@FCEEEEDGEEEFFE7FFFEFFEEFEFFFEFDEEEDDFFDCD9@FDDEEDFD>GDGEC>B?@	A	51	G	35	16	23	35	12	0.00213
10	95720490	C	117	cCtcTCTctcttcttctTtttCCtCcCcttCTcCTCcttTCtttCcTtccCcTCCCCCTtcCcCCTCcCCctCCCCctccCCtTCctCTCctcCtTCTCtttccCCTCTtCccCcTc	??BC?GEFEEDDFDEBEEEEBGDEFFGCEEGEFCEGFFEEGEEEDFEBGGGGEGGG:GEEGGGFFDFGFFGFFCFFGFGGFFFDFGFF;FGFGFFDFDFFFCGFFFCECF@GGEFBC	C	70	T	47	40	17	30	30	0.03760
10	100148176	A	173	ggGgAGaGGAGAGAAAAAgAGaAAGGAgGAAAgGgGAAgagAGAagagAAaAgaagGgaGGaGaggGAAGAaggAAggAaAAAAGAAaAAaggAGaAAaaagAaAAAaAAAGggGGggggaGaaggGaAgagGGAgAagGAgagAaGgagaagAAgAGgGAaGaagaaAaaaA	CC@BFAFCCGCHBHHHFHFHCFHGCCCFCHHFFCF?HBFFFFCEGFGFBAFHGFGGCGGBBGCFGGCHHCHGGGHBGE>DHGFHCHHFHBGFGFCGHHGEFGFGFGFCG?GAGC?B=GGFGBGGGG:F>DGGBBGGGEGBCGGGBGBFFFEGGGAFFAEAFGBCC>B=B@;@C	A	97	G	76	57	33	40	43	0.04813
10	124359524	C	148	CCCCCCCCCCCCCCtCCCCCcCtCCCcCctcctCCCccccCttcccccCcCccCcCcCCCCcctctCcCctCCcccccCcCCccCcCCCccccccccCCCCCccCCccCcCCCCCCCCcCCccCCccccCcCCCCccCCCcccCCCcc	@??F@EGGGCGFGGEGGFGGFBEDEEFGEEFFE>GGFFFFGEFGGEGGEGEGAGGGGGGFGGGEG>GG8GFGGGGGGFGGGGGGFAFFFGGGFGGGEFFFFFGGFFDGFGCFBFFFFFGFFGGFFGGGGF?FEFEFGGFFEFA>BB?D	C	139	T	9	78	0	61	9	0.00089
10	127585150	C	75	CCCcCcCCCccccCCcCccCCcccCCCcCcCcccccCCccCcccCCccccCccccccccccccAAAccccCAAcA	D>BACCGFFCCCDFFDGDDFFDDDEGFEGEGDEDEDFFCEGDEEFGEEDDFEEEEEEEDEEEEFEEEEEDFEEDC	C	69	A	6	24	6	45	0	0.00295
10	132915202	A	74	aaggagAaAaAgAAAGgaGGaagAAGAggggAGAagggggAAggaGAGagaAaaAGgAAgAaAGAGAgaAgAGa	C?ABFCEFHFHCHIHCCFCCFFCHFCHCCBDHCHFDDDDDHHDDFBGCGDGGGFGBDGGDGGGBFBFCFGBD@C	A	41	G	33	24	11	17	22	0.03739
11	294537	G	63	aaaaaaaaaaaaAAAGGGGGGGGGGGGGgggggggggGGGGGGgGGGGGggggGGGggGggGG	ACBCEEEEED@FA?7AADDED99DDDDDFF?GEFFCFDDDDDDEDDDCDGGFFCDCGEEEE?C	G	48	A	15	30	3	18	12	0.00667
11	552788	G	32	CGgCgGGcGGGccgcGcCCGGggcGccgcccG	DCFDFC<FC>CFCFFCGDCCCGGFBGGFGGE=	G	17	C	15	11	4	6	11	0.04161
11	1016609	C	85	cCCcccCCccCcCCCcccCccccccCccCcCCcCCCccCcccCccCCccCcCCGGGGGGcgcccCCGcCcGGCcCCccCcCccCc	C;BEHGGGGGGFFGGGGGEFGGHGG?GGFGGEHGCGHHGHHHGGHFGHBGGFFHGGGHGIEHHFFFGHDCFGFHFFFHDGCECAC	C	75	G	10	32	9	43	1	0.00608
11	1017623	C	177	CCCTCCCTCCCTCCTCCTCCCCTCTCCCCCCCTCTCCCCCCCCTCTCCCCCCTcCTCCtctCtcCTcCCCCCtcCTtcCCcCCTCCtTTCcCcTCTCcttcttccCccCcttttcCCCcTcTcCCTctcCcctCTCtcCtCcCCCCCccCTTCcCCCCCCCcTCcCtctCCccCcct	=?C=8:9:@?CEGGEFA:GEFGDBEGFGFHEEE:EBGGG:GE?DD:@EGGGEEHFB<GEHEG6HGE@GGGGGE9GE<HGGHGGEGFBDEGHDHCGEDHEEHCEHHFAHFH<E@=HDFFHDDDHDFDH?AFHHEFDDECF8DGF=FCDGGFDCFHFFFFFFFHC<FFBEACCAABA>B	C	129	T	48	93	27	36	21	0.04904
11	1075850	G	207	GAgagaAAaGGGGAGgAGGaagAGaagGAaaGAagGgGaAAaagAgGAGGaaaGAGGGAgGgAagggAaaGGaGGAagGGAAaGAagaaagGAaagaggaGGaaaGagaaaaggaGaGaAaaAggaagggGagggAAGGagGAGGggggaaggagGggGgGGAgaagggagGaAggggaaaggGgaGagGGggagaGGGggGaAaGa	CCACC?A>AA>;@@BDEFFGGGDGFEDGFFF9FFFFFGFFFFFFCFGFGGFFFGEGFGDFGFFFFF;FFFGFFGGFFFGGFFFGFGFEGE?GFFEE=EEGFGGGGFGGBGGGFGGFEGGEGGFDEGGFGGGFGFGFFGGGDGEFG=GGGGFGDFGFGGFGFFEGEGGGGHGFGEEG7GGGGGGFGGFGEFFFGGAGEEFGGFEFACD	G	114	A	93	54	29	60	64	0.02251
11	1093569	A	80	CacaAaacAcaCccAcacAAcaAAaAAAcAAaAccAAcAaAAacacAaAAaAAAAaAAAAaAAAAAaaAAAAAAAAaAaa	<AEEGDDG=GDDFGFFDFGHGAHHCHGHHGGEGHGHHHHCHGCGEHF9GGEGGGGDGGGGCGGGGGEAGFFGEE>@;C?A	A	64	C	16	43	2	21	14	0.00011
11	1093575	G	84	GggtGtgTtttgtgGgtgGGgGGGtGGgGtGtGGtGGgtgtGGgGGgGGGGgGGGgGGGGGgggGGGGGGGGgGggGgGGGGGg	@ACFBGCGBECC>CCCGCACCBBCG9>BCD:;CCCCCDHDHA=DACDBBABDB?<DBBBBBDDD@BBBBBBADBCBB;@AA@?A	G	70	T	14	47	1	23	13	0.00004
11	1093582	G	87	cgCcGcgcgGgcgGGgGGGcGGgGcGcGGcgGGgcgcGgGGgGGGGgGGGGgGGGGGggGGGGGGGGgGggGgGGGGGgGgGgGGGG	CCAD>DFCFCFDE;CFCD?DB;EBDACCCECCCGEFDC6CCF@=CCFBA@@DBBBBBEGBBBBBBBBGBGFBFBAABAGBE@B>>CC	G	75	C	12	52	1	23	11	0.00009
11	1212954	C	481	CacccccaccCCCCCCCCcccAAcCCCACCccccACCCACcCcaaccccCCaaCACCAacacaaCaccccACCCcccaccAACcAcccaACCCCcaaacccaCCCCCCAcccccacACCcccccacCCAcaccAACACCCCCACcccccCCCCCCACACCACCCaaccacccccacaacCACCCCCccacACCacaacaCacccaccCCCCCCCCCCCccacccCCACcaccCCCCcccaaccCCCAACCAccCCCaaCcCCaccCCaaACCCAcaCcacccaccccccccccCCacaccccccaaaCCCaaaCCCacaccccaCCacCccCcCCcaCacaaaacCccacCCCCCcCCacCcccCCCcccCCCcccCCcccccCccCCccCCCCCccccccccCCCCcccCcCcCCcccCccCcccCCCcccCCCcCCCCCCCcccCCCcCCcCCCcCCccCCCccCCcccCCccCCCccc	DCCCC?BADCA?A6><>>CDC:@EDC@A@AFEEE:ADCDEH;GDDFGGG?EDDFDAFECGCGCDGDBFFFEF:DGGGDGGFFFGFFGGD8GGFFGDDDGGGBGGFFE:FGFFGGDG9FFGGGGG:GGEDGDGGEFG?G6E9EDDGGGGGEEEGGGECFCFFGFFDDGFDGFGGGDFCDGGF>BGFFGGDGEBGDGDDGCFDGGGDGGGGGFGFFDF@FGFDFFGD;FDGDGG<GFFGGGDDGGFEDFFGF:DGFF>DCEFFCDGGGEDCFFFDDGDGGDGGGDGGGGGG<EHG5EEH=GGHHHFCCCFFFEECGFGDGEHHHHEFGAHFHEFHEFHE@DH6EEEEGFHDGGG?GFHFFEHFHHGFEFHGHEEFHFGGEHGHCHDHGGGHBFFEEFHGFHGHHGFGEFGFHFHEGDEIGHFGHEHHHFEFHHHFEEHFEEAEEA:HGFFFHFEGFEEHDF:HDDFEFDDECC=BCA>@A@E>	C	386	A	95	189	30	197	65	0.00269
11	1213047	T	246	ttTTttTTtttTttTTTtttTTTtTtTtTTTtTTttttttttTTttTttttttTTtTTTTttTtttttTTTTtttttTtTtttTTTTTTtttTtTtttTTTTTttttTTtTTTtTTTccctttTTTTTCctTTTTcTTTttttTttTTTTttTctTttttTTtTTTTTTtctTttTTTcTTtTttcTTtctCTTtcTcttTTtcTtTTttTTTttcTTTcTTTTTTTTTttTTTTtTTTtTTTTtt	AC=???BAAABEECEFFDDD@GDDGDGDFF<DGHDDDDDDC=GGDDGDDDDCDGGDGFHGBDHBCBDCG6GG?DD>DGCGECEBGFGG=D;EG7F5?;GGCGDE6EE>GEGDG?GFGGC5<EDG?GGGDGDFGGEGEGG?D>EAE=EDFFBEF=DE??E7FF@FAFFFF>H@FE<FFFHFEEFDEHFFEADFFFEGFHEEDFEFF7FC7DFDFEDEFFFHFFFFFEFEFE:EEFF7EDE=CE?C8:	T	229	C	17	125	2	104	15	0.00066
11	1213142	C	306	cCCgCcCCggccCCCccgcCccCCCccGCCCccCCgccCcCcggcccGCggCccGCggCCgGCCCGccCCccgGCCCCccCGCcCcCcccccCcCCCcCccccCCCcCCCccCCCccCCCcCCCCCccccCcCccCCcccccCCCCcCcCCCccccCCCccCCCCCccccCCCcCCccccCCCCccccCcCCCCCCCccCCcCCCCcCCCCccCCCCCCCCccCCCCCcCCCCCCCCcccCCcCCCCcCCCCCCCcCCCCcCCCCCCCCcccCCCCCCCCCCcccCCCCCCccccCCCccccCCcc	?B=B?C8>CBED:FGEFFFCEFGGFFFED;EFF8FFBFDFGFFFFAFCGFFGFF=EFFAEFGGGGGFFGGFFD@=HFGFF6BGFEFGFFFFEDFGGGFFFGFFFGGGDGFGGGGEGGGGGGGGFFGEFGGGGGGDGGGFDGGGGGGGGGGGGGFGGGGGGGFFFFEFFFFFFDGGGGGEGFGFFGGGGAGFCFF@FFGFFFGFFFFGFFFFEFFFFFFFFFGGFCFFFAFFFFFFFFFGGFFGFFFFEFFFFFFDFFEF>GFEFFEFFEEEGCEBEFEFFGDEEFCBBCCDA@@B>BABBB<C?DD	C	286	G	20	173	7	113	13	0.03345
11	1213405	G	531	GGggggggaGGgggggggggggggggGgggaGGggggGggggggGGGGGGGgggGGGGGgaaaggggGGGGGggagggGGGGGGGGGGgggggggggagaGGGgggaaagGGGGggggggggggGGGGggggagaGGGgGGGagaaagggGGGgggaggggGGGaggggGGgggGGGgGGgggggggaagaggaggGggggggGgggggGGagaGGGGgGGgggagGGggggGGGggggGgggggGGgaggGgggagggGgggggggGGGggGggGGggggggggggggggggGGGgggGgGggggggGggggggggggggggggggggggggGgggggggggGggGGgggggggggGGggggggggGGggggGggggggGgGGggggggGGGGGGggggggGGGggGGGGgGGGGGGGgggggggGGggggGGGGggGGGGggggggggGggGggggggggggGgggggggGggggggggggGGggGggGGGGGGgggggggGGGggGGGGGGGGgggGGGgGGGGGGGG	@7AAAC?CA;;AA9BBBBBBCCCBBC;CCCCABGGFFAFFECFEABCCCC5EFFCCCBC>DDDEFFECCCC7FEDFFECCACCCCCCCFFFFFFFFFDFDCCCFFFDDDFBCCBFFFFFFFFFDACCCFD@FDFDCC=F>A=DFDDDFFDCCCFFFDFFFFC?CDFFFFCCFFDCCCFCCDFFFFFFDDFDFFDFFBFAFFFFDFECFFCCDFDCCCCFCCGGGEACCFFFFCCCFFFFC;F?FDCCEDGFCGFGDFFFCFFCDFFFCCCGGCGFBCFGFFFFFFEGGFGGGFCCCGGGCGBGEGGGGCGGGFGG>GGGGG@FGGGGEGEGEGCDGGGGGGGGCGGBCGGG<GFFFGC<GGFGGF5GCCGGGFBGGGG@GC@C:GGGGGGCCCCA:GGGGGGBBBGGCBB?G==BBBABAG9GGGBBB<GGGBBBBGGBCBBBGGGFEGEB:GBHHBDEFGGGGBGGEGGEGBGAGGGGGGGGBBFGB?FBBBBABGGGFDEGAAAGCBBCBCCC@FEE@@??:::AC?CC	G	503	A	28	174	0	329	28	0.00001
11	1213424	A	419	GggaagGAaggAAGaAAgggggggggAgggaagGaaggagAGgggAAGGaAAgggggGGagagGGggggAggaagGAagggGggggaagAagggggaAAAagggAGgaaagggagagggagaAAAgagAGaAagggggAaaaagggaagaggggagggggagaAggagaggggGgaGAgagaggggaAaggagaagAAaaagAgaaaggGgaGgaagagAAAAGAgaaaaaAGAagGAGAgAAAGAGGagaggagAGagaaGGAAgaAGGAggaaaaagaAaaGaggaagggaaaAaaagggaAaaaaaaagaGAggAaGAAAGAaagaagaAAAaaGGAGAGAAagaAGGaAAGGGAAAAAgaAAAgAAAAaAAgaaggaAAAAAggAAAaAaAggAAAAAagaAAaaggAgAagggg	?CCC?@@>?8BAAB:A@BCCBBCDCCEFDE@EFGEEEEEEFGFFDFFGGEFFFFFFFG9EFEEGGFFFEDFEBBCCEDFFEGFFFEEEEFEF?AEFEFFDEFFFFGFEEEEEEEFEEFEEEEFFFEEEFGE@EFEEEDFEEEEDF@EEFEFEFGDFGFEEEEEC=FEEEEFFFGEEFFFDEDEGGDEEEFFEFEEFEFFFDFEFEEDDFGFEGFFBFFFFFFF@CFDFFFFFGFEGFFEFG:ECGFA8EGFGGFGFG>GFFGGFFFFF>?FFFEF=FEFFE8FG<?FFEFFEFEFEFEFGGFEEFFFCFFECFFEFFECG:EEFEFFEFFGEEE=GGBFEEEFDEFEEEFFFDEFFFEEEEEEAEEEFEEEEEEEGAFDGFEDEEDFFDDEFEEFEEDCCDDCB?:B<A=AA>?BC??C	A	222	G	197	100	44	122	153	0.00000
11	1213428	T	407	tttTctttttTtttttcTTctcTTTTtTTcctctTTtcttTtcccTttttcTTtcctTtttctttTttctcttTTTttTttTTttttctttctccttttTTTtttTTtTtctcttTttttccttttttttttttttctctTcttttccttTttTTctctcttttTTtccttttcTTtttcTttttctTttTTtttttTTTTTttttttTTTttTTTTtTTTTTTTtttttttTTttttTTTTttTTTTtctttttttTttTtttttttttttTttttttTttttttttTTttTtTTTTTTtttttcTTTttTTTTTTTTttTTTtTTTTTTTTTTttTTTtTTTTtTTttttttTTTTTttTTTtTtTtttTTTTtttTTttttTtTtttttTTTttTTTtttcttt	CA?@:@BBBB6CDCCD>BA@E@CDDDHCEBBGBA?DFBGFEGBBA>GFBF@EEG@BGFGGGBGGGDGGBGBGGEEDGGDGGEEGGGGBGGGBGBBGGGGEEDGFGBEGEG@GBGGEGGGGABEG5GGFGGGGGGGFBGAFE?DGGDBBGGEGGEEBGBGBGGFGEEGBBGGGGBBEGGG?BGGGGBGEG;EAHFEGHEAEEEHGHHHGE9EHGEEDDH<9EEEBDHHFHHH6EE>HHFDEEEHGEEEEHAGGBHHHHEHGE:=HGHHHGHGGEH@HHHGDCHHHHHGHDDC6DHEDDDDCFAH=HCDDDAHDDDDDDD;GGDDDIDDDDDDDDDCBHDCCHDDDDHDDHHGHHGDDDDDFHDDDHDHDHFEDCCDHDCCD<GFGEGCDDDDD=BB?>@@A=@@;<EE	T	366	C	41	142	0	224	41	0.00000
11	1213440	T	386	TtccccctTTTtcCccTCctttccctctccctctTTTctcTCtTtccccTttttccctctcccctccccctctTcctctccccCctCTctctcccctTTtcctcttcTTtttcTctttccCctCctctcTTTTCTctttttTCTtcCTCTcTTCTCCtctcctcTCtcttCCTTctTCCTcctttttctTttCtccttccctttTtttccctTtttttttctCTccTtttCTTTCTttcttctTTTttCCTCTCTtctTCCtTTCCCTTTTcTTTcTTTTtTTcttcctTTTTTccTTTtTtTcctTTTTTtctTTttccTcTtccccTTTtTTTcccccctTtttccctttctTTTtccTTTTccctTTTTTTtctTttTtTttt	ACAC?C@?AA=A@ABAABBCBBAABCCCBDEEDEDFCDEDEFE;ECCDDEEDEAADDDDEDDDDEDDDDDEDDCDDEAEDDDDFDEEFDEDEDDDDEFFEDDEDEEDEFEEEDEBEEECDG<?FDDDEDFFFFFEDEDEEEABFBDGFFCDCDFEECEDDDDE5FFCDEFGGFFDD@EGDEDFF=EBDEF?FGE@EEFEEEFFFFFEFEEEFEFFFFFFFEFGFD?E9EDEBFFFFCEEEEEDE;F:FDDEFFFEFEFEEEFFBG=FEEEEEEEEEEEEEBFEEFFBEE>EDEEDEEEEFEFEEFFEEE>EF;FEC?DE@EEEEDEEEEEEEEE>EEEEE:@EFFFEEEFFFDFDDEFEEDDCFDDDDCDDBC>A?@BA;B>??BB	T	232	C	154	108	32	124	122	0.00000
11	1213533	C	369	CCcttCCCCtttcCCCCCCctcCccCcCccccCCCctcCCCCttCCCcctCCCcCCCtctcCcCCccctcCCccccCCCtccccCCCCCCtCCCCcttccCCcCCCccCCCcCCcttCCCCcCCCCcCCCCCCccccCCcCCCCCCcCCCCCCcCcCCCCCccCCCcCCccccccccCcCCCCCCCcccCCCccCCCCcCcccCCCCCCCcCCCCCcccCCccCCccccccCCCccccccCcCcCCCcCccCcCCCCcccCCCcCCCCccCCCcCcccCCCCccccccccccCCCCcccCCCCCccccCCCCCCCCCCccCCCcccCCccccCccccCCccCCccccCCCCccCCCCCCCCCCCcCCcc	BBCC@8>@?CCC?B@@DCA?DAFC>FAFAAABFGFBGBGF@AGGGGGBBGGGFBGGFGBGBGBFFBBBGBGGBBBBBFEGBABBGGGEFFGGFFFBGGABFE<GGABBGGGBGFBGGGGGG:GFFCCBFFGGEBBC:GFCEEFFFFCFFEGEGCGCGGGGFC;GGFCGFCCCBC=CCFCGFFEF=CCCCFEFCCFFGFC>C<CEDEEEFF?DGGEFCCCF?CB?DACC<BCFEFCCCCBCCCECFEDCECCFCFFEFCCCFEECEFF=BCFFEBECCCFF:FCC?CCCCCBCFFEECCCDFBDE@C@CEEFFDEEDDFCCFEE;;BEEBABBFBBAACC?@BB>>>=6ABB>C>>>>@BABAAA;C?@>	C	350	T	19	205	0	145	19	0.00000
11	5862984	G	118	gGGGCGGGCGCggCGgcCggCgCCgGCGCGGggcGgGgCgGCCCCGgcGGgGgGGCGgggGCGGcgggGCgGggGGCCcGgGGCGGGCGggCGcccGCCgCGCCggcCGgGCCCCcGg	A@?BACCFFEDFFEGFGGFFGFGGFHGGDGGGFGGFGFGFGGGDGGEHFFGGGBGGGGGFGFGGHGDGGGFGGGBF>FBFGFFFFFF@FFDFFGHHFFFGFFFFGFHBFFE=AC>@?D	G	75	C	43	42	33	33	10	0.02931
11	17663742	G	85	GGCGCgCcCcCCGGgCgCgGGCGcGCcGgccGgcGGGcCgGgGCCgccGgGGccccGGcGccgCGGCGGGCGCGGGcCGGGCGgC	@DDHEDFBGBGGHHC9DDDDHGHAGG@HDCBGCCHHGCGDGDGFFDCCFDGGBCBCGGBGAADBFFF?GGFGFGGFC>HFED<?C	G	47	C	38	35	20	12	18	0.04272
11	18267478	G	131	GGGGGGGGggGgGGGGGGGGGGGGGGGGGGgGGGggGGGGGggGgggGGGggggGAAAgaaaGAaaGaggaAgggggGAaAggaAaAGGGAggGAGGgGgagagagGagaggaaagaggagggggaGgGaa	BA=CCEEEFEEEEEDEEEDEBEEFEEEEEEEE@EEG=EEEDGGEEGGEEEGG>FEEF:GFFEEFFDDCGGFEFFGGGEEFEGGDEEEDDDEAFCEDAGDFDGFFEED?DFGEEBFFEFFFFF<CBAAA?>@	G	97	A	34	53	11	44	23	0.02936
11	27379127	C	49	CccgccgcCgCccCCcCgcCggcccCcCgcgcgcgcccggggcccgccc	?DGEFFFEDFDFFDDFDFEDFFFGFD?DFGGB=G=GGEGGGGGGGECGG	C	34	G	15	9	0	25	15	0.04197
11	48453777	T	139	TTTTTTTTTtTTTtTTTTTTTTTTTTTttTTTTTTTTtTtTTTTtTTtTTttttTTTttttTTTttttttTTTCCTTTTTttTTttTttCtTttCTCCTtttTtTTttCTCTTCtttTtTttTtTTTCTTTTtttTTtT	=9@ACEEEEDEEEDEAEEEEDEECEEEDDEEEEEEEEEEEEBEEEEDEEDEEEEEEEE;EEEEEEEEDEEDEEGFDEDEEEEDD?EEEEFEDDECDFFCFBCDEDDEEFDFDDDEEEDEDEEDEDDDFCCECDA@B@=?	T	129	C	10	81	10	48	0	0.01526
11	51516144	A	88	AGAAAAGAAGAAAaaAAaAAAaAAaAaaGGAAaGaAAAAAGGAAAAaaGgGGAaGAAAaGGGGAaGaAaaAaaaGaGGAAGGaAAGAg	CDCABEEDFGFFFFFFFFFEFGFFGEGFGFFFFGGFFEFEFFEEEEGDFDFFDHFEEEGFFFFEGFGEFFEGGDFGFEEDFFGEEC?A	A	63	G	25	41	23	22	2	0.01531
11	55872657	A	186	CCcCACCCAaccaaaacAcaAAaaAAAcaCAAacaacACaacaAAcAAaaccccaCaaaACCccaaaacAccAAAcccccAccAaccaAcacccaaaacAcAAAcCaAcaCaaaacAcACAaACAccAAaaaCacCAccccaCAAccAAcaaAAAAAAaCACAaACCacacAAcacaAAcAaAcaa	DCC@A9>9>BBBCCBFGDFFFFFFFFFFFFFFFFFFFFGFFFFFFFFEFFFEFFFFFF=EEFFFFEFFFFFFFFFFFFGFFFFFFGFGFGGGGGGGGGGFGEEFGGFFGGEGFFGFFFEFFGFGEGGF;GDDGDGEEGGGGGFEEGGEDGHDAEDEEEGFEFEGEEFCGGGEEFCGGEDEEFD@??	A	110	C	76	55	22	55	54	0.00623
11	56143570	A	360	AAaAaAAAAAaAAAaAAAaaAAaaAAAAaaaaaaAAAAaaAaaaaaAaAaaaAaaAaaAaaaAAaAAAAAAAAaaaaaAaaAaaAAAaAAaaaaaaAaaaAAAAAAAAaAAaAAaaaAAaAAAAAaaAAAAAaaaaAAAAaaaaaAAaaaaaAAaaAAAAAAAaaaaaaAAAAAAAaAAAaaaaaaaAaAAAaaaAaaAAaaaAAAAAAAaAaAaAAaaaaaAAAaAaAaaaaaAaaaaaaAaaaAAaaAAaaaAAAAaaAAAAaaaAaaaAaaaaaaaaaaaAaaaAaaaaAAAaaaaaAAaGAGGGGGGGGGGGGGGGGGGGGGGGGGGGGGgggaggggggGaGagaaAaaaaaAAa	BBC@A;@>?<CCA>F:DDFCEDFEED>EFFCFFFE@E>FFEFF@FFCFCFFFEDFEFFEFFED@DE@EFEEEEFFFGFDDFEFFCEEGEEGDFFFCEDFFEEDEE5EEGDEGEEEGEEEGEBEEEEGEEEEDGGGGDDDDEGGGFEEGGGGGEEGGEEEEEEEFFGFGGEEEEEEEFDDDGGFGFGFCGDEDGGGEFFCDGGBDDDDECDGDFDFDCGGFGCDDDGDGAGGGGG@GFHGHHDEFGDDGFDDGGGDD:DGGDDDDGFGDGGGDAGGGGGGEGGGDGCGDEGGGDDCFFEFACCEGDGHHFFGCHGH:GGGHGGHFGGGGF;GCGHGGGFGGGGGEEBDBB?<7A=??:C?C	A	318	G	42	147	32	171	10	0.00026
11	57334678	T	32	CtttCtTttCttccCttttctctctctctCtc	:C7BEDEEEFDDFFEEEEEFFGFFFGFGFEFG	T	19	C	13	1	5	18	8	0.02888
11	62434173	G	153	ggAGgggGagagaaggaAaggagggaGAaggGgaaAGAgaAgaaAaGGAAaaaggAAAaAAgAGgaAgggagggAaggaAgGAaAAAAGAaGAAgGGgAaAAGAgaAggAaaGAgAaGAAAGAGaGAAGAgAAAgaGaAAGAaGGaAAAaAGg	AA?=?AACECFCDECCFFFCCFCCCFGFFCCFCFFFFFCFFDGFFGGGFFGGEDD8FFCEFDEGDG>DDDGCDDF?DDEF>:;E6:EEGFGFEECFF?EGEEFE>GEDEBGHFADEFFEEEFEFGFEEFE@EDE?GEFFEECBBB?ACB=C?A	A	87	G	66	51	25	36	41	0.01430
11	63681648	G	52	AaGaAGgGgagGaGaaGgaGGaGgaaAAagGGAGAGGGaAGaGAaGAGGAgg	>=ADFGFGFFFFEGFFGGFGGEGGGGEFGFGFFFEFFFGEF>FEFFFDBAAD	G	28	A	24	20	10	8	14	0.04850
11	65733289	G	170	GGAGGGAagaAAGaGAAGGaaAGGGGAGAagaGAGGAaaGGaAGaAaaaGGAAGAAgAaGGGGGGAGggGGaaGAGGagGGGGggGGAgGAgaggGAaGgGAGGAAAAGGGgAGAaAaAGGGAAaggGaGGaagaaaaGggGGGGgaaAGAgGgAAgagGAAGGaGGggG	?>BBCDDEEEFEDEEFFCDEDFEC?EFDFDDEEFEDFEEEEEDEEFEFFDDFEDEF?EFEEEEEEFAFCEEEFEFEEFFEDDDGGEEFGDEEFGFDEFDGDEDEFEEEDDDGBDCEEFEDDDEEFEGDFDDFEBCEFFDGFDDDDFDFEDEADGDDGFFDEECCCC@>A?	G	96	A	74	70	40	26	34	0.01493
11	65733393	C	187	ttctTtttttCCTTCctCTtCtCttCccTTTttTttcttCCccttccCtctttcTTTcctttCTTCctcttcttTtcttCtCCtCTCCtCttCCTttCcCCCtCccTCtCttcCctTctTTtTCtTCtCcTtCtcTcttTTcccTTCTtccTttCcttCTCcTCCctCttcctTcccttCTtTctct	CC??AC>CDB9AFECAGBGFDFDAGD:BGGGGGGGGBFGDDBBGGB5DGAGGGBFGGBBGGGDGFDBGBGGC?FGGBGGDHDDHDGDDGCHHA8F:HDC@D89DCCGDEDGHCDCHFCHFFHF;GFDHCCEICH<DCHHEFCCCFFC>AB=FFGC=HGCFCCFCCC?CHHCBGFACBGFA@CC=;<A	T	105	C	82	35	41	70	41	0.02483
11	67786398	T	45	tccttttttctCctCttcttCttcttcCtttccccccctcttcct	BBAACBBEFCDDDDDEEDEEDEEDECDDFFEEEEDEEDEDFGEEF	T	24	C	21	0	4	24	17	0.04017
11	68839949	C	32	CCCcTTTtTTcTTCCcTCCCTcTCcTcTTTTT	@CGBCEBHEECDDFF<DFFFDCDFCCADEBA@	T	17	C	15	16	9	1	6	0.03297
11	73620537	C	166	GGgGCcGGCGCcCGGCGcgcCcGcCCGCGccgGGCcGCGcGCGccCGGCGcGGgCcgCCGCGccCCCGGcGCCgcCGGcCcgGcCcgggcGgGgCgGGCcccGGGGggGCccCCCcCcGCGcgCgCGcggCcGcGGcGgGccgGggcgcccggCccggGCCgCcGc	==>>?B@AEDDE@ECGEDFDFDDDGGEGEDCEEEGDEF8DEEE<DGEEFEDEEFGEEEFDEEDCGEGDEEDFFGEFEDEGEFEEFEGGFEEEEGGGDEFEEECCEEGFEFECEFE@EADEDFCEFFBEFFFEDDDDEDGCEEFDF@EGEEEBFFEEFD=AAB>??B	C	86	G	80	41	51	45	29	0.04303
11	74303841	T	63	tCtctCtTCctCCtttctCtctcCccCcttTttttccttccccttcttctcttttccccttcc	A=:@BCCFCCDDDEEDDEDEDEDDDDCDEDGEFEE=?DFEEEEFFEFFECB:EEEEFEE?E<E	T	32	C	31	2	8	30	23	0.04332
11	78489798	C	39	AcAaAaacAccAcCccccacacAacaccaacaccacaca	C?ACADFDFCDFDFDDDDEDEDFEDEEEFBEFEEFEFEE	C	20	A	19	1	6	19	13	0.04360
11	78498022	C	113	ctTtCcTtcCcTTtCcTTtttTcttctcCtttcCCTtttTtcttCtCtttCcttCtcttCttcCctCtctcCttCCtcccCcttttcTtCCcccCcCCttcccCcctcCtcTc	CC>CFC7FBEAEAGGA=FGFGFBGGBGB@EBG@FFFGGGFDBGGGGAGHGFBHHFFCH@>DHBECGFHCFCBGHGFH=CCECHHHHCEGEECCCE8FEHH@CBFCBGCBG;?8	C	57	T	56	24	11	33	45	0.01421
11	99690461	A	153	AGaGaAAggAAGagAgAaagaaaAGgaGAaaaaaAaAaAAAAaaaggaagAAggggAAAgAAaaagggaGGaAaAaaaaaaaaagAAgggAaggaAaagAaaAagaaaaAAaaaAAAAAaaAggaAaaaAAaaaaAAAAaAAaAaaaaaaaAa	>;5BDBBGE@FGFFEFFFFFFFFFGFFGFFF>FFFDFFFFFFFFEGGFFFEFFFFFFBFFFFGDGGFFEFGFFGFFGEGGGG<GGCFGGGFGE?EFGGGFGGEGGEGGGEE>GGEE@EEBGEGGGEFGCEDGEGDCEEEGEEGEEG9EGEDCC	A	119	G	34	49	7	70	27	0.04235
11	102988504	A	125	TAAtATtAtTTaAtATTatatATAttTTtAAaattaAttAtttaaAAAaATtaAAAAAAaaATaaTAttATatttATttaatttAAaAttAtAatatTtTTTTTatAaAAaAAAaaTTttaaaat	>CC@D@FFGGGFHGHGGFCFGHGHGGGFGIHEFGG@H=GGGGGGGHH=EHGHFEEHBH=GGHFGG:FHHH7GGGHFGHHGGHHHHHGHHHHHGGHGGFHFFFFFGHGGGGHGGGFGFEHGGFDAC	A	66	T	59	37	22	29	37	0.04828
11	118210458	A	182	CCCCAAACCACCCCACAACAACAAAAAAACAaAaAaACAAAAAAAaCAAAAAAAAAAAAAAAAAAAAAAAaaaaAAAAAAAAAaaAAaAAAAAAAAAAaaAaaaaAaAAAAAAaaAAAAAAAAAAAAAAAAAAAaaaCAaAAAAAaAAAAaAAAAaAAAAAAAaAAAaAaAAAAaAaaaAAa	>D?ABA@GGCGGGBFG<BGBEEDFEF@EEFEAEEEEFGDFFFEFCEGEFDFD=FE@CEB:B@>>:CDCEDEE;EDAEEEEED=@EEECEDE7BEEEEDEBEDEFFEEDEEEEEE@EEE=EEE@=EDEEEEECEEBE7@EFEEEEAFEDDDAEEEEE;DDCFEEB?DC?B?AB>A@?=;7A@B	A	165	C	17	130	17	35	0	0.04629
11	121393450	G	115	aaGgGGGAgGgAGGGaGagagGaAgaaaggaagGGggGGggaGggaaGaaaagAAgAagaaAGGggaaAGaGgGGgGgagGGgaggGaGAaggggGgGaaagaGGgGggggGaga	C>C>=DDBFHFEGHHFHFFFFHFEFFFFFFFFFHEFF;HFFFHFFEEHFFE>FEEGEFFGEEHHGGGFDHGHGH<GHGGGHFG:GGF:GDBDGGAFDGGGE:GGGFGGFECDBB?	G	72	A	43	33	9	39	34	0.00915
11	123886549	G	70	AGggAggGgGAgAGAGAggGAGGGAGGAGAGAGAGGGGGGAGGAAGGAAAGGGGGAAGGGGAAGGGAGGG	BBDCFBDEEEFF:EBEDFFDEEEEFEDEEFEEAED9DDDDEDDEDDDEEEDDDDDDDCCDDECCCBC>AA	G	47	A	23	39	23	8	0	0.04614
11	123886717	G	378	GGGGgaggaaGGggGtggggGGGGGgGGGgagGggagGgggGGGGGGGGGGggGGGagGGGGgggggGGggagGGGGGgGggggagGGgGgGGGgggggagGGGaGGGGGgGGgGggGgggGgGggggagGGggggGGGggGGgGGggGGGGggggGgggGGggGGggggGGGGGggggGGGGaggggggGgGGGGGGGGGGGaGgGgGGggggGGGGagGGggaggGGgggggggGGggggGGGGgGggggggGGGggGaaGGGGGGGGaggagagggGGGggggGGGgGaGgggGGggaGGGgGGGGgGgggGGgggGGGGagaGgggGGgGGggggGgGGgggggGggGGgGGgggggGgggggGGggGGGgggg	@=>ACAC?C?5;?@<;AAA@>>===BAAACEBCCCFBBCCBCC7CCACCCCCCCCCFCCCCACCCCCCBCCFCACCCCCCCCCCFCCCC=CCBCCCCCCFCB??F=CCC<@CCC?CCCCCCCCCCCCCFCCCCCCCC=CDDCCCCCBBCC<CCCCCBCCCCC@DACC>DDCCBBCDDDCC8CCGDDDDDDCDCCBBBCCCCCCGCDCDCBDDCCCCCCECCCDDGDDCC8DDDDDDCCCDCDCCCCD?DDDDBDABCDDBGGBCCCCCCBGDDGDG@DCBBBDDDDBABDBGB:DDBBDCGBBBDBBBBDBEEDBBEDDBBABGDGBDEDBBDBBDDDDBDBBDCDDDBDDAABA?@A@@A>>==<><<=<A??AA?A	G	353	A	24	175	0	178	24	0.00000
11	123893801	A	156	AaAAAAaaAAaAAAAaAAAAAAaAAaAAaaAaAaAaaaAaaaaaaaaaaaaAaaaaaaaaaaGAAAaaAAaaaaAAAaaaGAaGaAAaaaaaAaaGaaaaaaaaaaaaaaaaGaaaaaaaaaaaGGGaaaaAgagaaaGaaaaaaaaaaaaaaaaa	BC9<;BDEEDF?FFEFEFFEFFFFEFEEF@FFEFEEEFFFFFFFFFFFEEFFFEEEFGFE;<GF?C@FFFEBFFFF?GEGGDGEGFFGGFGGCGGGEGGGEGGGGFGF<FGGGEGG8@FGFGFGFFFGG=G=GGGDGGFCGGGFEGGGAGGGEDBB	A	145	G	11	39	9	106	2	0.00045
11	124252750	G	45	aagggAAgagaaaaaagGaaGAAGGGGAGaaaagGGAgGaaGGGG	BBGFFFFFEEEEEEEEFGBFGFFFCGGFFFFFFEFFE@FFDCBC?	A	23	G	22	6	14	17	8	0.01691
11	124253100	G	219	GGgGGGgGGggGgGggGggGGgggGgGGgGGgggggGGgggGgggggGgGGgggGGGggGgAgGgGGggggGGggGgggGGggGGgGgGGGggggggGAgGGGggggGGgGGGAgGAGggAGgGGAgGgGGGGgGggggggggAgAAgAGGgaaGGggGgggggggGAgAAGGAAAggGgGggagAGggagaGAGGaAGggAAGgGGgGagaGggAGga	DDC<BBBCCBDEGFEFGEEGGEFFGFGGFBFFFFDFGGFFFBFFFFFGFGGFFFGGGFFFFFFGFGFFFFFGGFEGGGFGGFGF?GEGDGGGGBGGGGFDGGFGGGGGFGGGGFFGFGGGFGGGEF?FGFGGFGFGGGGGG7DEGEEGE>FGGGFCGHFGFGG>GGFEGEEEFEEEGFFGFGGGFEF@EEGGEDEEGEEEGCEFEDDACAB@AAAA?>A	G	188	A	31	82	22	106	9	0.00613
11	124266758	G	66	gggggAgggggggAggggggGGgGGGAGGGGGGGGgGAGGGGGGAGGGGGGAGGGGGGGgggGgAg	BBBEDFFEFEEFFFFFFFDGBFAGGGFGFGFGGGG9GEEFFFFFEFFFFFFEFFFFFFFDGFEFDD	G	59	A	7	34	7	25	0	0.03881
11	124266912	A	160	GggagggaGGGaGgGggGgggaGGGaggGGGagggagGgGGggggGGggGaGGGgggGGGGggGGGgGgGggggggggGGGGGGGgGGGGggGgGggGggggggGgGggGgGGggGGggGGGgGgggGGgggggGgGGgGGgggGggGGggGGGGgGggg	@AAC??@AABABDCGEEGCFFDGGGEEEGFDEEEEEDGEGFF7FFGGDFGEDGGFFEGGGGFGGGF5GEGFDFFFFGEFGGFFGGFG>GGFFGFGGFGEFFFFDG?GGE?GFFFFFFFFFFFDBGBGFFDGGFGFEFFFFFFGGFFFFE?FEEFF:?B@>	G	152	A	8	71	0	81	8	0.00911
11	124267148	C	107	CCtcCcccccctCCtCctctcttcctCtCcCtccCtccCCctCCttctccctCcttcccCcCcccCcCcCCcCctccCcctcCcCcccccccccccccccccccccc	A@A@ACCBBBCDEFFGDDCEDDEDDE@EGDGEDDGEDDFGDDGGEEDEADCDGDEEDDDGDBEEEGEEEGGEGEFEEGEEFE7EGEEEEEDEBEAEEEEEEEEDD7B	C	87	T	20	25	0	62	20	0.00323
11	134054707	C	37	ctcCcctTcctcCtttcTCCttcCCcCCCCCCCCCtC	B>C9DDACGGDGFD?DGGG?DEGGGHFDFFFFFFF>C	C	26	T	11	16	2	10	9	0.02930
11	134182856	A	29	GGGGaaGgAagGgGGaaaggaaggaggaa	@<8AFFCCDFCCCCCFGGDDG?8DGDDHG	G	17	A	12	8	1	9	11	0.04317
12	7025748	T	27	tttttttCccCtTtCCCCCCTCTTTTC	BBEDEE;ADD>D>FFF=FEBEEEFBB?	T	15	C	12	6	10	9	2	0.04733
12	8082367	T	121	ccttcTcctcttTtttcTTTtcttttctTttTtctTTctttTtttcTttcttTtcTTcttctttctTtttTttcTttTtTtctTttTTttTCTTtTTTTttttTtTTTTccttTtTCtTTt	BB<ADCEHBHCDECCBGGGF@GDDDDGDGDDGDGAGHCBDDEDDDGGD>GDDGDGFGHEDHECEHEFEECGDEHCECFEFEHEFAEFCEEFCFFEFFFFECDEFEFFFFHHDDE@D@>CA:	T	98	C	23	38	2	60	21	0.00597
12	9264946	T	130	tgggGTTGTgGgTgGtGGGGtGtGgGtGGGGGTGgtgTTTGTTtgTgGTTTtggGTGGTGTTGgTGtTTgggGTGTTTGTgTtTTTTTTGgttTTTTTGtTGgggggtTGGgGTTGGTGTgtgTGTgggg	C>AA@?@CFEEFCFEEEEEEEEEEFEEEEECDFEGFGFFFEFEDFCGEEFFFG9EFEDFEFFDGD=FEEGGGDDD?EEDEGEFEEEEDEDGFFEEDEEDFECGGGGGFEDDDD@EDCECEC@?AABBAAD	G	69	T	61	38	46	31	15	0.01767
12	9451473	G	177	GgGGGGgGGaggGGGgaggggGGGggGGGGgGGGGGagaGGgGagggggggggGGGgggGGgGGgGgagGgggagGGgGggaGggggagagGagGagggagggggggggGggggggGGgggGggggGggggGgggggggGGggggggggGgggggggGggggggggggggggggggg	@C<8;9==<<@@>?@BFBCDC<?CCCC=CCCCCCACFCFCBCBFCCCCCC8CCACCCCCCCCBCCCCFCCCCCFCACC<C?FCCDDCGBGD=GCCBDDDGDDDDDDDDDCDDCDCDCCDDD=CDDCCDDDDADDDDDDDBBDDDDDDDABCDD?DCEADDDDCDDDDDDDDBDDD@<	G	164	A	13	50	0	114	13	0.02082
12	9459809	G	160	gGGGgGgcgGgGGGgcGggGGggggGGcGgcGggcggcgggGGgcgGggggGcGGgGGGcGGgGgcgGGGgcGGGGGggGGgGGgGggGGggGGgGggggGGgGGGGGggggGGggggggGgGGggggGggggggggggggggGGggGgGgGggggGGgg	@ABCA?CEC=DHHHFFHFFHHFFFFHHGHFGHFFGFFG=FFHHFGFH6FEFHGHDFHHHGHHFHFGFHHGFGHHGHHDDGHACHGHGEGCGGGGDHGGGFGHGHHGH@EGGGFGGGGGGGFGGG:HG>GFGGCGGFAGGGGGGGGGGFGGFBAA@@CCDD	G	149	C	11	65	0	84	11	0.00310
12	9578197	A	263	TTTtTTATTatTtaatTTTTTTTaTATTTtttTTtttTTTtTaTtaaTaTTTatatTtTtTTTTaTttTTaTaaatTttTTTTtTtttTTTTTTatataTTTTatTTaaaatattatttTTTTtTtTtttttTtTTttTtTTTTTTTttTtTtTTtTtTttTttttTTtTTTTTTtTTTTtttTTTtTtTtttTtttttttTtTTttTtTTttTtttttttttTttttTttttTTtTtttTTTTtttTTtTTTTttTTttTTT	B@ACA@?CAEDEGGFHD7FDEFFEFFF>CGGGEFGGGFFFGFF=GFFFCFFFFGFGAGFGFFFFFFGGGFFFFFFGF?GFFEFGFC@GFFEFFFEHFG=FFAEF@FFGFEGGFGFFHCHFFF5HFHBFHHHHFHEDGGFHFBFEFFBHGFGDHFFHFACHHF=GHBEECEEECEEHEEEEHHHEEEHEHEIIIEFHHHHHHEHEEFHEHEEGGEHCHHHHHHGEHHCHEFHHHEEHDHHEEDDEGFFCD5CBBBCBAA@@A??	T	236	A	27	127	2	109	25	0.00000
12	9586746	T	109	tttTttTttTtTTTTttTTTTttAATtTTtttAAATAtTtttAAAttTttAttTtttatAttatttatttttatatttTtttTttttatttttttattttttttttttt	AAA>@B>BCBDDAFCFGFFFFFGF?EGFFGGG9FDEBGFGGGFECGGEGGGGGFGGGFGEGGFHGHGHHHHHGHGBH=F=GHFHHHHGHG9HHHHBHHHHHIHHHFHA?	T	91	A	18	20	11	71	7	0.00286
12	10588530	C	148	ccCCccccccCcCcCCcCGcCGCCGCcccCcGcccGcCcccCcCcCGcCGCCccccccccccGGCcccccccCcGCCCCCccccCcCGcCCGCcgcCcCcCCCcCcgcCCccccccCCcGcCcCCcccggcgcccggGcCgccccgcc	CC?:<=9@@CDADBDCBDCBDBBCCDBBBDB>BBBBB;BBADBDBDCBD=DCBBBBCCCCAACBDCBCC@CCDCCDDDCDACCBDB:CCDDCDCDCCCDCDDDCDCDCCCCCCCCDCCCBCCCCCCCCDDCD@CADCBCCDCBCBC>9	C	125	G	23	45	14	80	9	0.03601
12	10588581	T	97	cTcTTtTTTTcttTtTtTTTtTttcTTcctttctTTcTtTtTTtctttttttcttTtTttttttctTttttttTttttttcttttttttttttttTt	B=B>DDFEFFFEDGDGEFGGE?EEFF@;FEEEFEGD=CEGEFFEFEFEEEDEF;FDFGEFFF>FGDGF?EFFFGFFFFFEGFFFFBEFFFFFFFFFF	T	85	C	12	26	0	59	12	0.03237
12	11506647	T	55	TTTtTTTTTTTTTTTTTtTTttTCTTttTCCTTCtttCtCTttttTTtTCtCtTt	BEFEFGFGFC<GD5GG=FGGEDECFFEFFCCFFCE8?CFCFFED=FFEGC:AAD;	T	47	C	8	29	8	18	0	0.04287
12	11506654	C	53	CCcCCCCCCCCCCcCCccCCCccCTTCCTccTcTTCccccCCccCTTcCTTTC	6FF9<G<GG>@EGGG<BFGEDFCCEDFFDFA<GDDDFEFBFFF:FCDFFDCCA	C	42	T	11	26	11	16	0	0.02255
12	14628773	C	34	TCCCCTCCTCCCTcTTTCCTTCTcTcCTTTcTcc	FGGAGGDGGFGD@CFEFFFFFFFCE9CCCC<=@@	C	19	T	15	13	15	6	0	0.02390
12	15067511	T	35	TTTTTTTTTTTTTTtTTTTTTCcTCTTcTCCTtTc	FEFFDFFDFFEFFEFEFEDEE<CCEEECDDEDGB>	T	28	C	7	26	4	2	3	0.04384
12	18234422	C	83	cCacCCCCaaccaaacCcaCCaccccaaaaaccccCacaaaccccCacccaccccacaccccccAaccaccaccacacaaccC	A?@?B@A>BBEEEEDGGFAGGDGGGGDDDDDGGGGGDGDDCGGGG<DGGGDGGGHDGDGGGGFGFEHFDGGDG@EHEHEE<A>	C	54	A	29	11	1	43	28	0.04910
12	25254975	A	118	CaCacacCccacCCCCcaaacaCaaACaaacAACCCaacaCcccaCcccccCaaaCacacccaccccaaAaacccacacaaaacAaaCcaaccccAccaaccaaaccacCccccacCa	DA=AC@DCEEAEDEEFFCDDGDFDDEFDDDGFFFFFDDGDGGGGDGGGGGG?DDDFDGDGGGEHHHGDEFEEHGHEHEHECEEHFEEFHDEHHHHFHHEEHHEECHHDHEHHGHDDB>	C	67	A	51	19	6	48	45	0.03995
12	25956258	C	46	TCcccccTTctcTtTTccTCtCCcTCTTCcTtcTTTTttttttccT	:GFFFFEEGFEFFEGGFGGGFGGGGEEFGGFFBFFFFFEFEEEF@B	T	26	C	20	16	6	10	14	0.04241
12	31253544	G	85	GGGGGGGGGGGGGGGGGGGGGGGgGGgGAGGAGgGAGAAggGgGGgGggGAgAgggGGGGGgGGggGGAGggAAggGAGAAgGGG	BCB<C==@CDCCCCCCCCBCCBBGCCGCHC;HCGCGBGHGGCGB=G@GABGGGDF8BBBBBGBBGGBBGBGGFFFFBD@DC<:A?	G	72	A	13	51	13	21	0	0.03196
12	49230035	T	64	GTgTtgTggggGggtTggTTgGggGTGTGtgtGgggTtTtTGGTTTTGgtTGGttgTTTgGtTg	B<DEDFFFFFFBFFDGCFFEFEGFEEEFEEGEEGGGBEEEFEEEEEEDGFEDDEEGCEEDA@A@	G	34	T	30	13	20	21	10	0.02730
12	50745811	G	33	GgaAaaaGGgGgGaaGGaGggggGggGGGgGGg	@ACEEFDDECEC:FFF?FECDDDDCBDDDC@AA	G	25	A	8	14	1	11	7	0.04634
12	51585599	T	58	gtttGtttGggtgtgtggggGtGtgggGttttttgttttttGtgtggtgttttgtggg	C?CFCGGGCCCECGCGCCCCCGCGCBCCGHGGGGCGEHHHHCHDH@CGD5HIHEHDDD	T	31	G	27	0	6	31	21	0.00731
12	51585601	C	55	cccccTttctctcttttcTctttTcccccctccccccTctcttctcccctccttt	?DGFFEEEFEFEFEEEEFFCEEEFFFFFFFFFGGGGCFGFGFF@E:GGGGGGFFF	C	31	T	24	0	4	31	20	0.03116
12	52699419	A	137	AAAAAAAAAAAAaAAAaAAAaAAaaAAAAAAAAAAAAAAaaAAAAAaAAAAaAAaaAAAaaaaaaAAAaaAAAaaaAAAaAAaAaAAaAaaAAaaaaAGAGaaAaaaGGaAAAAAaaaaaGaAaGAaaaAaAAGAAa	B@BFFFFFFAFEDFFFEFFFEFF?EFFFFFF:F9FEFFFFEFFFEEEFFFFFFFFAFDFFFEFEFFFFFFEFEAFFFDEEEEAEFEDFEEFEDFFFEEFEFAFEEFFFFCEEBEECE<EDFFE=ECABAC=ABBB?@	A	130	G	7	80	7	50	0	0.04763
12	52711590	G	33	ggAAGgGGGGgAagAgAaAAggAAaAAGgAAgA	ABHHCC>ACCCHGDHDHGHGDDHHGGGBECFBE	A	17	G	16	14	6	3	10	0.01336
12	52825363	G	68	AaAaggaAAGGAaaGggAAAgGgaAAAGAGGAAgGAaAGAaaAGGgAgagAgAggagAAAAAgaGAgg	E?@C@AEGG@CHFFCCCAHHCCCFHG;CHCCHGD@EGHCHFGHC:DHDFDHDGDDEDGEGGGDGBFB=	A	39	G	29	27	12	12	17	0.02742
12	52842736	T	102	TctccctccccccTttcctttcTTcTctctcctcctttcctccctcctcctccttttttcTtcTttctctttttcccctcTTttctttcctttctctttttt	DAC?@@?B>C@BACDCCCE;EDG>DG:EDBDDEDDEEEDDEDDDEDDEDAEDAEEEEEEDGEDGFEDFEFFFFFEECEEDGFFFEEFFE<EFFEEEFBFB<>	T	57	C	45	9	0	48	45	0.00431
12	53045615	A	26	aaaaaaaaAaAaAGGGGGGGGgGGAA	FEEEEEEEHCGEGBBBBBBBBEBBFC	A	15	G	11	5	10	10	1	0.00522
12	54963907	T	62	TTTTTTTCCTTTCTTCTCCTCTTTCTCCCCCTTTTTCCtCtCCCCTCTTCCttCTtCCCCTt	EEFEEEEGGDEEGEDGCGFDFDDDDDFFFFFDDDDDFFEFEFFFFDFDDFFEDEDABBAA@B	T	34	C	28	28	28	6	0	0.02801
12	55807293	A	98	aaAaGAGaGAGaAAAaaGaAGAAAaAaAAGAGAaAaAaaAGGGAAAAAAAAAAAGGAGAGGAaGGAAAAGGAAGGGaAAAAGAaaAAAAAGGaaAGGa	EEFF=GCFBGCFEHHFFCFHCBHHFHGHHCGCHFHGHFGHCACGHHHGHGGGGEBBGBGBBFHBBGGGGBBEBB@BGFGF>BFCFGDDBD@@ABB<?D	A	70	G	28	49	28	21	0	0.00062
12	85277561	T	106	ATTTAATTTATTTAAATAATTTTtATATtttATTTATATAAAttTTtTtAATtTAAtAtAttAAAATttAAtAtAATTaTATAATtTatatTTaaTTtTATatATa	BEGGEFGGGEGGGFFEHFFGGGFEFFFGFFF5FGGF<FGFFFFFGGFGFEEGFEEA?EFEF8EEEE@FAEEFEEEEFFEFEFEEFFFFFFFEFEBEFDFCDAA:AC	T	62	A	44	40	37	22	7	0.02893
12	112590640	A	35	GaaGggaaagggaaaaaaGGgaggagggaaGggag	<EFBCCFFFCCCFF<F<GCCDGDDGCDDCGBD@@A	G	19	A	16	5	0	14	16	0.04927
12	123200334	T	83	ccttTTTcTcttTcccttTTtTTttTtTTtTcTTtTTTTTtctTTTTTTTTTtTTTTttTttTTTtTTTttTTTtTtTTTTTT	A?@ACCCGEGDDEGGGDDEEDC:<DEDDEEEHEECEEEEEDHE<DEDDDDDD@DDDDECDEEDADEDDDEEDDDECCCCCCCD	T	74	C	9	50	0	24	9	0.00012
12	129298815	C	159	ccccGCggGCgggcGCCCcGCcgccccCCcCGcCccgCGCCgccgCgCCCgcCCCGcGCccgcCCggCccCgcgCcCCCCCCCcCCcCcCCCCccCCcCCcCCcCCCccCCCCcCccCcCcccCCCCCCccCCCCCCcCcCCCcCcccCCccccccccc	C?CACDFEGGEEDD?GEFDFFDFDDDD8:DFFD<DDFGCGGDDDDGEDGGFDGDGGDGGDEFE=CEFGDDDFDFGEG<GGGDGDGGEG@DFGGEEGGEFFEFFAFFFEEFFFFEFEDFEFEEEFFFFFDECFFFFFFEFEFFFEFEEDFED:?@@>@@@	C	135	G	24	75	8	60	16	0.04926
12	129298819	C	157	TccCCccctCCCtCtcccccTTcTCtTcccCCTTctccTcCCCccTCCtCTcccTTccTtcTctcCcTTTTTTtTTTtTtTTTTttTTtTTttTTtTTTttTTTTtTttTtTtttTTtTTTTttTTTTTTtTtTTtTtttTTtttttttttTTtTTt	GBB9CB?AGBCDBDGBBGBBE6GGDGG;BB<EHGBGBBHBDDDBGBDDG=EBBBA=BBGHAECECBCG>GGGGHFG>HGHGFGEHHGGHEFHH@F<GGEHHFFFFHFHCFHFHFHFFDFCFFHFFFFFFF<FHFFHFDEGFFHHHFFGGGDD?:C?E	T	112	C	45	66	16	46	29	0.01290
12	129348666	C	46	TtCTTTCCTCTCCTCCCtttCTCTTTCCTtTCtTttCTCCCCctCc	C>EDEEG:E:EGGEGGGGGHECEEDDDFDHDFHDHHF@FBFFACA>	T	24	C	22	15	20	9	2	0.03757
12	132547087	G	70	gggGGGGgGggGggggGGGgggGGggggggggAGGGGGGGGGGGgGGGGaAAGGGGAAAAAAAAAAAAaA	?>A?@@>EFFFG?FEFCGGEFFGGFEDFFCGEFEFFFFGF>FEFBFFEFFEEFFEFEEEDE=EEBEDB?C	G	52	A	18	30	16	22	2	0.02074
12	132547093	A	71	aAaaAAaaaaAAAaaaAAaaaaaaaaGAAAAAAAAAAAaAAAaAGGAAAAGAGGGAGGGGGGgGGGGgaGG	?@DDFFEEEEDFF;EEFFEEEFEAFFGEFEFEEE:ECEFDEE;EFFEEDEFEFFFEFBBFFFFFGFDBBBC	A	50	G	21	29	19	21	2	0.01113
13	19775867	G	59	GggGaGgaGGgagGggagGgaGGaggaggaGaggGGGggGgGgGGagggggggGgGggg	9C=CECEE>CDEECF=BEBEECCEGGDEFFC=GGCCCFFCFBFBBFFGEFGEFBFBDGF	G	49	A	10	19	0	30	10	0.02241
13	19775875	T	57	TcTtcTTtctTttctTtcTTctTtcttcTcttTTTttTtTtTTcttttttTtTtttt	DEEEF>GCFEGEEFEFEFEHEDGEFEEFGGFFFGG>EGEFFGFGFEFFEDFFEFFF=	T	47	C	10	19	0	28	10	0.02210
13	20000613	A	147	GgaaAAAAAaGAagAAggaAAagaAAAAaaaaAAAaAaAaagAAaAaAAAgAgAagAaggaagggaaaAagAAAaAaaAAaaaaAAaAaaaAaAaAaAaaAAaAAAAAAAaAAaaAaAaAaAAaaaaaAaaaaaaaaaaaaaaaaaa	@ACC@CDDDEBCGGFHEFEHHDFFHBGCFEFFHHHFHFHFFFFHFHFHIHFHFHFEFFFFFFFAFFFFHFFHHHEEGFHGEEEGHHEHGGGHGGGCGGGGHHGHCHCHHHGGGGGGGGFGBGGGHGGHGGGDFGFGGGFGAA@?@??	A	130	G	17	59	2	71	15	0.00835
13	20000614	T	144	tTTTTTtATtaTTaatTTtatTTTTttttTTTtTtTttaTTtTtTTTaTaTtaTtaattaaatttTtaTTTtttTTttttTTtTtttTtTtTtTttTTtTTTTTTTtTTttTtTtTtTTtttttTttttttttttttttttttt	AAAAAABC=BDEFDEBGFDDDGGEGDDDDGGGDGDGDDCGGDGDGGFDGDFDDFDAADDDEDDDDGDCGGDDECGGDDDDGGDGEEEG?FE@EFEEGGEGDG>GDGEEFEEEEFDFCFEEEDEEFEE>EEEEEEEEA@???=9=	T	129	A	15	58	1	71	14	0.00432
13	20000621	T	128	TTTTttttTTTtTtTttcTTtTtTTTcTcTtcTtccttccctttTtcTTTtTttTTttttTTtTtttTtTtTtTttTTtTTTTTTTtTTttTtTtTtTTtttttTttttttttttttttttttttttt	B>A?A?BBAAACCEDDDGEEDEDEECGEGDDG?AGGDDGGGDDDEDGFEE>CDDEEDDDEEEDEEEEEDEE=DCEEBBEEEEDECEECEEEEEE8DEDCEEEEEDEEEDEEDEEEEEDEEEEEDDCAB	T	118	C	10	49	0	69	10	0.01323
13	20067011	A	62	AAAAAAACCAaCAAaAAAACCCAaAAAaCaCAaaaaCaAaaaaAAaAaaaACAAaaAaaaaa	HFHHH:HDDGFDHHGGGGGDD>HGHGHGD=CEEGGGCGGEGEGGG>GGGHGCGDGFFAED??	A	52	C	10	27	10	25	0	0.00397
13	21835472	C	32	cccccccAAcCcAcccAccccAAAcAAAcCaa	@CDDDDDHHDDDHDEAGEEDDHHHEHGG:CFF	C	20	A	12	2	10	18	2	0.00006
13	24890228	A	96	acacccaccacaaaaacaCCcCccccccaCCcaaaaacaaCCCaaCcCCcCCCCCcaCaAaaCaAcacAaacaACCCcaCCCaCAACAAACcaAcC	CCCGGGCGGDGDDDDDGDFGGGGGGGGGCGGGDEDDCGECFFGEEFHFGHEGGF?HEGEFAEG<FEEHEEEHE6EFFHEEAFFFEEEEEE?HED<?	C	54	A	42	28	10	26	32	0.00646
13	25027744	A	226	GAgaAAAGAGAagGAGAGAAGGgaAgAAGgAGAGGGAAAAAagGgaAGAAgGggaGGagaaaaGGAGGgaaAAaaAAAAAAAAagAGagagAagAAGAgggaAGAAggaAaaGagAgaAgAAAAaaggggAgaAAgGGGGgaAAaGgaaAGAaaAgaAGgGagAAaagAgAggaAaagaaAagaaAAAAGggGAggAaGggGAggggaGAggAaggaaagaggaaa	@BCC@C@9C>DDGAHCHCHFCCFFGFHHCFACHCC6HDHHGFFC=FHCHHFCFFFCCFFFFFECCHCCFFFHHFFFHHHHHHHGGHCEGFFHFEBHCGGGGGECHHGGGGGGCGGHGGHGCFGHEAFFGGHEEHHGCC<CGGHHGCGGGF;GGGGGGGBGBGGFG=GAGHGDDGGGGGHGGGGGGGGGGBGGBGGDGEBGDBGGD9DGBDGGFFFFDC???ADDCD	A	129	G	97	73	39	56	58	0.01605
13	25671369	G	158	gGgGggGggGgGGggGggGGggGggGGGGgGgGggGGGGggGggGGGGgGggGggGGggtgGgttgttGgggGGgGGGGgGGGGggggtGtGGGGgGGtGGggttgttGGgtGgtgGGtGgggGGGggGGGGgGGggggGGGgGgGGGGGgGGGGGGg	C@BCCCEFEGFGGFFGFFGGFFGFFGGG@FGFHFEGGGGFFGFFGFGGFGFFGGGFGGGEGGGEEGEEGGGAE8GFF:FGGFGAGGGDEFCGFFFGFFDFFEGEEG@EFFHEFGEGFFDCGGGFEFGGFFFFDFEGGGDEEFGFAFFDEDCCCBBBAD	G	143	T	15	80	0	63	15	0.00001
13	25671398	C	161	CccCCCCcCccCccCCcctcCcttcttCcccCCcCCCCcCCCCcccctCtCCCCcCCtCCccttcttCCctCctcCCtCcccCCccCCCCcCCccccCCCcCcCCCCCCcCCCCCCcCCcccCcCCCCcCcCCcCcCCCcCCcccCCCCCCccCcCccCCC	@=?CBEGAGBBGBBGGBBGBGBGGBGGGBB@DDBGG>G><GG8CCBCGEHGFEG@GGGGGBBHHAHHGGCGGCHCGGHDCCCDGBCGGEG@GGCCCCGGFCG>FFFFFFCFFFFFFCFFB?CF9FFFF<FCFFAFCFFF@FF8CCFFFCEFA=C@C=;>CC	C	146	T	15	87	0	59	15	0.00000
13	28712743	T	67	TCttTCttCCTCtCCcCtCCCtCTTTCTcTTttttTTTtTtTTTTTTTtTtttTTtttttttttttt	B?=CBEEG:GFFGFGBGGF<GGFF5FG;BFFGGGGFEFHFHFFFFDFEHECFHEEHHCHHHHHHHCG	T	52	C	15	23	13	29	2	0.00678
13	46937193	T	110	cCCTCcTTCCTCCCTcCTTTTTTTcTcTTTTTTTCTCcTcTCTCCTCCcTCttTcTtcTcTTtctTTtTTCtTTCtcTctcctTTtccCTcTTcTTccTCTTctTTCCct	EDFEFGFFGFFGGGFGFFFEFFFFGEGFFFDFFFFFEHEHEGFFG;9FGEGEEFHEDGFHFFEHDFEEEEEEEEEEGDHEHHFEEEGGEEHEEHEEHHEEDDHC?AAA@>	T	63	C	47	50	23	13	24	0.00110
13	99948097	A	169	AGGAAGGAaaggAAGAgAaAAAGAAgAGGgaAGAGAAGAAaagGAgAggGgGGgAaaaAAgAAGAGAaggGaAgaggaaaggaGgagGAAGaGgAgaGGaAaaaaAAagaAAggAAggaaAAAAAaAgAgagAaggAaAAAggGaAGAaAGGagagagAGgagaaAgga	E>;@B?AGCGGGGHAGFHFHFHCHGFHCBFFHCHCHF>=HCFFCHFHFFCFCCFHGFEHEFCH@HBH8FFCGHGGAGB<GGGGBGGGCCACGCGHGEC?GH8GGDHHEDGHHGGGHDGFFGGGG@FGGGGGGGGGEGFGGGGGBGGBGFGBBEDFGEFHC@FDDCC@=D	A	98	G	71	57	29	41	42	0.02985
13	101289969	C	88	CTtcCCcctCCCctTCCCtctCcttcCcctttcCCCCtTCCCCTcCCCtcctccCcCccttcccCTtTCCttctcttCccCCcCctCt	DB??B?>=GF:EAGEFGFGBGEB??BG@BGGGBHHGGHEGGGGEBFGGHCAHCC?BG@CHGCBCGCHDGGHHAICHA;CBDFCFAHEC	C	59	T	29	32	6	27	23	0.00312
13	110861081	T	101	TCTCTCTCCTCTTCTCCCCTCCCCTTTCTCTCTCTCTTTTCctTTCTCCTCTCCTCTTTTTTCctTcTCCCTCccTCcTCCCCTTTCTTcCCccCCcCCCc	@FGGGGGGGGGGGGGGEGGGGGGGFEGFGFGGEGEGGGCGGCGGFFFFFFFEFFFFFFFFFFFCHEBFFFFFFCCFFCFFF?FEFFFFEBFFBBBD@B@>>	C	57	T	44	46	42	11	2	0.03605
13	113899447	C	209	aaCCCaACccCaAAacaCccCaaccAcaaccaACaCAaCaacaCCacCAcaACCAaCAAcaaaaCCcacaaCcaaccaCcccaccaacCaACCaaacCCcaacACCCaAaaCAaAccCaaaCacacCCAccCACccAcCcACaacCaaacCaaCaCCccACcacacaaaCAccccCccCccaAccccCCccCCccCaCaAAAAcccacc	CA?=>BA=A@>>=EFEEDDDDEDDDECEEDDEGDEDFEDDEDDDDE=D=DEHDDHEDHHDCEEEDDDEDCDDDCDDEECADDEDDEDDDEHDDFAFEDCEFDEHDDDDHEEAGF;AEC=FFDEEE@D@CEEDHDEEHEC8CCFDECDFFECFFCFCCEEGCEFFEEFFGCGEEEDCEDC;E8GDEEECCEEBBECC<CDEDEC@?@:BC	C	118	A	91	52	27	66	64	0.04375
14	20097498	T	35	cTccTcTcctTctccTTTcTcTcCtCtttctCcct	?EBBEBEBBHDCH8CEDECDCDCFHFHHHAGFBCA	C	18	T	17	3	9	15	8	0.03542
14	20097531	G	35	gGggaaGGGgGaGaGgGgggagGaggGGaGGgaga	CBFFEFCCCFCFBGCGCGGGFGCGGFBBEBBGEGF	G	26	A	9	13	0	13	9	0.01307
14	20228227	G	448	GGGggggggGGGGgggggGgggGGGgggGgGGGGGGgggggGgGGggGGggggggGggggGGGGggggGGGGGGGGgggGggggGggGGgggggggggggggGGggGGGgGGGGGgggGGggggGGGgggggGGGGGggGGGGgGGggGGgggGgggGGGGGGgggGGGGGGGGggggGGGgggGgggGGGGggggGGgggGGGggGgggggggGAgggggggggggGggggggggggggggggGGGggggggAGGGgGGgggGgGGGAgggGGGggggGggggggGgGGGGGGggggGGGGggAgggGgGGgGGgggggAGgAGGGggGAgggAGGGgGAGGAGgGGGGAGGAggggAGgGGGAGGggGGAAGGGAGggGAGGggggGAGGAggGGAgggGGggggggGGAgAGggGGgggGAGggGGGGGgAAGGAGgGGAAGggg	@<@CCC???<<:;=A@@A=AAA?>9DBBBCBAB;CBBBCCC=C7CCCCCCCCCCCBCCCCCCCCCACCCCCCCCCCCCCBCCCCCCCCCCCC8CCCCCCCBBCBCCDDBCC;C>CCCCCCDDCCCCCCCCCCCCCCCCCC>C<CCCCCBCCCC=DDD@CACCCDCDBCCCBCBCCDDDCCCDDDCDDDCCBCDDDDCCDDDCCC7DC7DDCDDCCHDDDDDDDDDDDCCDDDDDD@CDD?7A@ACCCDDDDDDFCCCDBCDCCBCBBBGDDDCCADDD9B9CDDDDCDBBBBBBDDDBBBBBDDHDDD?DBADBBDEEDDGBEGBBBDBB?DDDGBBBDBGBBGBDBBBBGBBGBDDCGBDBBBGABDCBBGGBBBGBDDBGABCDDD@EBBGDDBBDDCCBADDBDDCAAFDCABCC@CCC@E@@@?>B???@@<<C=<CCA?CAAA	G	419	A	29	189	29	230	0	0.00000
14	20228250	C	453	CCccCCCcCCCCCccccCCccccCCCcccccCCCCCccCCCcCCccCCcccCcccCCCCCcccCCCCcCCCCccccCCCcccCcccCCCCCccccCCcccCCCccCcccccccCAccccccccccccCccccccccccccccccCCCccccccACCCcCCcccCCcCCCAcccCCccccCccccccCcCCCCCCccccCCCCccAcccCcCcCCcccccACcACCCccCAccACCCcCACCACcCCCCACCAccccACcCCCACCccCCAACCCACccCACCccccCACCAccCCAcccCCccccccCCAcACccCCcccCACccCCCCCcAACCACcCCAACcccACccccccccCACCccACccACccccCCAcccCAAcCCCCACCAcccCccCcCCAACACcCACccCCAcCCcCACccccAAccCCAccCAcACcccAAACACAAccc	DD?BA?>DBBB:DGGH>EFGGFGGGGGGFGFGFFFFFGGFFGGFGGFGGGGEGGGGGGFFGGGGGEEBGFEFGGFGGGCGGGFGGGFFFFGGGFGGFFGGGFGFGEGGGGGFGGFFGGGCGGGHGGGGGGFGGGGGGGGF7GCGGFFHGGGGGEGFEHGFHGGAFF?GFFHHHGFGHHHFHHHHGHGHFGFFFFHHH@GFEFHHFHHHEHGH6EHHGHE?FHFGGFHGGFHHFFFFHGFFFFFHGFFFFFFEHHHHFFHFFFEBEGHFFEEEDFFFHHFEDEHHGHEDGFEHHGFEHHHFFHHDHHHFDEHEEHHDFHHHFEEGGACDEEHE6FFEEHFFEEEHHIEEHHHHHHHFFEEFGHEEHHEFFFDGFFEHHHFEEHDEFFBEFEHFHDHHEHFFEEFEFHEDDHHFDEHEEHFEEGFFFCCEDCCCCCABA?@CAAACCAACA?EEE	C	398	A	55	182	55	216	0	0.00000
14	20228424	G	637	GAAgagGGGGgaGGgaaagGGaaGGGGagggagGGGgagagagagGaggaaaGgaaggGGGGaaGgagggagagGGagagaaGGGgaGGGaaaagaaaGGaaggaGGGgGGGgagggggaagaggaggGgaaagGGGGggaaaGGGgaaagggaagGggagagagGGGGGGGaaGGGGGGGaaaagaaggGgggagGGGGgagaggaGGGGagaaaaaggaaGGggGGGggGGGagagGgggaaggGGGGggggaggggGaaggaaaagGGGGGGGGggaaGGaaagGGGGagaagggggGGggagaGGGGGaagaggggagaGGGGGgaaggaaGGaaggGgggggggggGGGGgGGGGGgGgagggaGGGgggggGGGggggagGgaGGGGgaaagGGgggaagaGgaGGGggaggaggggGGggaaagGagGgGGGGGGgaaaGagggGGgaagggagaGGggGcGGgagagGGGGgggggggGgggggGGGGgGGGGggGggGGgggggggggGGGGggGGGGGgggaggGgGggGggGagggGgaggggggggggGGGGgaggggGggggGggGGgGGGgggggggGGggggGGGgggGGGGGgGGGGGGGagggGggggGgGggggggggg	@A9?CCC=;A@AA<9CBBAC?CDEDCECDDDDCGGGGGDDGFFCF9EFECEEHFEFFFGGHHFFHFFFEFFEFD>HFFFFF@HFHFEHHGFFFFFFFEGHFBFFEHHGFHHHFFFFFFFFBFF=FFFFHCFFFFH;HHFFFFFHHGFFFFFCFFFFHFFFFBFFFHHHHIHHFFHGGHEHHFFFFFFFBFIFFFFEHHFHFFFFFFFHHHHFFDFFFFFFFEHHFFH;HFFHHHFFFFHFFFFFFFHDHHFFAFDFFAFHF<FFGFFE?GHHHEHGHGFFFHGFFFFHHGHGGGGEG>GEHEGFGFFHHDHH<GGDGGGFFFEGHGGGFFEEGGGHH>GGFHFDGEECGGEHHBHGHGDHHGEGGGEG>GGHGGGGGHHHGGAGEGGGEGGGGGFGCEGHGGAGGGGHEGHHHFGDDGFFGGEHHFFG?GGHGGGGHHHGGGGGGEGGGGGHGGGEGGGGGGFHGGH>HGGGGGGHHH@GEGEGGGGCGGGGGGGGGG=GGGGGGBGFGEEGGGGGGDDGGGGGGGFGHGH@HHGDGGGGGGGCGGGGGGEGGFGGGFGFGGGGGGEGEGGGGGEGGEGGDGGGGGGGGGGGDGGGDFFFGEGGGFFGGFFEHEFEACDDEB?AAD<B;BBB@;???	G	492	A	144	220	2	272	142	0.00000
14	21971729	C	87	cCgcccCCgggcCGccGcccgCCGccGgccgccGcGcgcgcCcGgcGcGgccGCcCccCCcGGgCGcCccGGGCgGgCGCGGGCGGc	A8B@@BG;CCCBGGBBGBBBCDGGBBG:BBDCBGCGBDCCBFCFDCG?GCCCFB>FCCFFCFEEFF@CCCDFF7DF=FEFFEFFEC=	C	50	G	37	17	23	33	14	0.01615
14	23248112	A	43	aaaGGGGGgGagaaaaGaaGGaGaGgAAaGaggggggaagagg	>DCFEFGGDGEECDEEGEEGFDFFGEFFFGFFFGGFFFFD?@C	G	24	A	19	12	2	12	17	0.00867
14	24429093	A	64	ACAACAaCAAAACaCAAaACCAcCaCCaAACACAaaAaaCACAAAaCACCAACCaCCAAAaCaA	9GEEDFEFFFFFGFGFCFFGGFCGEFFFE>FEFEF;=GEFEDEEEFFEF8EEEEFFGFCB@B?C	A	41	C	23	28	22	13	1	0.01195
14	24760808	C	68	ccCTCccCCcTCTcTCcCTCTCccTTCcTTtCCTcTctcTtcTCTCTcTtcccctcTTTTCcctTCTt	CCBGCBBDDBHDG8EDBDGDFDCCFGCC=GHDDGBGCH@GHAFCDCFCBHCC@DHCFFFFCCCHECEC	C	38	T	30	16	23	22	7	0.00636
14	35591174	T	225	TTtTTCTtTCCCCTTCtTcTTtCTTCcTTttCCtcCCCTctCTTtTtTTctCCccCTtCtttcCTCTtctcCttCTtTCttTTTCCtcCtccCttCccttTCCtCCtCTCCtcctttTCTTCtttTTCCCTTCCccCCccCtcCCtCCTccTCCttCCTCtTTTcTCtCtcCCcttTtctTtcttttttCTTCTCcCcTTTTtcCccTCtCTCTtccttcttccc	B>?:>B?ADGGGGEE=ECDEEDGEBFBEEEEEGEDGGGDDEHEF@DAFF@EGGDDGCEGEEEDGEGEEDCDGFFGEFEGED@DEGGFEGFEEGFDGEEFFEEGFDFFGEECFGEFFEEEEEGFFFEEGGGEAGG?DG@EEEFEGFEFFCEEDFFEFFFDFFDDDEDFFFFEFFFFFDFE=DEEFE7FFFFDCFDFEFDDDDDFEFEECDFEDFD?A@=A@?;=BB	T	119	C	106	57	66	62	40	0.03284
14	38064215	G	107	CgCcCgCCgCgGGcgccCGCgccgccGcGgCCcggcggggCcccggcggcggcgCggCggcggcgCggcgccgggggcgcgggcccccgcccggccgcgcgccggcg	DC?B<BCEFE<H@FDEEGF=FE=FF;EFHFGGFFDFFFFFGBFF=DEFFBFFFFGFFGDFFF;FFDFFGFFFFGEFA=CG=FGFGEGGAGEDGGG;GGCGHGG:GFD	G	54	C	53	5	14	49	39	0.02409
14	38092025	G	52	ggGggCgGGGGGCGcGCGGGCGgGCCGGCCCCCCCgGCCgCgGCCCCCGGGg	CGFEFGFGDGFFGGGFGGFGGGGGFGFGFGGGFFFGFFFGAGFFFFFFEE?B	G	30	C	22	20	21	10	1	0.01576
14	38092026	A	52	aaAaaTaAAAATAtATAAATAaATTAATTATTTTTaATTaTaATTTTTAAAa	DEDEFGFFEFBGFF:GFEFGFGFGGFEFG@FGFFFGBFFGEGEFFFFFDD5@	A	30	T	22	20	21	10	1	0.01576
14	50824839	G	39	gAGGAgggAgAAGAAAAAagAGaAGaaGAAAgGGgggAA	BAFBFFFFFFFEGEF;BFGGFFGEFFFFEEEGFFGGCA?	A	21	G	18	17	8	4	10	0.02367
14	59950676	A	72	AACaCAAaaCACaACCAacacAAaCaCaCCCaCCaAAaaAAACCCCAAAacCCcCCaCCccaACcACCAcaa	=EGFGFFFFGF@FFD:9FBFBFEGGGGCDGEGGGGEEGGEEECEFFEEEGAFFCEFGEFACGDF?CCCB<;C	A	38	C	34	20	26	18	8	0.04965
14	61857969	A	69	aaAAaAGGAGAAAAGAAGAAAGaAAaaagAGAGAGAAaAgGGaaaGGGGGaagaaGGAAGGGGAAGgGa	?BE;FDHDEGEEEEFD6GEDEHGEEGFGGDHCGDFDDGDGGFGGFGFGGGEG<GEGGD@GGGGCCGE@@	A	41	G	28	25	24	16	4	0.03238
14	70235741	G	106	GAAAGGAaAAgaggGAAAagAgaggaggggAgGagaggaaGaaAgaaagggggaAgaAaaAgGAaaaaAGgGaAgAGggaaaggaAgAggaAagAAGGAAaGGAgA	D@<ABABFEEEFEFGFFFFFFFFFFFFFFFFFCFFFFFFFFGF:GGGG7GGGGGFGG>F=FGFFGGFFFFGGGEGE@G:GGGGGGEEEGGGEGGEEFFDDEEGECA	A	58	G	48	28	14	30	34	0.04946
14	70698041	G	59	GGGGGgAggGGGGGgGGGGgAgGGggGAGggAgggAggAGggggAGGGgGgggAAAggg	BB8?<FEFFE<<EE:EEEEFFFDEGGEFEGAFGBFEGGEDFFGGEDDDGDEFGEED?AD	G	49	A	10	23	10	26	0	0.00156
14	70924566	C	42	CCcCGcGCGGCGGCGcCcGCCccCCGGCgcccGCGGGCCCGG	CBGGFF?GEEFE9FEBGGEFEGGGFEEFHHHFDFDDDDEDCD	C	25	G	17	16	16	9	1	0.03121
14	70925818	T	201	tTTtccttttctttcTTtttttcttttcTTTctcTtTtcTtctTtcttTtttCtcttttTctctcTtttTttTTtTttTcttctTTtTTtTTTttttTTTTTtctTtTtTtTTTTTTtTTTCtttTcTtttTTttTCTtTTTTTTtctttTTTTttTtcttTTTtTTTTTTCtTTTTtTtttTtTtTttTtcttTttTttC	?@???BBCABCBBABACDFFDDFEEDEFGEGEEFFEGCF7EFEEE>EEFEEEGEFEEEEEFDFECGEEEGEEGGEGEDG8BDEFG8EEGEGGABFFFGEFGGFGFGFGEGEGGGGGGEGGGGFEFGGGFFEGFFFGGEFFFFBGFFFFFFFFFEEFF?HEFFFFFFFFFFCFFFEFFFFFFFEFFFEFFEDGEEGDDD@??	T	174	C	27	80	5	94	22	0.00680
14	74983495	C	81	CCGCCCGGGGGGCGGCCCGCcGGCGCGGcGCGGCGCCCCCCCCCGGCGGGGGGGGCCGCcccCGCcGGCcCgGGGGGCCGG	FEE?GGEEFEEEGEEEFFBFGEEFEGEEGDCCEGDFFE:EFEFFDDFDDDDDDDDFEDFDHHEDEHCCEHD;CDA>>AABC	G	41	C	40	40	33	1	7	0.02913
14	76432136	T	49	TtccctTttttctcccccctcccctttctccccctcTccccTttccttt	DA??EAGCDDDFBDGGGGGDGGGGDDDGDGGGGHEGGHHHHGDEHHD@<	C	27	T	22	0	4	27	18	0.03452
14	77332408	T	71	TCtctcTtCCCTccccTcttccTcTTctTCTtcTtttTtctcTtttTTTTttcCTctttTccttcTctTcc	C>E@HBEGGDFEBBBBEBGGBAEBFFB?EGEFCFHHHDGCHCFH>HED>EHHCEEDHFH5BBHCBEC>D<5	T	43	C	28	20	6	23	22	0.04414
14	100795139	G	115	ttGtTtTtgtttgtgTtttgtGGttGTttgtTtgTgGttGGttGGGTTttTtgGGTGtGTtgGgGGTTTtGgtgtGtGtTtGGTttgTTGgtTGgTtgggtgTTTtgGGgGgtGG	<?7DCFFF@FGGCGCGGEG@8CCGGBGGGCFFGCGCCGH;CHFCCC<GFHBHDCCGCGCGFDCCCCGGGGCDHDGBHBAFCBBFHHDFFBDGEBDFHDDDH<FFECDCBC??BAC	T	64	G	51	23	29	41	22	0.03761
14	103568981	A	85	CCCccaAcACaCACCCAaaAAcCACcCCaCCAcAaaACCAACAaAAaaCCAaaaaCcAAaCAACCCaaaAcAaCAccCCacaCaa	A<AC<EHBHDDDHDDDHFFDHCDHDCDDGDBHCH=GHDDGHAFGEGGGCCBGGGGCDGGCCGGCCCGGCGCGGCGCCCBDCG@??	A	46	C	39	23	28	23	11	0.04822
14	106173790	A	122	GaGGgGgggagagGaGGaaGaaGGGagGgagGggggagGGgggGGaaagGaaagggagaGgaGGaGgaagggggGGGGGaaGGGGggggGgaGGGagaggGggaggggagGGagggaggGgg	>@:=A=CFEFFEECECCFFCFF9C:FF?CEFCFFFBFDCCFFFCBFFGFCFGGCGGGEG@GEC@FCG>FGDGG:CCCCBGBBBCBGGGABGGBBBGGGGGBHHH6HHGFGBBGFEGEFD=AA	G	90	A	32	39	0	51	32	0.00000
14	106173808	G	118	aaGaaGGGagGgaGgGggggagGGggGgGGaaagGaaagggagaGgaGGaGgaagggggGGGGGaaGGGGgggggGgaGGGgaggGggaggggagGagggaggGgggGGgaGGgGggg	?A>CA<BAAFCEECFBFFFDEFCCEF6FC@EEEECEEE?EEEEECCECBDCF=EEFFF9;CCCCFECC;CFAGFDCGFCCCGFFDCEFFEFEFFFBFCFFEGGBGBG@BEF<BF?B@D	G	90	A	28	38	0	52	28	0.00000
14	106174767	G	106	gGGTtgGGgGGGgGGtGgGtgGGttGGGtgGgGGGtgGGGGGgGGgGtgGgGggtgGgggGtggGgGGGGggGGggGGgGgGggGGgGGgggGgggGggggGgGGG	A9>?7CACDEEEFEEEEFEEEEEEEEDDEDFEEDEDE@EDEEBEDGEFFEGDGEEGEFFFEFFGEGECEEGFDDF:DDFDGDEDDDFDDFGGD@EDBBBB9@B>AC	G	95	T	11	53	1	42	10	0.00363
14	106174770	A	104	aAAaAAAaAAgAaAgaAAggAAAgaAaAAAAgaAAAAAaAAaAgaAaAaagaAaaaAgaaAaAAAAaaAAaaAAaAaAaaAAaAAaaaAaaaAaaaaAaAAAAa	C=?DBCDDC>CEF5CFEECCE9DCFEFEDECCF?6AEEF6DFEDGEGEGEDGEGGGEDGFEDEECEGGE>GD>DFDHDGEDDGDDGFGDEGGCGGDADEABA>?	A	95	G	9	53	0	42	9	0.00111
14	106354531	T	186	TtTTTtTTttTtTTTtTTtTtTTTtTTTTtTttttTttTtTTTTTtTTTttTtTttTTttTtttTTtTttTttTTtttttttttTttttTtttTTtTttccCCtttcCCCCcccctcccccctcccTTccTttcTTCtTtctctctCCtcctcctccTccccccttcCCccttcCcttctCttctt	?BAB?DCCGGDGGEGFDGGGGGF5GCGGGGGFGGEGGGGGGGGGGGGGGFGGGFGGGGHHGHFHFGFGHHCHHGGCGHHBGHGHGHHCHGHHGEGHEHBCCCCHEHCDDDCCBCCHCCCCBBHCBBCFCCFHIBFFCIFHCHCHCGCCCB?HCCHCCFCC@CACHHACCCCHHCCBFC=BAA9;C>	T	132	C	54	54	13	78	41	0.04282
14	106471595	T	66	TtTTtTtttTTTttTttTTtTTtTttTTtTttctctttttcTCCtTtttCCCtcCCTCCtCCtttt	ABBDDGEEEGGGEDGEDGG?GGCGEFGGFGFFGFFFFFEFGGCCFFFBFCCCFGCCFCCFCA@@>A	T	51	C	15	19	11	32	4	0.01878
14	106518415	C	84	CaaacCCaCAcACACCaCCCCCaCCCCCCCCaCCaCcCacCcaCcCCCCCCcCCCCCCCaCcCCCaCCCCCCCCCcCccCCCcC	@CDCFEGDGFGFGFGGDGHGGGDGGGGG<GEEGGEGHGEHGHEFHFGFFFFHFFFFFFF9FHFFFFFFFCFFFFFHFGGFCACC	C	69	A	15	57	3	12	12	0.00001
14	106518418	A	89	aaaaAAaAAaAGAAAaGAGAAaGGAGAAAAAaGAaGgAaaAaaAaAGAGGAaGAGGAGGaGaGGAaGGAAGGGGGaAaaAGAaAGAagG	DBCEHHFDHFHAHEHFCHCHHFCBFCGHCHGGCHGCDHF>HGGHGGBGBBGGBGABGBB=BGBBGGBBGGBBBBBGGGDFAEDE>CA=C	A	58	G	31	34	29	24	2	0.00047
14	106573251	G	68	GGAGGgGAAgGAAGGGgGGGGggGAGgAggAGGGGgAGAgGGGGGGGAAGgGggGGGgGgGGAgggGG	=;ACBCCEHC@HIDACCBCCACDB9CDHDDHCC@CDHCGD>BB:BBBGGBDBDDBBBDBDABFC@>>A	G	55	A	13	37	13	18	0	0.01465
14	106791201	C	138	CcccccgcggcggCcCggCGCCgCgcgggcCGcggccCCggcccCcgcCgCcCCCcCccCccgcgcggcgcCCCgCcGCGccggggggcCCcccCCcGccgccgcCggccCCcCgcGgcgccCCgGccGgGcccCccG	C@ABBACDDCEDCECGDEGGDGAFFBEEEDGGDFEDCGFDEDDDFDFDGDFDFEGDGDDEDDEDFDEFDEE>G?FAEGFFECFAG?GEEGFEDE?EEGEEGEEFDGGEE?FFEEDDFGEGEEEEFFEEFGFEEEGD>A	C	89	G	49	34	10	55	39	0.03667
14	106940351	C	151	CCCCCcCCCCCccCCCcCCCccCcCCCCCCcCCcCCCcccCCccCCCCCccCCCCCcTCTTCcCcCTCCCcCCTCccCTCcTTCTTcCcTccccTcCcCCCTTCTTCcTcCCCtcTCcCCcCcTTccTCccTcCTccTTCCCCcCTccccC	A>=>BAAD@DDB:DDEBDDDBBDB@DDDDDBDDBDDD;BCDDBC?DDCDCCACCCD;FDFGDCDCDGDDACDDE9CCDFDCGGCFFCDCFCCCCFCCCCCCFFCFFCCFCCCCHBFCACCCCCFFCAFCCBFCCFCCFFCBBCBBD;>>=@	C	124	T	27	75	26	49	1	0.00018
14	107087259	T	70	TTTTttTTTtTtTTtTTTTTTTTTTTTttttGGtGtGGGGGGGGttttGtGtGttGtttttGtttGGGGG	CFCFDDEGFDGDGGEGBFGG9GBGGF@EEEEFFEFEBFGEFFFFED<DEEFEFEEFEEEDEEBB@B>CCB	T	49	G	21	22	21	27	0	0.00001
14	107087285	A	87	GggGGgGGGGGGGGGGggggAAgAAgAAAAAAAAggggAgAgAggAgggggAgggAAAAAAAaAgAaAAaAaaAAAaaAAaAAAAaa	E:CHFCHBIHG9HHHHCCDDDEDDEDDDEEEEEEDD6D?DEDEDDD@DDDDADCDBDDDDDDGDEDGDDCDHGCDDDE?ABC?CCCA	A	48	G	39	38	13	10	26	0.00002
14	107087299	A	93	GGgGGGGGGGGGGGGggggAAgAAgAAAAAAAAggggAgAgAggAgggggAgggAAAAAAAaAgAaAAAaaAAAaaAAaAAAAaaAAAaAAaA	BBBBCCCC@CCCCCCCCCCHHC9DCFH>HHHHGD78D@DGDHDDHDDDDDHDDDHHHHGGGGH9GGHHGEHGGGGGGGGG?GGGGGFGEFDBC	A	55	G	38	44	14	11	24	0.00003
14	107099190	G	45	gGGGGGGGGGGGGGggTTTTTTTTTTTTTTTtggtgTgTTTTgTT	BGFG?EFGGFGFFGGGDFGDFGEFEFEFFFFEAGEGFG;FFFAAC	T	24	G	21	22	13	2	8	0.02915
14	107099230	G	78	AAAAAAaaGGGGGGGGGGGGGGGgaagaGaGGGGaGGaaGGGGgggGGGGgGggGGgGGGGggGggGGgGGGGgGggg	BFHHGHFFCCCACCCDCCACCCBCEGDG@G?BCCGBCGF=BCCDD?BBBBDBEDBBD@BBBDDBDDBBDBBBADBBB?	G	63	A	15	45	6	18	9	0.03342
15	20252361	A	50	AAAAaAGaAGAAaaAaaAaaGaAaAAGaaAAaaaAaGaAGGaaaaaGAaG	C@EHFGBEHBHHF5GGFEFGCGEGFF@GFFHGFGHFCGGBBHFGGG;GEC	A	41	G	9	18	9	23	0	0.00220
15	20444902	C	41	ccTTccccccccccctctcccccccccttcttcccTccCcc	C?>===:@@@CCBAACBGBBBBBBBBBGFBGGCBBECCFC?	C	32	T	9	1	3	31	6	0.02779
15	20456821	G	83	gGGgagAAgggGgAggaaggAggGaaAgggGggAgggAgGggggggGgggggaggAgggggaaggaaggGggggaGgAgGgaa	A><=D@CDBCBBCGCCFFCCHCCCFCHCCCCCBHCCCGCCCCCDCCBDDBDDGDDHCDDDDGGDDGGDDBDDDDHB?FBBDFG	G	61	A	22	10	9	51	13	0.03533
15	21259159	A	138	GagAAAAAGAaAaAGGAAAAaaaAAGGGGAAAGaaaAaaAaaaaAGGaagaagaaaAaAGaGagggaagaaaAGAagaaaaaGAaGagaaAaaaagAGaGaAaAgaaGGaAaaaaGaaagaaaagAaGgaagaaaaaa	@C?@ACACAGFHEFACGHHGFFFHHCACCHHCCEEFCFFHBFFFFDCFCFFFFFFEHFHC@CGFFGFFFFFFHCHGFFF7FGCHGCEGGEHGGGGGBBGCGHFHDFGCCGFFGGBBGGGGGGGFDGF@GFGGGGE;CA	A	101	G	37	31	22	70	15	0.00294
15	22345178	C	187	CCcCCccACCCCccCcccCCaccccCcCCcCACacccCcacCCccaCccCcccccCccCCCACcACCACCCCcacCACAacACCCCaAAACCCCCCCaCCaCCCCcCccacCCccAcaaaacCaaCCcccCccCCccCcccacacaaaccCaacccCCaccacaacCaaaccccCcCCacCccccac	ADA:AADEFGGFDDG@DDGGEDDDDFDGGDGFEEDDD=DEDE8CDEGDDGDDDDDGDDBGGFGEFGGFAFGB9FDGFGFFCEFGG8FFFFGGGGEGGFGGEGEEGDFDEAEFFEDDEF<FFDF;FFFEEEFEDFFEECEEFGEFEFFFDEFFDECDFFFEDFEFADFFF;EEEEFAFFDAB?@=@?=	C	143	A	44	69	12	74	32	0.01529
15	23181922	T	142	CTTTCCCTCTCCTCCTcTTCCTCCCCCCtTCtTTTCtTTCCCtTTTtTTTTtcTTTccctTtTTTTTTcTTTTTTcTTtTTTtTTtcTTcTttcTcctTctTcTTTtcTTcTTtcTTTTTtttTctTTttcTcccTtctctc	?B@@CC?GCGDDGCDGBGHECHDDCDDDG=DGGGGDGFGDDDGFCGHGG@GH@BGGCBCHGGGEGGFGCFDGFGGCFGHGFFHFEH@FFBDHHCGCCHFCF@AFFFHCFFBF:HCFF@FFHHHFCEFEHGBFABBEC7A8=8	T	95	C	47	69	22	26	25	0.00313
15	23181990	T	128	TTtcTTcTttcTcctTctTcTTTtcTTcTTtcTTTTTtttTctTTttcTcccTtctctcTttctttctttcTTTTtTTttTcttTTTcTttttttTtttTttTTtttTTtttttTttTtttttTtTtT	DBA@@?BABB@BBBCCBBF@DEGDDGFDGFEDGGFGGEEEGDEG?E=DGDDDGEDEDEDDEEEDEB9EEFEGGDGFGGFDGEFFGEGBEFBFFFFFEEFFFE@>FEFFFFFFFFFDEFDEB@>A?B;?	T	105	C	23	48	0	57	23	0.00001
15	23182537	C	49	tcttcccttctttcccTTTcTTcTtTtTcttttTTTttccTtTttTttt	?:AAC>>BBBEDEFFFGG?EFGFGEGEGFECFDFFGEEGGEFFEAFDDA	T	36	C	13	14	0	22	13	0.00976
15	33359370	C	102	cccCCTctTcttCccTcTccCTcCTtCccTTCcTcTCTCCTTcTcCCTCtTTTTTCTtTCcTTCTTTctTtTCCtCTTTCttccCcTTCTCtttTTTtttcc	CCAAAECDGCDED@BGDGDDDGDEGEDDDG=DDGDFDGDDGGDGD@DGDFGGGGGDGFGBEFFCFFEEEFFFCCFCFFFCFFDECE?FDDBBBCCDCA@>=?	T	55	C	47	38	23	17	24	0.04485
15	34112825	C	75	TCCTTCCCTCCTCTtCCTTTCTTTTtTtTCCCtCtCTCCcCCcCtCCttTctTCCtTCctcCCtcttctCCCttt	ACEFEGGGFFGAFEEGFBFFEFEFFFDFEEFEFFFFECEFFFGFFEFFDEFFEFEEEDGFGEFEFCBB@AA@>>C	C	38	T	37	31	19	7	18	0.00722
15	40269052	G	81	GgaaggaaaGgaGAGaGGgGGGaaaGgagggaGAGaaagagaaaaagaagggaggaaagggGgagagaaaaGgggagGggg	>ACDDEDDE=FECCCECCFCCCEEEC=EFEFECHBEEBFEF8@DDDFDEEFFFFFDFFFGECFEGEFBFEECG6GD:B@BA	G	45	A	36	15	2	30	34	0.00235
15	42139642	C	87	TttCCccCtCtcttTTtctTcCtTCcCctCTtCtCTCcttCtCCCctCCTcCcctctcTttctTCcCCtTTTCCtcCtCtTTCCtCt	?@C@A=@DFDGBGGGGGBGGBD?GDBDBGDGGABDGDCFHDHDDDBHDCFAC<CHCH@FHHCHFCCCCHFFFCCHCCHCBDEAACCB	C	45	T	42	28	15	17	27	0.01838
15	42302433	A	75	GgAaGGaGAGGGGGGGaGGGaaaAgaggAAagAAagaGaggGGGGGaGGaGaagaAgaAaaAaaagagagaagAG	=BDDC;DCHCB<BCCCECCBEEEHFEGFHHCFHHFGFBEGFCCCCCFCCDABFEFGGFFEFGFEFGFFFFD>B@=	G	38	A	37	24	11	14	26	0.00539
15	42302437	G	74	GgGCgCGCCCCCCgCCCgggGcgccGGgGCgcgCgccCCCCgCCgCggcgGcgGggGgggcgcgcggcGCgccC	DC>@BFGEDGGGGCDGGCCCGBCC@HH<HBDBDGCCCFFGGDGGDGDDCDGCDGDDGDD7CD;DC?DCGFB><A	G	38	C	36	11	22	27	14	0.00960
15	43924422	T	65	TTTTTTtCTTCtTTTTTTTttTTCtTTTTtCttCttTCTCtCTCtTTCTTCTttTTTCTTtTtCt	AEFFFFEBCF@EFCF;EFFFEEFGEFEFEFFDFFFFEEEFDEEDFEDEEEFEFADDFFBB@C;?A	T	52	C	13	35	13	17	0	0.01459
15	51868373	A	60	gagaggAgaAagagaagggaaggagAgaaggggggggaagaagaggggggaagaaaAaaa	CCCAAB@ABBCBCBEECDGFEEEEE:EFFFEFFFEFFFFFFFFFFFFFFFCCFDFDGD<7	G	31	A	29	0	4	31	25	0.04871
15	56297909	C	76	tCCCCctCtCtcCCcccctttcctCtCCCccccCCCcccccCCCCCCcTCCccctCcCCcCCCCCCCcCttCcctt	ACDCDGDDDDDGDDFGGFDDDGFECDDDDGHGHDDDFHHHHDDDDDDEFCCGHHBCHCC=CCCCCCCGCCDBFC@=	C	61	T	15	35	1	26	14	0.00036
15	64428559	G	119	gAAAgGGGGGGAAGAAAGGAAAGAGGGGAaGGGAGGAaAgGgGAAgaggAGAAAGAGAAgAAgGggAGAgAAAgGGAggAAAGGaGAAgaaGGAGagAGAAGaAaggAgAGagAAggGg	A?:?BDCEEEEFFEECFE:FFFFFEEDEBDE=EEEAEEFGEEEFFGEGGDEEAFCEDEEGEEGDG?EDEGEDEEDDCGGECE?DEDEEGECDDEDEEEDEEDEEEGGDEDD:AAA<;<B	G	62	A	57	38	47	24	10	0.01448
15	66821174	G	93	GCCCCgGgGCgggCCgCgCGGGCGcGccGGCGGgGGCCGGCCCCCCcGCCCGggCGGCGCCGcggGGCCCggGGGCCCggGcGGGCGgGgCCg	A@E>5F9G?EGFGEGGGFG@CD>DFDGGDDFDCGEDFEDDEEFFEEGDEEEDGGFDDEDFEDGFFDDEEFGGCDCCFEGGD8CBCB?A<BCCA	G	52	C	41	33	35	19	6	0.02019
15	73995173	C	53	CcCttTtctTTcctttttCTCcctTcTcTcccctccttcTtTcTTTTTTTCTt	?:BFFEEBGGFBAGGHGGGGGCCHGCFCFCBCC7CCHHDFHFBFEFFFEFFBA	T	32	C	21	17	5	15	16	0.04752
15	73996101	G	35	AGgGGGgggAggggAAgAgAgGagggAgagAGaAG	A=BDCDDEEFFEFCF7FFGEEEFGFGEGFFEDFEC	G	23	A	12	7	9	16	3	0.02982
15	90029795	C	73	ccccccCcccccCccccCCcCCcCCCCccCcCCcCccCccccccCCccCCcccCCccggcggggggggggggg	CC@DDC;FEGHGEFGGFAGFGGFGGGFGGGFDGGGGFAGGGG9<GG:F<GGGGFEG@D>GEE?GADGF@:5EF	C	58	G	15	21	0	37	15	0.00378
15	100332989	C	34	ccaCccccaCcAAcCCCAcCCAAAACAAAAcAcA	C>EGBBBBGFCEECFFFACFFDDDDFCDCC=C@C	C	19	A	15	8	13	11	2	0.01279
15	100341255	C	72	CCCCCCCccccCCCCCccCCccCcCCCCcCccccCcCcCccccccccTTCcccTCcccCCcTTcCTcCTTcT	DBGGFEGDDDD<GGHGDDEADDGAGGGGEGEEEEGE>BFEEEEEEE=DDFDEAC<EEEFFEDDEFDEFEC>?	C	63	T	9	29	9	34	0	0.00253
15	100341327	G	66	GAaaaGAaaaAAaGGaAGaAGGaGGaAAGaAAGAaaGaaaAAAAaaggGGaagAAAGaagAGGGAg	DC?A:<DEEDFFEGGEFG?FGGEGGFEFGFFFGFFFFEFFEEEEFEFGFFCFFEEEFFEFEFGCCC	A	43	G	23	20	18	23	5	0.01844
16	772620	T	33	TTtTttTTTTTTTTTTTTTTTTTTTggggggTT	?=>BGDEFEEFFFCFFFDFEFEEFD:7CCECD:	T	27	G	6	24	0	3	6	0.00008
16	1291597	C	31	CGGGGCCCGCGcCCccccGCCcGcgcCcGGc	FBGECFGGGGE;FFCCCCFFFCFBD;FCFFB	C	20	G	11	10	10	10	1	0.04722
16	1494075	A	72	TtatttAttaAAAttAttttATtAaaaAAataaAtaatTattaaaaATtAAattAataaAttAataaaattt	A@B@@CDEDCBFFCDFDCDDFEDFDDDGFDDDDFECCEFE;EEEEEFF?EFEECDEDEEEEDEEAEEEEEEE	A	40	T	32	16	4	24	28	0.01603
16	2301520	G	40	GCCGcgcCGccCgccCCcCccGCGGccCGCcCccGGcGCC	6DD>DFDECDD?FEEDD?DEDB@BBEECBAECEEAAEACC	C	28	G	12	13	10	15	2	0.04084
16	2749195	A	160	AgAggGgaggaaagAAagaagAAgAGAgaAaAagAGggAGaagGggggaGaaaaAgGaaGggGggGaaaaggagAAAGAgggaaggggAAAAaaagaAggaaAAAAGaAaaGagaaAggaGaagaagAAgGAAaAGgAaggAAgaAaAgaaaggAGagaG	@CC@<?CCCDFEFCHHECFFCHHCHCHCFGFHFCHCCCHCFFCCCCC<FCGFFFHCCFFCDDB@DAGFGGD?GDHGHCGDDDGGDDDCHHGHFF<DGHDDGGEHGHBGHGGBFDDGF@DEBGGDGGDGGDBGFGGBBGG9CGGDEGGGDGHGDDGBC?=A	A	91	G	69	39	18	52	51	0.03134
16	3533577	C	66	cGGccccGgcGcgcggGgcccgccggGGgcgGcccggGGgccccgggGcgCccgcggggcgccggg	A>=@>BAEFAE@FDFFEFDDDEDD7FEEEDEEDEDEEEDFECEEGFEECGGEEGAGGFGEGEEFEE	G	37	C	29	11	1	26	28	0.00839
16	10855341	C	43	tcTcccccccccccTccttTctctccctcctccttttcttTtc	CC@ABBBBAB7B=BBBBGGBB7AH@CBHCBHCAHHHH<HHEH>	C	25	T	18	0	4	25	14	0.02480
16	11002904	G	104	GgAGGAGGGGAGAGAGAAAGAGGAAAAGGGGGGGgGGAGAGGAAGggAAAGgAGgAGAAgaAAGGgGAAggGGAGgGGAGAAgAGGGAggAAGGAGggGGAGGa	;DH@CHCCBA<CHBHCEGGCH@CHHHHCCCC>CBDCCHCHBBGHBEEGGGBDGBDGBGGDGGGBB@BGGDCBBGBCAAFBFFBGBB@G??BB?=>>?=A???@B	G	64	A	40	48	38	16	2	0.00826
16	12297201	C	360	CcCccCcCCCCcccCccCCcccCcccCccCCCCCCcCCcCCcCCCCcccCCCCCcccCccccccCcCCCCcCCCCCCCcCccCCCcccCCCCccccCccccccCcCCccGcggggcccCccCCCccccCCCccCcccCcccCcccccCCCCCcCCCCCCccCCCCcCCCCCCCCccccCcCCCCcccccccCCCCccCccccCCCCCCCccCCCCcCccccccCcccCCCccCCCCccCccCccCCccCCCCCCcccCCccCCCcccCCccCcccCCCCCCCcccCGccGGGcgccgCCcGgcgcGCCgcggccccgCcgggggggCCCcGcGgccGccggcccggcGcGCgggcggCGg	@?@ACBB=B?9D?C:EFF7FFFEEEFEFFGGFFGFF?EFAGDEGGEFFFGGA=DFEFFFFFFFFFFFBDFFCGEGFFFFGFFFFFEFFGBFFGFFFGGGFGGFGFFFGG=GFBGGGEG>GGGFCGGFGFFDGGGGDGAGGFGFGGGGGGGFEGG>FF9=GGGFFFGGEGFEGGBGGGGFE=GGFGGGGGGAEFFFFGEFGAEFDDEGGGGGFFEEGGGBGGGGEGGFFFEGFFEEEGGFGG=GGFEGGDFFEEFGGGEEBGFEBGGGFFDFCGGF=FFFEEEGGGFDBGDBDF@GFAFEGDGG;GCD>GEGGGFGGGFGGGBG@CGEEDGCFDCDEBCD?DBAA>BBABAA9BB??AC?D	C	317	G	43	155	13	162	30	0.02296
16	15116625	G	65	tTttgtTgttttggtgttttTTgTgTggtgttggtttgtTtTtTTtgtggttttgtttggttgtt	C??ABB@GFEEEFFDCDEEEGGFGFGFFEFEE;FEEDFEGEGE@GFGFGGFFFFEFFFEGEFGF8	T	45	G	20	10	0	35	20	0.02471
16	20476995	G	116	GgGGgaGgaaaGaaggggGGagGgGGGggGaGGaggaGgggaaGGaGGagagGGggGGaggGGGggggGggGgGggGgggggGGgggggGGggGggGGGGggGgGGGggGgGgggg	BA??BBAFFEDCEEFFFFEEFFEFEEEFFEFBDFFCFECFFFFDEE=DFGFGEEGFED:GGEEEGGGGEGGDGEGGDGGGGFDDFG;GHDDGGDGGDDDCGGDGD@DBGDDBBA<A	G	100	A	16	45	0	55	16	0.00021
16	21531609	C	43	CttcCtCttcctcccctcCtttttTcttcCttctcCctCcCCt	DC>@DBFCDGGDGGGGDGGADDEEBHEDHGEEHEHFGEFHAGA	C	23	T	20	9	1	14	19	0.01123
16	25137385	G	56	GGGGAAGAAGAGAGGAGGGAGAAAAAgGAgAGgGAggAGgGGAGAGAGGAAAAGGA	EEDEFFAEFE7EFEE?EEEEDECEEEGDEDED;DDGGEDGDDECDDCCDD<EDDCB	G	31	A	25	25	25	6	0	0.02813
16	33392148	T	197	TTcTtccTcccTTtcTcctcTTccccTTTtcctcccctccccTTTTccctcTTtccttctTcTttttTTctctcccctccctctTtcctcccTtctcTTccTTtTTtttttttTTtttTtTtTttTttttttTttttTttTtTtTTTTttTTTTtttttttttttTttttttttttTTttttttTtttttttttttt	C@CAB>>@>?AFFHBEABGBGGB@ABGGFFAAGBBBBGBBBBECEEBBBGBGGGBBGGBGGBGGGGGGBB?BGBBBBGBBBGB=GG<BGBBBGEBG?GGB@HHGGGDDDGEGGGEEGGEGGCGGGGHGGGGAGHHHGGHHFHGCGGGGGGGGGGG@HGHGHG5GHFFH=HGHHHHEFFHHHH;HFHIHHFHHHHFHC	T	146	C	51	52	0	94	51	0.00000
16	33404765	A	44	aaAAaaAgAaaaaGGaaaaaaGAaaGAaAAaaaaGaaaaaagag	=CHHDDHFHDD;DC7DCD<DDBHEECGDHHEE9EBEEEECEGEA	A	36	G	8	8	5	28	3	0.03745
16	33410688	C	192	TCCCcCCCTcTCcCccCCCcTCCCcTcCCcCCCTCCCCcCCcCCCCCCcCCccCcTcCCccCCTccTcCCCCCCCCcTCCCTCCcTCcCCTCCCTTCCCTCTTCccCCTcTCcTTccTCCCccTCcccCCTCCCccCCTCTTCTcccTCCCCccCTTCcTTcCCccccccCccTTCCCCCCCCCCCCCTcCT	=B@DDDFFEEFFFGFFGGGF@FGFFFF<CFG?GFGGGCFFEFGGF=GGGFEGFGFFGGFGFFFE:FDFGGGFF6GGGEGFFFGGFFEGGFFGGGDFFEGFGFFFGGGEEGCDG=EGBFEEEGGEEGGGFFEEEFFGDEEFEEFEBGFEEEFEGGFEEEFEEGFEFGGGGGEFGEEEFFDGFDBABAAAA@C?	C	154	T	38	101	38	53	0	0.00000
16	33410777	G	260	GggGTGGGGGGGGGGGGGGGgGTTgGTGGGGTTgggGTggGTTgGGGTggTggTTgGgGggggGGggGGGTggGGGggGGggTTGTGTGggTTGTgggTTgTTgGTTggGGGGgggGTGgggGGTGtggTTTgGTgTTgggTTTTTtgTggGTGgtggGTTGGGgggggggggggtgggGGTgTtgtgGgGtggtTggggTgtgtgggtggtggggttgtggttggggtggggggtggggtggggGtgttttTgttgggg	@?B>B=@:<BAC8ACCCCBCFCGGFCGCCCCFGFFFCGFFBF5DACCGFFB@FGGDCFCFFFFCDFFC>CG>FCC>FFCCFDC6<GCG<FFGGCGFGGGGFGCFCGGGGCCCCGFGCDCGGGC<FCEDGGEG:5FGGGGE?GGGGAEGGGGCGBGECGC>FCCC=EEFG:GFGEGEGGGABFGGEGD7BGBEGGEFGGGFBGEEFFAFEGGEGGGGEEG>GE;EGGEGEGGGGAFEFEGEEFEFE?8C;?>;DB:=D=DD	G	184	T	76	66	49	118	27	0.00003
16	33784236	T	174	TTCTTTCttttTTTttttttTttttTCttTTCtTttttttTTTTTttttttTTTtTTTTTtTTTTttTTttttTTCTtttttTtttCTTTTTTtTtTTTtCtTtTtTttTCtTtTTttTTtttTTTttTCTTtTTtTtttTTtTTTTTCCCTTCttTTTCCtttTtTCCtTCTT	@B?;BA?CB5CEDFDEEDDEHEEEEGDEECGDEG=EDEEEGG=GGEEDDEEGGGEFGGFGFGGGGFFGGEFFFFFCGFFFFFGFEFDGGGGDGFGFGFGFC6FFGFF@EFCFFFFFFFFGEFFFFFCFFCFFFFEFFFFEFFFFFFFFCBCEEBDEEEECBB@@BAC?@AAC??	T	156	C	18	81	18	75	0	0.00002
16	46388499	T	53	tTTaTTTTattaAtTatttaTatTatTtTtaTTtTataTTTTTtttTTTtttt	DGGEDFEGFEEFFDGFDDEFFDEGFEFEFFGFGFGGEGEFGFF@GFFFFF@>>	T	42	A	11	22	1	20	10	0.01491
16	46388714	A	35	AaaaAATAAAaaaaaaATTTAATTTAAAaAaaaaA	BDEEEFFFEEEFEEGGFFFEFEEEDEDEGEGGB?C	A	28	T	7	14	7	14	0	0.02718
16	46390977	T	47	CTTttTtTCTtTCtTTCTtCTttTCTttTttttCTTTCTtTTTtTTt	A?BCDGCGDDAGDCGGDGDDGEEG?GEDGEEEECFFECFFFFFEFF:	T	39	C	8	22	8	17	0	0.03767
16	46391489	A	193	AGAaaAAAAGGgAAAGAaaAAgaAggAAgaaaaAaaAAaaggaAaaAaaaaagaaaAAgAaAaaAaaggAAaAaAaaaAAgAAAAgaaAAaaaagAaaaAAAaaaAaAAAAaaaAAAggagagaaaaAAAAAaaaaAAgagaAAgaaaagAAaAAaaaAaAaagaaAAaaaagAAaAAAaaAaAAaAaagaaA	CB>CC:<@?BAFAEFEEEFFEFFE;FFFFFF=DFBFECFFFFFF;FFFFFFEFFFFFGFFFFFFFFFDFDFFFCFGEEFAGFDEFGGGB:GGGGGFGGFFFFGGFEGFFFEGGFFFFGGFEGGGFGGFEFEDFBGEAEGDGFEEGGGGGGEEBEEEGEEGEEGGEGEEGDGGGEEEEDEGGDGEEGDGGEC>A	A	164	G	29	76	4	88	25	0.00090
16	46391511	G	178	GcgggGCGcGGgGggGggccGGgGgGggcGGcGGGGcggGGggggcGgggGGGcggGgGGGGgcgGGGccgcgcggggGGGGCcgggcGGcccgGGcgggccGgGGggGgGggggcGGgggggGGgCGGggGgGGgGggcggGCgcgGgggcgCggGCGccggCgggcgcgGGgGgGg	<CCA?89;G;BECFECFFGGB=FFFCFFGCCGABBCGFF@@FFFFG@FFCCACGCFCF:>C@FGF>BCGGFGGHFEDGCCCC7HGGGG:CFFHEC>GGFGHHBG@BGGBFCFGGDH;CGCGGFCCGCBBGGBEBAGBGGHGH>CGHGBGGGGFCGGBCBHHGGCEFGH@FF@?B?@?B	G	141	C	37	62	7	79	30	0.00735
16	46392238	T	66	atTTTtaTaaaatTaTaTtatatTTttTTTtTTTTattATattaTttTTTatTtTTTTtTtTttCt	CB@?DED>DDEEEABEEEEDEBEFFEEFEFFF?FFFEFFFFFFF>FEEEEFFDFEEEEFEEDF@B>	T	50	A	15	28	1	22	14	0.00078
16	46394378	C	44	ccCCCcccCcCCcCCCCCcccCcCGCCCccCGccccGGCGGGGC	?CDFGA>BGBGGCGGGGG@CAFCFGFFFCCFGACCCGGD@BAC@	C	36	G	8	19	8	17	0	0.01563
16	46394533	C	81	ggGcCGGGCCGcgccgccGCCCCGGGGgcggCGccgggggggCCcCgCCgcccCCgcCgCCCCCcCCCCgCgcccgggcgg	C@BBEHGHG=CCECDFDDHGFGGHFGHADEEGHD@EEFEFFFGGDGFEGGEEEGGGEGFGAGGGEGGDGGFDFEEGEFDFD	C	45	G	36	26	11	19	25	0.02420
16	46401960	A	45	aaaaaaaaaaaaGGAAaaGGAAAAAAGAAAAAAGaAAaGAGGGAG	:DEFDFEFEFFEAE;FGGEABEDEEEDEEEDDECEFDFDD>ABC?	A	34	G	11	18	11	16	0	0.00389
16	46403723	C	118	cCCtCctcCcCCtCcCtcCcCCctCttcCcCCCCcCcttCCtCccCcCCCccctctcCCcccctcccCCcctCCccccctCCttCcccccccccctCccccccccccccccccccccc	CB?BB>D?FBFFG9BDGBGBGGBGGGGBGBEDEFBE?GGGGGGBB6BGDABBBHCFCFG9BCCHCC?GBCCHGGCBB8BHFGHHCCCCCACCCCCHCCCCCCCBCC@;CCCB>?>;@@	C	100	T	18	35	0	65	18	0.00142
16	46405022	T	80	cccCcCCTCTcCTccCTcCtcccCCCCTcccCcccTTTCccccccCtTTcTttCTTttTtTTCCCccTTtTTCCCTTtCC	C?=BAAGEGEBGEBBGEBBGBBAGGFGDB@BFBCBEEDGCCCCC:GFCECCHHFDDHIDHDDFFFACDCHDCFEEC9CAC	C	49	T	31	23	22	26	9	0.04037
16	46405165	T	101	TtTTtttccttctTTTTtTTtTtttTtTtcTTTttTtTTtTTTTTtTTTTtttTTtTTttTTTtttTttcTttttTttTtTTTTTtttTtttcTtttttTt	CBB;DDC@>CE@CEG@EGGGGGGGGFGGGBEGDGGGDGEEGECFGGGFGGHGHCGHGGFGGGGGHHDGHCDHHDHFHHFH<FFFFHHHDHIH@FHHHGFCE	T	95	C	6	46	0	49	6	0.03027
16	46406281	T	27	ccTCTtcTTTcTTtctctctcctttTT	EF>GEEFEEE?EDEGFDFGF:GFFFDE	T	17	C	10	9	1	8	9	0.04154
16	46406453	C	33	CGCCCCGGGGGGGcGcgGccGccGGGCccGCcc	EGGGGGHHGGGHGEFEF?FFGEEGGGFEABFED	C	17	G	16	7	15	10	1	0.00240
16	46406657	C	27	CCCcCcccCCccCtttctttctCtCct	>D;GDGFGDCGHCEEEGEEEFECECGC	C	18	T	9	9	0	9	9	0.01158
16	46406714	G	40	GggGaaagaaagaGaGgagcaaGGGGGgGGGGgGgGGGGG	BFGCDDDFDDDFDCDCFDGHE<CCBBBGBBBB@BGBBBB>	G	28	A	11	19	0	9	11	0.00015
16	46407937	G	33	tTTGTTTTTGTGTGTgTTGTTTGTGTTTTTggg	DBGCGGGGGDGHGBEGFFCGFFBFBFFDEFG??	T	22	G	11	21	7	1	4	0.03254
16	46408060	C	28	ttCttttttttttttttCtttttcCccc	BCEFFFFFGGGGDGGFHGHHHGHCGCGC	T	21	C	7	0	3	21	4	0.01068
16	47698744	A	93	GAAGAAAGAAGGGGaaaGGAGGGGAAGGAaAGaAAAGGGaaGaGAGGaaagaAGAgaaaAGaagaAGGgAggagAGAGGgAAAGGaaGggAAG	BFEEF;FEFFEEEEEEEDEF?EBE<FEEEDFDEFEEDEEEDDDD=EDEEEGDBDEFEEEEDEFGEEDDGEGGEFDCECCEECDAA?@A?>A<C	A	49	G	44	28	34	21	10	0.04891
16	56667282	C	50	AcaAacaccacaAcaaaccaAcAAAcAcccaAacAaaacAaACAcAAACa	C?CCFBF@BFBF<BFFFBAEFADFFBFCBCGFFCFGGGAEGEFE=EDDFA	A	32	C	18	16	2	16	16	0.00672
16	66614008	T	253	cttTtcCtcCcCTCTCcctcCTTccTCTTCctTCCCCCTCtCTtcccCCttcTTtCCcctCcccCTCCCcTTCTCTCCttCCcTTCcccctcTTTCCTtcTTcTcTcCtccccctTTCcTTccccCTcTTtTCTcCCTTtcTCtCTTCtcctCCTttcTctcTTttTctCCttCccCctctCctctcTctCtTTccctcCTCTcccCctccTTCcctcctcTcttTTtctcTcTTttCTTtTcCtttCtTTct	CC?B7DB<EFHGG>GFFGDFGGAFGFGGGGGBGGFGGGAGBEFDGGGGG@DGAGDDHGFDGGGGGGFCFGGGGFGFGGDDGCFGGGGHGG6GDGFG>DEGFGGGHFHFEH@HHHEGFGH9FFHHHGGHGFEGBFHGGGGEHGGCGGGGEE>EGBFDEHGHEHGFEEFBEFDEEFHHFGEHEFHEHEHEHEFEFFCHHECFFFFBHHFHEHHFFFHHEGHEHFHEBFFEGEHFHEFEECFCDDDC@@=B<C?EB	C	135	T	118	57	65	78	53	0.04449
16	70154480	A	191	GgAGAgaggggaAgAAgagAagaaAAagaGgaggaggaAGGAagAAgggaaggaGaagaagggaggaGgaaggAAgAGAaAAagAaaAaaAgaaaAgAgAgAaaaaAAgAaagAgaAAgaggaaggAAagaAgAgAgaagagAggAaAaAAaAaaaaaAAaaAaaAaaAaAaAaaaAaAAAaAAAAAAAaA	>?=;<@?BBAABCBDDDDFFDDDEBHDEDCDEEEEFFEHCCHAFHHFDEEEEEDBEEECEFEEEEBDCFEEEEEFFFCI=H;EFHCEHEDHEBAEHGAEHEHFEDFGHEG=EFHFFHHGFGGFDGFBHFGFHFHGHGFDEFDH?GHFHF?G:GFEFGDGGFEG=FGEFFEGFGFFEFEG>EBEEBDDBBA?	A	130	G	61	61	8	69	53	0.00000
16	70154499	G	156	ttgggtgTgggttGGgGGGgGGggGggGggGtggGgGgGtGggggGGgGggtGggGGtggggggtGGgtgGtGtGggggggGtgGgGgGgGgggggGGgggGggGggGgGgGgggGgggGGGgGGGGGGGgGGggGGGgGGggGGggGGGGGggGg	ACC>A77A9AAB>6@BBBADC@FFBBFCFFCEFFCACFCECFFFFCCFCFAEAFFC<EECFFFFECCFEFCECECFFGDFCCEFCGCECFCGCGGFBBGGGAGGBDGBGB:BGGG?GGHBBBHBBBBBBBGBBGGBBBGBBGGBBGGAAAA>=?CD	G	141	T	15	63	1	78	14	0.00446
16	70161263	T	182	CTTTTtTtTCTTtttttTTTttTTTtTTTTTTTTtTTTTTTttTCTCTCTCtctTCCCTCctCCTCTCttCTTCCtcTTTCTTCTCCTTTTttttCTtTtTTTtTtTtTttCttTTCtCCtttTCCCtTtctttTTTTttttCTttTtttTCTtCCtTttttCCCttCtttttttttttccc	@@<AACFDGDGHDDDDDGGGDDGGGDGGGFEGGGDGGGGGGDDGDGDGDGDDGDGDDDGDGDDCCDGDDDDGGCDD;GGGDGGDGD8FGGGEEEEDGEGEGGGDGEGEGDEDEBGGDECDEEEGDCDEFEBEDEF<GFEDEDCFEEFEEEFCFEC@EFEEEECCCEECEEEEEAC@>=;DEC	T	138	C	44	69	37	69	7	0.00005
16	70164334	A	176	GGGGaAGGGAGAGGaAAAaGAGAAGAGGAGaGGGGAaAGGgaGGAGGGgAGGAGAGAGAGGaGAGAaGGGGGGaaGAGaAaGGaaggGGGGGgggGGGAAgGGAGGGAAGGgGGAAGGGGgGGGaAAAgggGAagGAAGGGGAGGGAaAAGGGAGGGAGAGGAAGAAGGAAAGGag	ECAEFFEEEFEFFFCFFFFEFEFFEFAEFBGDEEDFGFAEEFEEFEEDFEDDEDEEFEEDDFDEDEGDDDDDDFFDDD;EGDDGGFGDDDDDGGGDDDECGDDEDDDDEDDGDDDECDDDGD@DGEDEGFFDEGFDDE@DCDDDDDDGDFDDCEDEEFDDBABBB:AA>??:B?CE	G	108	A	68	93	50	15	18	0.04738
16	70182375	T	187	TCtTTTTTTCtTTtTCTTTTtTTtCTTTTTCtTTttCTTTTTTTTCTCttCTtTTTCCCtTTCtTttCCTTTCTCCtTTCcTCtTCTCCCCtTCTTtTttTTttttTCCttTttTttttttttttCCTctCTTtTTttCtTCCtCCTttCCCTTTTtCttCCCtTTCCttCCttttTCCtCTtCCct	>BEFEEEFFFGFFGFFEDBEGDFFEE@DFFFGFCGGGEFDE>FEFFDGHGFFGBFEFDGHF;EHFHHFFFEFGEGGHEFFCFEGFFEFEEE=EFEEHEHHEEHHHHEGDHHEHCEHHDHHIEHHHDE?CHFEEHEEGGFHEFBHEFEHHFBEEEEEGEHGFFEHDDDDHHDEHGFCEFDDBBC<@;>	T	132	C	55	72	52	60	3	0.00000
16	70182390	T	214	TTtTTtGTTTTTGtTTttGTTTTTTTTGTGttGTtTTTGGGtTTGtTttGGTTTGTGGtTTGgGtTGTGGGGtTGTTtTttTTttttTGttTtttTttttttttttGGTgtGTTtTTttGGtTGGtGGTttGGGTTTTtGttGGGtTTGGttGGtttTGGtGTtGgtGTTGgGTGgggTGtGTtTgttggtgTGGtgtttgtgGGgggttgTgg	B>GGEGGGBFGGFGGFGGGEEEGFGGGGGEGGFGGGGEGGGGG>GHGGFGDFFBGFGGHDGGDFHGGEGFFFGGGFCFGGFGGHHHFGGHCG=HBGFHGGHHHHD=?EEDHFFFHDDGHDFHFFFHFFFFBFFFEFFFHFGHFFFHF:FFHHFFHHHDFFHFFHFDEFDFDD=FFDDDFFHFFHFDHHDDA?FEEHDEHHB@BDC???CC<?AB	T	136	G	78	67	58	69	20	0.00033
16	70796515	G	106	aaGaaGGaAgGAaagaAaagGGGaaAGggGggaaagGAGaaaGgAGaagaaaGgggagGGgggaGaggagaagaGgGgggggggaggagGgaggGgaagaaagagg	?A;CCABG@CEDEFCFFFFCEEDFFFECCECCFFFCEFFFFFEC=EGFCFFFECCCFCEEBDDGCGDDEDGGDGEDDCD?DDDDGDDGDDDGEDDB?<DGEF?>AB	G	61	A	45	21	6	40	39	0.01456
16	71012855	T	154	TTTTTTtcTtTctTTTTTcTcTTcTctTTcTTccTtcTTTctTTccTTttTTttTTTtttTTtttTTTTTTtTtTttttTTtTtttTtTttTtttTTtTTTTTTtTTtTtTTTTtttttTtTTTttTttttTttttTtTctTTTtttTttttTt	AEEEG;FBGGGBGGEGGGBEBGGBG@GGGBGGBAGGBGGGBGGFBBGGHGGGFGGGFHHHGGHGHGFGFFGHDHFHHHHGGGFHGHFHFHHGHHHFFHFCFFFFHFFHFHFFFFHHHHHFHEFEHHFHFEHFHHHHEHFBGEEEHFHDCCGHF>	T	140	C	14	78	0	62	14	0.00003
16	71163579	C	59	CccCCCCccCccccccCcCCCcCCCCCCCCCTCccCcTTCTTCcccCCCCCcTTcCccc	DEFFGEGFFFFFGGGGGGFGFGFFGFFFEFDEFGGFGDDEDEFGGGFFEFDFEFEBA@D	C	52	T	7	29	7	23	0	0.03584
16	71956517	C	70	CCCCCCCCCCcCCCCcCCCCCCCCCCCccCCCCCCCCCCccCCCCcccCCccCCCCcCCCaaaAaaaAAa	A?<>?CCDCDFB@BDGC?DDDDDDDDD@<DDDDDDDDDDGGDDDCGGGDCGGDDDDGDDDCAA??@>C@B	C	60	A	10	48	3	12	7	0.00290
16	71956529	C	70	TTTttTTTtttTTttTTTTtTTTcccCccccCCcCCCcccccCcccCCccccccccCCccccccccccCc	DDB<A?@@@AAAB@CFFFFCEGG>HHCHHGFCCFCCCFHHGGCACHCCGHHFHHHDCDGFDDCCA>@B?E	C	47	T	23	12	15	35	8	0.00190
16	72054984	G	98	TGTTGTTTgTGTGGTGGTGTGTTgGGtTTGGGGGTGTgGTGGGGTGTGTtGTgGTTTTTTTTGGTTTTGTGTGgTTggGggGTgTTGGGTGgtGTgTT	BDGFFEGECGGGGGGGGBBBFDFDGGHBGGGGGGGBGDGFGGGGGFGGGHFFDEFFDFFFGFFFFDFCFFEFFDFFDDFCDFFDAFEEECE@DCC??A	G	50	T	48	38	45	12	3	0.02285
16	72110948	C	126	GCcgcgGCccCGGCCcGccGCcgCcccgCccCcCCCCCccCggcccCCggcgCCCggccgggCccgCgcCccCCccgccgcgCggggCgccCggCCCcgcgccgcccgccgCCcCccCcCcccccc	AB???B?BFEECCDEGEBGEDGFEGGGFGGGEGHH>GGGGGGFGGGFFGFG>GGFGCHGEGFDHHGFGHGDHFFH;GHHGHGFGFGGFGHHF;GFFEHGDGHGGHHHGHHGFFHEHHEHEAFF@CA	C	89	G	37	36	6	53	31	0.01206
16	74387680	C	137	CCCCCCCCCCCCCCCcCCCCCCTCCTTCCCCCTCTTCCCCcTCCTCTCCCCCcCCcCCcTccTccCCCTCTCTCCCccTcCcccTcTCCCTTTCcCCCTcccCTCCCCCTCccccCCcTCCTCCCCCccCCcTTCcc	@DGFDFGGGFAGGG8B?GGGGGEGEEDF>GGFEEEE8GGGCEGECGEGGGEGCFECFF7ECCECCGFFDFDFDFFFCCDCFCC8;CD:FFDDDFCFFDDCCCFDFD=FFDFABCCFFCCFFCEGFDC==AC8A??@A	C	110	T	27	80	27	30	0	0.00115
16	74394654	C	327	AaacCaaCAccaacacAccCACaCCacCacaccccAAcaccccCAcaccaCCacaCACCaccacaaaCCCAcacaCccAAacaccacacaaccccCAcAaCACcccaACCaacaCCCCccCCCccccACaccacaCCCcccccccccaaACCcACCACaCcACcaCacCCAacCCcccCCcaCCccACcaccCccaCCccCCCcacaccccAccCccaAaacaCcCCacccaaCAcaCcccCacCCCaccaCCccCaAccCCaaaccccCcCCccaCaaccccaAacCCCcaCCcacccAcCACcCCccCCCaccccCccccCCCCc	CC?C;DD<9=8BB=C?A??CEFFFDEBGDBFAABAFEAFBAABGEBFBAFGGFBFGFGGFBBFBFEFGGGFBFBFGBAEFFBFBAFBFBEFBBBBDFBFFGF8BBBFE=EFEAF8DGE??AGGBBBBFGGBBGBFGGEBBBBBB<BBFFFGGBEGEFGGDBEGCGGGCDGFGCGGCCCFGCGGECCFGCGCC=C=FGFBCGGGCFCGC;CCF@CGC<GFGGCGFCFEGBCBGGFECGGCCCFGCGGFGCCGFDCCFGEC:FFGG>?CC>F8FFCCGFGGCCCCG>FBFFCCGFFCG@CCECFEFCFFBCFFFFCCCCFCCABC@AA=	C	227	A	100	92	29	135	71	0.04796
16	74394671	T	282	CCcccttctctccttttCTCcCcCCccccCTTcctcTCTTttCTCttccCTcctcccTTCcctccctcccCTtCCTCCTcTcCTtcCctcTTCctTTttcTTccCTccCTccccCcccCTttTTTcccctctCcccCcccCcctcTtCccttccTCtcTcttTctCTTcctcTTttTcCttTTcccccccTcTTcctcTccttctcCctTTtcTTccctcCtTCTtTCtcTCTcctctTttcccTTTCtTTTtcTtTcttctTtcTTTctcTTTcTttcttt	>A?CCCC=B>C8>DCBB8?=?C@FEBBBBG9FABF>DGGFEFGGDGGBBFGBBGBBB>GGBBGB@BGBBBGGG=EGDGGBDBDBGBGBG>EFGBGFFHGCGGB;AGBBGGBBBB8BABGDHHAGGCBCBGBGGBACGC?CGCCHCFH<CCHHCCFGFCGCHHFCHGGECCFCG>HGGBGH=GGBB6BCCCGCEGCCBCGCCHHCHCBCHDE:AGFCC>HCFHFFFHFFHCFFFC>HCHFHHCC?EFFFHFFEFCFHFCHHCHDHAFEECGBFGFACCA<AAE	C	148	T	134	38	68	110	66	0.00002
16	81062171	C	76	TTTTTTTTTTTTtCTTtCTttTCTTCtTTtCtttCTtcTTcTTTctttttttCtCCTCCTCCTCCCCTCCCCTCCt	AECEEEEEDEEEEGEDEECDEE?EE5EEDEGDEEGD>GDCGDD=GE?EEDDDF?FCDFGECDCBCBBBCCCA>B?@	T	50	C	26	31	23	19	3	0.01766
16	83065664	G	75	GGGGAAAgAGGgGGAAAAggGGAAgGAGGGgAaaaGAAAGAGGAAagAGAAaGAgGaAaAaAAggggggggAAAA	<BBCHHHFGCCGA;HGHHGGAAHHGCHCCCGHEEECGGGBG?BGEEGGBGGDBGGBEGEGEGGE?FBABBAACA@	A	38	G	37	30	21	8	16	0.04972
16	85775097	G	31	GcCCGGGCcCGCCcCGcccGCGGCCGCGGCG	HGGDGHHGHGHFFHDGGHHGFGGEFFEE?CC	C	18	G	13	12	13	6	0	0.02754
16	87678144	T	252	TttcctCttttCTCCttTTttCtTtcCTtttTCCCtCCctccttttCCTTTTTCCCccCtTTtttctCCCTtTCtcTtTtCtCcccCtCTCCCTtcTTtccccCCtcCCCtctcTtCTttCtCttctTCCCCCTTCtccCTcCCTctcTCCtTttTtTTtcCTTttcTCCccTctctcttcccccTcccttctctttTCcctCTcctttTCtttTcTttCCCcctCcCtcctccTcttttttTTtctcCtCc	BACAAC>CDDBCBDBDFD>HGFFFGBACFFGFFFFGGG@GBBGGGGGGFCCFFEFEBBGGAEGGGBGGFFEGEGGB:GFGFG?BBBGFEF6GEBGBFEHCBBCGBGCFGFHCHBFHEFHHFHG=HCH@EG>FGCFFGCCEFCGGCCHCFFFGFHGD7FEH?GFEHHCFEECC?CD?HCHHCBBCCDCCCFHCHDDGHEECCHFACCHHCD=CHGEAEGHFFF@C:DCDHCBHCCEBHHGHHHEEAAF@CB@>	T	132	C	120	47	60	85	60	0.02232
16	88785924	C	109	CCGGGGCCGGCGCCCGCGGCcGCCGCGCcGCGcgcGcCCCGCCGGGCGGGGCCGCCCGCCcCGCcGCGGGCCCCgcgGGCCGGGcGCCGCCCcGGCGcGGGGCGcCCCG	??GHGHAEHHGHDDEGEFGDG9FGHFGEGHGHGFGHGGGAGGE@HCDCHGBFDGFFFGFFGFGFFDDGGGFFFFGF@FGFFGGGGGFFGFFAGFGFGGGFFCEDBBBC@	C	59	G	50	47	47	12	3	0.04847
16	88902780	A	90	GAAAggGggGGGGGGaGAaagAaAaGgGGggaaAgaGGgGaGaaGGGagaaagGaGgagaggggaGgaggaagagagggagagagaaaga	EBBB?C@@@BEFG?GFHCFFCEFEFGCHHCCFFECFHHC9FHFFAHDFCFFFBHG;DGDGDDDDGHDGCDBGDGDGBDDGDGDFDDEGCB	G	52	A	38	22	7	30	31	0.02229
16	89299268	A	304	AaAAAaaaAAAAaaaAAaaaaAaaaaAaaaAAAaAAAAAAAaaaAAaaaaaaAAAaaaAAaaAAAaaaAAAAAaaaaAAAAaaaaAAAAaAAAaaAAAaaaaAAaAAaaAaaAAaaAAAaaaaaaaAAaaaaaaaaAAAaaAaaAAaaaaAaaAaaAAaaaAAaaAaaaAAaAAaAaaAAAaaaaaaaaaaaaaAAaaAaaaccaaaaAAaaaaAaAaaaaaAAAaaaaaAaAAAaaAAaaaaacaAAaAAcaaaAAaaAaaaacAcaAaaaCAcccccAcaccacccCACaacccacCAcCcc	CAA@ABBC@BDD=GGFEEFEF@FEFF=<EFBFFFBFFFEFFFFEFFFFFFFFAFEFFFFFFFFEF;FEE?FBFFDFFFFFBFEFEFFFFFFDEFFFEEFFFEBFFFFBFEGFFFGFFEDBEEGEGEFFGEGFBEGEFFFEFFGGFEGGEEF<GFGGBFGGGEFGGDGGGFBGFFGFGFFFFFF=FFGCGGD6:EFFEGFGDEGGGFDFFEG8GFECEGGGFFEEFE?GGFEFE?EGGEDGG:GFGFEE7EEGG?FDE5GE?>FAGEEGE>GGFDGG=EGEFEAFGEFFCCBBB>B?@A@A?C?C	A	275	C	29	113	5	162	24	0.01507
16	89784349	C	84	cCccCCcCcccccCcCccccCcCcccCcCCcccccCCcccCcCCCCCccccccccccCccccccccccccCCCCAAAAAAAAaa	A8CC7<CAEDDGF@EAEFFF9FEFFF9FAD?FFFFFGF?FFF<FEE;FFFGFC8GGB?GFAFGGGBFGF9>G6EDDEEEEEC>B	C	74	A	10	24	8	50	2	0.00560
17	1798307	A	107	GAAAAAAAAGGAAaaAAgAGAAGAaaAgGaaGGAGGGGaGGgGGAGGAagGaAaaGgAGaAGaAaAaGGAAGaAagGAAaaaAAgGAAGgaGGaGAaAGaGGaaGga	@AAEFFFDFEEFEDDDFACEFFDFDDFFEEEEDE<E@EEEEGEEFEEFDGDEFEEDGEDEEDEEEEEDDEEDEECGDEEEEDEEGDEEDGECCECDDCB?@><@CDB	A	63	G	44	36	35	27	9	0.02182
17	3638344	G	59	aaaGAgAagagaaGGGGagggGaaaGagaGaaaaaGaagGgaggggagaaggaagagag	C??>@AEFFFDFEEEDEFFFFEEFFEF:FDFFGGFEFGFEGGGGGGGGFGGGGGGGGGA	A	30	G	29	2	10	28	19	0.01025
17	7011088	A	55	AAAAAAAAAAAAAAAAAAAAAAAAAGGGGGGGGGGgggGggGgggAAGGGaggAA	@?DEEEDCEBDEDE;;:EECEE@DDGGDGGGGGGGGFFGF6GDED8ADD@?>>F?	A	30	G	25	29	15	1	10	0.00131
17	7225149	C	203	gcCgGgGgCCggCCCGCcCgcccCcgcGGGGgcgGCggcgGCGcCGgGCGGcgGCCCCGGCGCGgGCCcgGGgGCgCGGGCggcCcCCGcCGcgAGcCCgCGCGgGCCGcCgcGCCgCGCCCGggCCGCCCgCGCGgCGGgGCCcgGgCCCCCGGGcGCCCGgCGgcCGCGCCgGCgGGcgCGGGCGgGGCgGCGGCCCGcCG	CB<C;CCFDF@DFFGEEDDFDDDDDED@EDEFDFEFEE?DEA@CFC<EGAEEEDEGGGE9E@FDGEEFEFDEFEF@EEEEGGFEGAGGEEFEDGFEEAEGAEFEFDGDDEDGEDFGFFD8FFDGGDEBFEEFEDEDFEDDGDEEFHDFFFEEFDDDEDFEFDFFDGBEDEDEFFDFGDCEFFCCCDDGCDFGCECCFDCC@BA	G	105	C	97	65	73	40	24	0.04942
17	7453505	C	98	ACCACCCCaaCCCAaCcCcaCAccaCacacCacaCAcCaCCcACCcCCCCAcCACaCCAAcccCAcCCCCaCCAcCCaCCCaaaAACaACACAcCCCA	C@A:DGG=DDGGF?DFGFGEG<GGD6CHEHFEGEFFHFEGFGFGDHGFGFEHGBE<FFEFHHHFEHFFFEEFEEHFF;EFFEEEDDEEDEFCCC>>A?	C	63	A	35	46	18	17	17	0.04576
17	7990577	G	85	GGGGGGGCGCGGGGCCCCCGCCGCCCGGCGGCGGCGGGGGCGCGCGGGCGCCCCCCCCCcGCCCCCCCcCCGcGccCCCGCCGcG	=<GAFG@DG?BGGGGEAGGFGGEGFGGAGEFFGEFFF;FFFFFFF9FEFFFFFFFFFFFHFFFFFFFFHFFEHFFFGGGDCAACC	C	48	G	37	42	37	6	0	0.03337
17	8051639	A	65	AAagggggagAagaAgaaggagagaggaaggaaggagggggagggaaggaaaggagggaagaaag	A5BCEEFEEFCBEEHFEEFEEFDFEEADEEDEEEEEGEFFGFFGFFFFGFBFEGFCGGGFEFFDA	G	35	A	30	0	4	35	26	0.04048
17	9479098	C	28	ACCCCCccAcCAAAcAcccAACAACCAA	GCDEDDEE5EDHHDEGDEEGDCGFCCGD	C	16	A	12	9	12	7	0	0.01033
17	9791159	G	102	GGGggGgggAAGAgGGAGGggAgAGgAGgGGGAAagAAAGAggAaagggGgaAAAGGgggaAgGAGagggGgaAAagAagGGGGaGAAaAgAgGGgAGAAaa	9A<BEAFFFHH>HFBCHCCFDGFH>FHCFCCBHADFHHH;H;GHEE>GFCGEGEFCBG<GCGG?GBFEGG8GCGDBGGEEBBBBEBGGEGEGGBBGFCCC:>	G	60	A	42	29	29	31	13	0.04407
17	14095566	T	275	TtctttTtttTTTTtttTTTttttTTTTtttTtttCttttttttttttttTCtttttttTtTtttTtttttttttTttTTtttTtTTtttTtTCTTtctTtTttttTttCTtttttcttttTTttTtttCTttttTTtCTttCttTttTTtTTTCtTctTTttTtTtttTTtttttTttTtCTtttTtttTTTTtttCCCCtTTtcTtTtctttttttTttTTCttctCttttttTCCtctTTTCCttTttTCTttTtttCttCtttttTtttCt	CCC?C@B>@@A9=@@A@FEEDCDDEGG;DCDGCDDGDDDBDDDDDDDDDDGDDDDDDDDBDGBDCGBDBDDDDDDGDDGFDDDHCGFBDDG6FEFDCGDF>GBDECGEDGDD;DDCGEECDGFEEGDDEGGDDEEGFDGECE@EDFEEGGEG=GGEFHEGGCEGEGEEEGGDDB6EGEEGEGGEEEFEDEFF?FEEDFEGFEFFCHFEEEHEEECEEEFFFFFFEEIEFEDEAEEFFFEHEFFFFFEDFCEFFEE?FEEEEECEBCB?AC@?=A@	T	244	C	31	76	23	168	8	0.00001
17	14095639	A	162	aggaggggaaAAAgggAgggaagAAAgagAAAAAaaAggAAAgaAaggAggAgaaagAgagAaAAagAagaaAagaAaagaagAAaAggAAAAaaAaAAgAagAgaaaAAaaaaaaaAaAaAaaaAaaAaaAaAAAaAAAaaaaAaaaaaaaAAaaaaaaAa	CACA@ABACC>BDBDDGFEFFFFHHHFFFHHHAGFEAFFHHGFFFFFFCF@HFFFFFHFFFFFHHFFHGFFFHFFEHFFFFFFHHEHEFHHHEFEGGFHFHGGHGGGGGGEGGGGEGHFHFHFGGGGGHFGG6EGGGFGGGGG@GGGFGEGGGF>FFECA@C	A	126	G	36	56	0	70	36	0.00000
17	15620481	C	87	tccCCccCCCccCCtcCcctCtCcCCctcccctCtccctCcCccCcCtCcCcCctCcctccCcCCcCcCCcCCcCCCcCCCcCCtcc	AACBBDEFFFFFGGCGGGGDGDGGGGGDFGGGDG<GGGDGHGGHGBGEGHGHGHEFHHEHHE8FGHAGFFIFFHFDFGFFFGFECCB	C	75	T	12	37	0	38	12	0.00094
17	15690664	G	28	gAgAgAgAgAgGAGGGAGGAAGGGAAGA	@FDEFEAFFFGEEEDDEDDEDCCDD?@B	G	16	A	12	10	12	6	0	0.02371
17	16323589	C	119	CacCAaCCCCCCAcCccAAAccCCAaAcAAAcCcCCCacCaAcccAacCACCacacAAccccCccccccccccccccccCcCcccccCCcccccccccccccccccccCCccccCcccc	DBCBCCEFFEEEFFGEEEFEFFGG<EFFFFFFFFGFFF9GEFFFFFFFGF;EFEFFFDFFFFFGGEFFFDGGFGGGGGGGGFGFGGAFG=GGGFFFGGGGFFGGGFGGFEGGGGEGFA?	C	96	A	23	27	15	69	8	0.00138
17	18565409	A	138	gaAgAaAggaaaaaAgaAaagaAaAAaaAAAagAAaAAaaaAaAAaaaaAaAgaAaaaAAAaAaaaAaAAaAAaAaaagAAAaaaAAaaaaaAaaAaAAAAAaaaAAAAAaaAaAAaaaaaaAaaAAAaaaaAaAaaA	>B>BBCEDEDDEEEHFEHEEEEHDHHE?EHHEFDHDGGDEEHEHHDEEEHFHEEHFFFHHHFH@EFHFHGFHHFHFFFGHHHFFEHHFFFEFFFFGFEEGGGEFEGGGGGFFGEGGEEEFFFGFEEFGFDEED@B>AC	A	129	G	9	58	0	71	9	0.01033
17	18647625	T	171	tttTTttTTTTTttttttAATtTtTttttTATTAtATtTaaTTTtAATATTTTtTAaATAAAATtAAtttAtAATATTTttTTtATAATtTAATTtttTAtTATtttttATTaATAAttTtATTTtaTTAtATTAaAAAaTTTAaTAtaTAAATtaTAAttAtttATtAtA	BBCEEDEGGGGGEEEEEEFFFEGEGEEECCEHGFEFGEGEEEGGFFFGFBGGGEG<FEGFCFFEFFF@FEFE9FGFGGGEFGGFB:EFE8FCEFFFDFFDFFEFFFC:FEEFFEFEEAF;FEFEFFFFFEFEEFEEEEEFFFFCFFEFAFEEDEAFEDEEEFECBBC:B9?	T	112	A	59	59	49	53	10	0.00010
17	21194843	T	152	TTcTttTTTccTTtTttttTTttTTttTtTttttTTTTtttttTttttttttTtTtTtTTCTtTTtccctTTtccTttttTTtCtcctctCttcTTTTTttTCTTtTttcTTTcTTctcCtttctTTTTtttTCTTctTtctTttTtTtTTt	A?D?@ACCCEEGGDHDDDDGGDDGGDDGCGDEEDGGGGDDDDDGED9DCDDDGDGEDDD=DGEFGEHHGEFGEGHGBEEDGGEDEHHEHED>EEFGEEGEEFCFFEFD79FFFHFFHEHCEEEHEFFFFDDEFCFFH>FEH9EBCEEFBDCB	T	127	C	25	60	6	67	19	0.04573
17	21906397	C	45	CTTTCCttttCtcCTCTcTTTttCCCTttCCCttCtttCtcCccc	AB;=<BFDEEDEFDHEDFGGGBEDDDGF<CCCDFBEGFCFECGAB	T	24	C	21	9	15	15	6	0.03621
17	25909816	C	47	tcctTttCttctCtcccCCCctCtttttTtccTTCCCTTCCctCCCt	BAAEFAE@DEDEGEDDDG?GDECEFDEFFEEEFEECEDEFEEFFFC=	C	24	T	23	14	6	10	17	0.03921
17	27613677	G	134	AGGGGaaAAaGgaGAAGAaGgGagaAgGAGggaAAagaaaGAGggAgaaaaGAaGGagGGagagAAGgGagagGaaGgggGGgaGagGgagggagaaGaaaGgGGggagaGGGaaGaaaGGaAGAGgaAAagGG	BEEDACDB>FFCFFEEB>FHCHFCFACGEHCCFEF<CFFFBEECCEBFGGFHEAGGFD@HGDGDEEHDEGDGDHDGHDDDHHDGHFDHDGDDDGDGGGGGCGEGGEDGDGFFGGGGGGGFGGDFBFAA7@A<B@	G	72	A	62	40	19	32	43	0.00513
17	36352489	A	167	AaaAACaaAACAAcAAAcAAaAaAaAAAAAAaaaaaaaAcAaAAccAcaaaAaaAAaaaaaAcAAAaAaaAaaaaaAAAAAAcaAaAaaAAAcAaAAccAAAaAAAcaaAacacaaAAacaaaacaaaaAcaAaaaaaaaaaAaaAaaaaAaaaaAAaaaAaAaaaa	AA@>@<<BA>A>>@CDDCDEDFCEDEFF;EFDDDDDDDFFFDFFDGBF@DCFDDFFD<DDAFGFFEDFD@FDCDDAFFEFFFGDFCEEEFEFBEDFFAHFE=EFEFHE;FEHEGDDDEEHEEAEGAEEDEABE<BEA@@CEEE>EEE>E<DEEE>EDEEDECEDC:B	A	148	C	19	66	2	82	17	0.00520
17	36352537	A	111	AggAgAAAgaggAgggagaaggAAagaagggaaAggAggagagggaAgaAggagAgggaAAaaaGaAaagagaaaaAaAaaAAaagGaaGGgaAaAaaaaGggaaaaagga	AA=ABCD?=ED6FFCFFFFDFFFFFAFFFFDFEFFDFDDAFFFCFFEFFFFFFFF>BFFEDFFGGEFGEGGF7FAFF6FGGFEGDGFGGGFGDEGEEGGGFGGCFFGE@@A	A	67	G	44	22	5	45	39	0.01241
17	36365191	A	124	AaaTaaTaataaaaataATTaaaaaaAataaaaaaaattaaaataaaataaaaaaaaaaaaaataaaaaaaatatataaaaaaaaaaaaaatttaaaaaataaattaaaaaaaaaaatataaaa	BCC=AA?B<@CCDDDCDE<ECDDDDDEDDD9DDDDDDDDDDDDDDDDDDDD<DCDDDDDDDDDDDDDDCDDDDEDDDDDEEEEEEEEEEEDEEDEEEDEE<EDEEEDEEEEEEEEECEDD@C?B	A	101	T	23	3	4	98	19	0.02200
17	39190953	G	56	gGggggGggggGggGGggggggGgGggGGGGgggGGGgGCGCCCCCCCCCCcCCCc	?@=BBCGBCCCHCCHFCCCCCCDCHDCHEHG@DDGFG;GFGFEFFFFFFFFGFFFD	G	40	C	16	16	14	24	2	0.00236
17	39190954	G	57	GggggGggggGggGGggggggGgGggGGGGgggGGGgGAGAAAAAAAAAAaAAAaAA	BABBCCEFFEEFFEEEEFEFEDECFEEDDEAFGDDD>DGDGGGEGGGGGG>GGEEAA	G	39	A	18	16	16	23	2	0.00120
17	39240511	A	128	TaatatttTTtaTTttaaaaaattTaTtaTtTTTTaaattTTTtTtaataaaaTTTTTTaaaattTaTTttTtTttttttttTTTTtTtttttttttttttttttTttttttttTttTttTtTTTttt	CC?ACCCBBCDCDBFEEEDDEDDDF?CEEEEFEFEDEDEEFFFEFEECEEEEAFFAFECEEFEFEFDFEFFCFEE?FEEFEFFFFFEFEFBEFFFFFFBFFFFEFEFFFFFEFECEACFEDEECC>@<	T	102	A	26	39	0	63	26	0.00003
17	39254133	G	28	ggGggggGGGGGggGgTTTTTTTTtgTT	BBBEEDEGGFGGEFGEF@9CEFGEC>DA	G	17	T	11	7	10	10	1	0.01612
17	39406299	A	95	aaaAaAaaaAAAAAAAAaAAAaAaaaaAaAaaaaaaAaAGAaaAaAaaAaAGaAaAAaaaAaGaGGAAAaAGAaGAGGAAAaGGGaGGAAAaAGG	CB<FDGCCCAGHHHHHH:HHHDHDDCCA:GCDE9EEHEHCH;EFEHEDGEHCEHAEHEEEHEBEBBGGG@GBGEBEBBEGFDAABDB?FDE=CA?	A	79	G	16	40	16	39	0	0.00012
17	39432065	T	26	TTTTTTTTTTTTttgggggggTtTTt	F=BFEEEEEDEDHHDCDDDCCDEBAE	T	19	G	7	15	0	4	7	0.00050
17	39432099	T	39	TTTTTTTTTTTttaaaaaaTtTTtTTTtTTtTTtTTTTT	HGGGGGGEGGGFFDCCB?BG:FFFFFFFFFFFFFFFFEE	T	33	A	6	26	0	7	6	0.00053
17	40001580	T	122	TCtcctttcttCtttCCcttctCttccCcTTTcccCtccttTtCTCtctctctCTCttcccttCCtcttCCcTtctCCCcccCCctcTTtCCCTTctTTCCtCcCCTctTCctCTTtCTCCt	?DC??AACBB>ABC6CCDC?FFGDEFEGFGGGCFFGEEFEEFEEGGEFEFEGEGGGEFGGGFFGGF6FFEFGFFGFGFFGFDFFGFGDFEFCDFFGCFFFF@FFFFFGFFFGEFE=EB?ACA	C	64	T	58	33	19	31	39	0.04439
17	40714804	C	71	CACCCacaaAAAACCACCaCAaaaaAaAAaCCaaCaaAcACCACAcCCCcCaAAACCAAaACcAAaaacAC	CCGAGEDEE>EDFGGEAFDG;FFE@E@EDFGGFFDFCEEDGFDFDEFFFDFFDCDFFDDEBFE@CEBC?CC	A	42	C	29	23	23	19	6	0.04412
17	41561622	A	29	ttTTTttttaaaaaaaaaaaaaaaaaaaa	CCA;=B@@BGGCFGGGCGGGGGFDC??>;	A	20	T	9	0	3	20	6	0.02299
17	53851228	C	82	tttTCtcctTtTTCtttTtCcTtttCTttCCcTtcTtttttttttCCttCCtcCcTcCtTTtccTTTtccCtCcttcCtCCt	??D:?GABGEG=>GGGGEFGBEGGGEEGGGECDGCEGHHHHHFGDGGHHGFHBFCBCFHDDGCB@DDHCAF6FCHC@FFGB<	T	51	C	31	15	17	36	14	0.03495
17	62796759	A	106	acACAacCAaAccaAAACacaAAaaAAAACaACACCaAACCAaAaACaAAaaCACAaaACACaaAaACAAaaCACAaaaAaCCCACaCcaaaaaCCACaaCACaCa	<C;<BD@CGFG<AFHHHDFBFHHFFBHI@DEHDHDDGHG7DHDHGCDD@HGGDGDEGGHDGCGGGGGCGGHDCGCGGGGGGCCCFCECCGGGGFBCGCCCAC@?CD	A	72	C	34	36	28	36	6	0.00147
17	71357983	T	95	ctTtCtCtTttCTCcTtttcCcCCcttttctCcctctCtCCtCttCtCCTctctccctccccCTtCCTcCtttcttTtccCctccccttccttcc	CCBB<B?DFEECGCDHBEEBDDDDDEEEEDDDDDEDE?DDDEDDEDDDDGDEEFECDCDAEEDGF>DGEDFEFEFAFFEECEEEBEEFCEE9EEC	C	51	T	44	20	8	31	36	0.04125
17	72889676	G	183	GggGgGGGGgggggGgGGGGGGGGGgggggGGggGGGGggGGgGGGgGgGGgGGGGgCCCGGGCGGCCGCCGGGCCCCCCGCGGGGCGGGGCCCGGGGgcggcccgccgccccgccccccgccgcccgcgcgccgcccccgggcgCGgGccccGGgCggcgGGCcccCcCcccCcccccCccC	@CBGCAHGHCCCCCHCHGGHHHHHDDCCCCAHCCHEHHDDHHDHHHDGDGGDGHGG8EFDH;GF:FEGH>GBHHEEGFFFHFH?EGFBHAG?GFHHHG8CDCCCBDABDCCCCCCCCCCCDCBDCCCCBDCBBBBBCCCCCCB;CFGDF?CCCGGE>DDCDGGFCCCFCFCCCECCCBBB;;A	G	106	C	77	62	27	44	50	0.00263
17	72889685	G	167	AAAaaaaaAaAAAAAAAAaaaaaAAaaAAAAaaAAAAaAaAAaAAAAaGGGAAGGAGGAGGGGGGGGAAGAGGAGAAagagagggaggaggggaggggggaggagggagagagggggggaagGaAggggAAaGaagaAAGgggGgGgggGgggggGggGgGGggggg	=@AEEFEEDFEDEEBFEEFFFFF<EFFE?BEFF;EECGEG6DFEEEEGGGG8?HGEHECH9HHHHHCEAHCHH9GBE>CGDACCCFCCFDDDCADDDDDCGDCGCDDFCGDFDCDDBBDFF7GGDBDDDDDG?GGDHDDGDEEGDFDDDGDDDDDGDDFDFGBCCA?	G	86	A	81	29	44	57	37	0.00829
17	72956124	G	138	GAGgAagGAGAagAagGgAaGgGggGaaGagaAGgagaaaaGaAAGGaGaGgaGGAAAaGaaGaGaGGGGGGaAAAGAGGGgggAAGgaGGGagaaAGggaGgaAaAGGAaGgaggAGGGGGAGAgGAgagggaaaag	@C=CCA?=B>DEDHEBCCHFCCCCCCFFCFCFFCCFCFFFFCDEFCCGCFCDGCCFHHE@DFCGB=ACCCCCFHHHCHBC5DDDHHADGBBBGCGGGBDDGBDEGGGBBGGBDAEDGB@BBBGBGDBGEGDDDFDACA	G	75	A	63	46	26	29	37	0.02595
17	73208184	T	125	ttTCCCTctctctCcCtcttccctctTTTccTTCCCCtCctttttcTtccCtcctTtcctTtctttCCttcTTttcccttTtttttttttcttttttttttttttttttttttTtttCttttttt	C?=BBB>5B5D>DC@@HBHGBBAGBGBBFBE<CG@DFGFBEGGGGBFGBBGGBBGEG@BGFGBGGGGFGGB@FGGABAGG<GGGGDGGGG??GGHGGHHHHHEHHGHGHGHHHBHGIFHHGHG@C	T	86	C	39	14	14	72	25	0.02052
17	73208205	G	68	gggGGgggGGgggggggGggggtgttttttttttttttttgttttttgtGtgtTtttttttttttttt	?C?A;@AAAC@BBACCCGGFFFGFGFG;GGGGGGGGGGGGFGGFG>GFG<HCHEHAHBHHHEFHGFFE	T	41	G	27	1	6	40	21	0.01343
17	73208206	G	54	TTtttTTtttggggggggggggggggggggggggggggggGggggggggggggg	?AC??=A@CDBDCDABCCCCCCCCCCCCCCCCC:CCDDDCHDDDBDE@DDDBB;	G	44	T	10	1	4	43	6	0.00300
17	73517536	G	134	GgGgAGAGGGAaGAAgAAGGgGGGagAAGAaggaGGAGagGagGAAgGGGAAGgAgGaGagaagGAgAgAGAggAGAgAAGAAGaGGAgagAAAgGGgggAAAAgAGaAggggaAagGgggAAGaAGggGAaag	7C?C?CHCCACF<HGCHHBCFDCCCFHHCH@FFFBBHC7FCEGCH>GBCCGB@GHGCG@8FGGGCHEGGHCGGG>CFGEGBEGBGBBGGFGGGGH<BGGGGGGGGGBAGGGGGGGFFADEDDB=?C>9???D<E	G	75	A	59	38	41	37	18	0.03420
17	73626983	G	72	GGCgGGGgGCgggggCGgGgGcggGCCgGCGgcCCgCCGCGgGCggcGCCCgcGCgCCCcgcggcggcCcgG	DGEB=GFFBGFGFCFGGFFGGEGFGGGFGGAEEGDGGEGFFGFFFEDFFFFFEF<GFFAEFEFGDEC?B@@C	G	43	C	29	18	20	25	9	0.03127
17	78081551	T	40	TTttttttTtTttttttTtTtTccTttCTtCCcCCCCtTC	?F?GGGGGFGDHAHHGHAHFIFACFHHCFFCCCC=CCHF@	T	29	C	11	10	8	19	3	0.03978
17	79385314	G	26	GGGGGGGGTGGGGGTGGGGGGTTGtt	BC?:HHH;8H;CG@D=GGGGGDDHA?	G	20	T	6	20	4	0	2	0.04615
17	79390277	G	33	GGggggGggggGggAAAAAAAAAaaaaaaAAAA	@BBFFFHFE<FGGABEDDE7CEEEFFG@C<ACC	A	19	G	14	13	4	6	10	0.03664
17	79409710	G	79	aGgaaaaGAaggAGaaaaaaAAGagAaAGaAAGGGgGgGAGAAGAGGAGGGGAAGGAGgGAaGAGGGaGGAGGaAAAaA	?@?BDEGGFFCCEGFCFFFFFFGFCFF?FFFFGGGCFDGFFCFGBF>FGGFFFEFFEFDFEGFEFFFGFEEEFGDDB7?	A	42	G	37	23	30	19	7	0.01681
17	80352303	G	124	gGgaaAgAaGaGGaAgaagggGaaAgAAggAAgAAggAgAGAgAgaAAAAAgagGagagGGAAAGagagaAaGaAaAaaaAaAggAgAGgAAGaAAAGGAGgAAAgGgAgagaaaaAgagaAGg	>?FEEFDFDEEEDEFFDEEEEDEEFEFFEFF9EEFEFFEFDFFFEEFEFFD6ECEEFEGEAFFEEFFEEEFE?FF;FFFFEEEGGEGEDFEEDDEDEDDEDFEEDEDFE=F?EF9ECBA@AA?@	A	72	G	52	41	18	31	34	0.01795
18	3075503	C	159	CCCCCCCCCCCCcCcCCCCCCCccCCCCCCCCCCCcCcCcCCCcCCCcCCCCCCccCcCCCCccCCCCCCCCcCCcCCCCCCcccCCCcCCCCCCccCcCCcccCcCccCcCcCCCccccCccCcCcCCcCCCccCcccCCCcCCccCCCcaaAAaaaa	>A?;>><@?EG7GGGGG@FGGHGG;HGDGGGGGGGDGGGGGGDGGGGGGGGGGGGHGHFFGEHHGEEGFGGGHGGHG=GGGGGHGGGGHGGGFGGHHGHFFHGDCHFHHFHFHFFFHGHHFHHFFFGAFHFFFHHFHHHFF@HEEFGFCCE@?AADDDD	C	151	A	8	102	2	49	6	0.02096
18	14542867	C	47	ccCCCTCCTCTcCTCTTCccCcTTcCCTcTCCTCcTCCCTCTTTCTc	AAGFGFGG?GEBG;8BDECCFC@FCFGF:FFFDFC9FEEEFEEEFEC	C	30	T	17	20	17	10	0	0.00799
18	14542949	T	85	TTTTTtTTTttcTtttttttCtttTTtcttttctttTttTTttttTttTTTTtTTtTtCCCtTtttcttTTttCCTtTtTCTCCC	>AFFFGFFGGFBFGFGGGGGG>HH6FFBHHHDCFGHBFFFFHH?=DHHEFFDHFEGFHEEFIEFHHEHGEDAHEFEHDHDDFFA@	T	71	C	14	29	10	42	4	0.04386
18	14542979	A	83	gAaggAAaggggaaggaAggAAgggaGggGAAgAAaAgAAAgAaggaagAggAAgAaAaAAAAAaAAaAaAaAAAAAAaaAaA	C>BBECHCFFFDFFFFFFFFIIFFAFBFGCHHGBHFHDHCCGFDCGGGGHGFHG@HGHBG6GGGDGFGGEGGEEGGFFGBD?C	A	56	G	27	37	2	19	25	0.00000
18	21531522	A	37	ggGGAgAAAGgGGAAAAAGAGAGAAGGGGGAAAAAAA	CBEEFCBFFED?E@FEDECEDDDBD>DDDDEEECCBB	A	20	G	17	20	13	0	4	0.03604
18	21739725	T	114	tttCTtTTcctttCcCtCtcCTCCtTtTctcccCTTCTTCCtttTCttctTcCcCTcttTCCTcCTtTCtCCCCtttCCtcCTCcCCcCTCTCTtcTtcCtTCCtTTTcctCCt	CBB<DGGGABGGGDBDGBGB@GECGGGGBGBBBDGG>GGDDHHHF@@HBGDCDCDGCGHGDCGCCFHGBHCCCCHGGCCHCCFCCCCDCFCFCFHCFGCCHF>BHEFF??A??B	T	58	C	56	26	36	32	20	0.04097
19	1036444	G	26	gaGggaggAAAAAAAAGAAAAAAGAG	CCCCCECDHHHHGF:GBGGGHED@E>	A	17	G	9	15	4	2	5	0.02828
19	1036456	C	28	gcGggcggCCCCCCGCCCCCCGCGCCCC	@ECFFDFFCDDDDCBCCCCCCBCBBCBC	C	19	G	9	17	4	2	5	0.01958
19	1036468	A	34	gaggAAAAAAGAAAAAAGAGAAAAGaAGAAgAGA	BBFFCFEFEFBFEDFEEDACEEEEDCDCFEED>A	A	24	G	10	22	6	2	4	0.04775
19	1116117	C	38	CCCtCCtCCTTtcCCcCTtCccCccCtCCcctttttcc	BBFEFGEFF?DGAGGBFFBECCFB==@FGCBGH:GD7;	C	25	T	13	15	3	10	10	0.04342
19	2643563	C	35	ttttCCCtctCcCCCCCCCCccccccccCCCcccC	>DFEC@DDBEDF@CDDCDDBGGGF@GFGCCC:E@A	C	29	T	6	16	0	13	6	0.02165
19	2732986	T	96	tccTTTCcctTTctCctcccCCTTcCcCcctTTTTTtTTcCTTttcCtTTTTTTCTTccTTTCTcTctTCtTTTcCtTTTttTtttCttcTTcCTC	C@C??<CGFCEEGDGGDGCGG=DEGGBGGGDE?EEDDAEHAD9EEHFBEE@EE;GEBHEEEEGCHDH@DFEDDDHFEDDDCDDEEEFEDHDD9B@C	T	59	C	37	40	15	19	22	0.01122
19	4511223	C	140	cCCCccCCCccccCCcccCcccCccCcCCCCccCCCCcccccccCcCcCCcCcCcCccCCccccCcccCccccCcccCccCCcCcCcccCccCcCCCCcccCcCcccCCcCcTcTTTccCTCccTcccCccCTccTTCTc	C;=?><>?@@@AAEEBABGBBADABGBGD;GBBGGEG=BBBBBBGBGBGDBG6GBGBBD?CBBCGCBBGBCCCGCCCGCCFFCGCGCCCDCCGC=GAFCCCFDD>AAFFCFCFCFFECCFFFC@7BC8FBBCC@=B?BA@	C	130	T	10	52	10	78	0	0.00019
19	4511278	C	154	CtcCtCCcCTttcTtCtcCCtCcCcCCCtcTCCtcCccccCctCCtcCCTCtTCtCcccCcCCCTCCtCtCCctCTCCcccccCCcccCCCCcTCcCCCTCccCCtCCCCCCCCCCCCcCCcCcCCCCCccCCCCCCCCCcCCccCCCcCCcCc	DC?9>?CFGGDDGFDDDGEADGGGGG?GDGGGGEHGG@F@GGDGGDHGDGFEFGEGHHHGHGGDGEGEGEGGHE>9GGGHEHHGG:HHGGGGHGG5FFGGECGFFEGFFFFFFFFFFDHDFGCHCFFFFHHCAFFFFFFFGFCHFEEGFAC>B>	C	128	T	26	86	9	42	17	0.00338
19	4511281	G	156	GGgGGgggGgGgggGGgGgAgAAggGAGggAggggGggGAggAAGAgGAgGgggGgAAAAGAAgAgAGggGGGgggggAgggAAAGgGAgAAAGGggGAgAAAAgAAAGAGAGAgAgAgAAAAAggAAAAAAAAAgAAaaAAGaAAgAgGAAAAAG	@;@=CCBCBCBCCCC<CCCHCHHCCCHCDDHCCCCCDCCH@DHHCHDB;DCDDDCDHHHGCHHDHDHCDCCCCDCDCDGCDDHGGCDCH@HHFACCCBGCHHGGDFHEBGBGBAEGDGEGGGGGD9GGGGGGFGGDGGGGGFBGFG?H@5DD@CBC	G	88	A	68	33	65	55	3	0.00000
19	4511283	C	162	CttcTtCtccCCtCcCcCCCtcTCCtcCccccCctCCtcCCTCtTCtCcccCcCCCCTCCCtCtCCctCCcccccCCcccCCCCcTCCCCTCccCCtCCCCcCCCCCCCCCcCCccCCCCCccCCCCCCCCCcCCccCCCcCCcCcCCCCCCCCCCCcccCC	DGFGFGFGGGGAGGGGGFFDGGAGGGG?FCGFGHFFGHHGFFGHFFHF?HHGHGGGDEFF>HCHGGHHEFHHHGHGFHHHG9FFHFFG9FFFHHFFHGFF6HEFFFFFFEFH=EIF6EEFEH;DE@FEEEEEGFDHHEEEHEEGEB@DD=CBB@BAA@@ACA	C	140	T	22	96	7	44	15	0.00151
19	4511284	A	163	aAGggaGggaaAgAaAaAAAgaGAAgaAaaaAagAAgaAAGAgGAgAaaaAaAAAAGAAgAgAAagAGAAaaaaaAAaaaAAAAaGAaAAAGAaaAAgAAAAaAAAAAAAAAaAaAaAAAAaaAAAAAAAAAaAAaaAAAaAAaAaAAAAAAAAAAAaaaAAA	BA>CEFHFFFFHFHFFEIIHFEDHHFFHFFBHGFGHFGHCHGEHHGH8FFHGHEHFHGHGGGH8GFG;BHGGGGGFH=GGHGGHGHHFCGHHHGGHHGGFGCGGGGCGCGGGGGGG=GGGFHDGGG?GGGGGFGGGGGGGGFGGG?CHHDFECCDCB?=?B@C	A	139	G	24	94	9	45	15	0.00621
19	4511350	T	234	AtAATATATAtAAtAtAAAAAttAAAAAAAAAtAAaaAATaAtAtTAAAAATAAAtaaAAAtAaaaaAAtAaAAAttaaAAtatAAaAAaaAttaTAAtaAAAAtaAAAAaAAAAtAaaAAAaAaAAaAaatAtaAAAAtAaAAAaaaAaAAtaAAaAAAAAAAaAAAAAaaAAaaaAAAaaaaaAAAAAAAaaAaAAAAAaAAaAaaAAAAAAaAAAAaAAaaaaaaAaaAAA	EA@CBDFHG;DDFDHDFHHHHEEHHFFHHHHHEHFF=HHGFCEHDBHHDHHGHHDEFEHHHAAFFEEHHEHFGHHFFGFFHFFEHHGGHGGGFFGGFHFGGGGHFGDHHAGHHHHFHEFFHHFHGHCGHDGEFFFGHHHDHGHEHGGGFG?G:FFCGGGGEGGGGGGGGGGC?GGGGGGGG:GGGGGGGGGD@FGGGGGFGGG=GGGGEFFEFFFEGHG==FDACCA@B@<??@	A	202	T	32	139	7	63	25	0.00000
19	4511491	A	424	AAaaAAAAAaaaaAAAAaaAAAAAAaaAAaaAAAAAaaAAAaaAAaAAAAAaaAaaAAAAAAaaaAaaaaAAaaAaaaaaAAAaAaaaAaaaAAaaaaaaaAAaAAAaAAaaAAAAaaAAAAAaaAaaAAAaaAAAaAAAAaaAAAAaaAAAAaaaAAAaaAAaaaaaaaAaaaaaaaaaAAaaaaaaaaaaaaAAaaaaAaAaaaaaaAAAAaaaaaaaaaAaaAAAAaaaaaaaaaaaaAAaaAAAaaaaaaaaaaAAaaaaaAAaaaaAaaaAaaaaaaaAaAAAaaaaaaaaaaaaAaaaaaAaaaaaaAAAaaAAaaaaAaAaaAAaaAaaaaaaaaaGGGAaGaaaaaaaaaGAaaGAaGGGGGGAGGGAGGGGGGGaaggGGGAAaaaaaGGGaaaaGGaaGAaaaaGGGAaaGGGG	BB?C9>=8?ABCC@9??BB@@??6>CB@ACCCCCACEFDDDE=EEDDEEEEDEEDEEECEEEE@EEEEEEDDEEEEEEEEEEDEEEEECEEECEEEDEEEEEEEDEEEEEEEEEFBEEC?DDEEEEEEEEDEEEEEECEEEEEEEEEDEEEEBDEEC;EEEEEFF?FFDEEECEBEEEEFEE@E@FEFFFFFFEEEFFFEBFEEFFFFF?CEEFFFADFEDEAFFE5:EBF=FAFFFFFFFE9EECEEEFFDBFFEE=EEFFFFF:EFFFF>FEBCBBEFFFFDFDEDFFAFDEFFFFFBDFFFFFD5FFFFFBDDEFDDFGEGDFDFEDDEEDC;DEFDFDEG?GDFGFFEFFFEDFGDFFGDCGGBGDGDCFGDGGGGDGFFFECGGGDDFFA5=FFGF?EEFGEFFEEDA;DCC@;;BDCA	A	384	G	40	144	38	240	2	0.00000
19	4511575	C	152	gggggCCCgCgggggggggCCCCCCCCCCCCCCCCCCCCCCCCCCCccCCCCCCCgccccCCCCCCcCcCcCCCCcCCCCCccCcCCCccgCccCCCCCccccCCccCccCCcCCCCcCcccccCCCCcccCCCcCCcCCcCcCccCcccCC	AC?C@@<?>@BBABBAABBBCE9GGGGEGG@GGGGGCGEG=GGGGGGGHFGFDGCFGGFGGGGGGGGGHGFFGGGFCGGECHGEHGGGHHFGHGGGGGFHHHGEGDHFEGFF=FCFF8FHHHFBFFFFHGGFFFGFFHFFHFAFHGEFDB@B	C	135	G	17	91	0	44	17	0.00000
19	4511830	A	355	AAGAAGgGAAGggAaAAGgGGAAAGGAgAAagAAaaGGAGggaGGGAgaGAAGAGAGAAGGAAGAGGAAGAAgAagaAAgGGAGggAAGgaAGAGaggGAaAGAAAGgAAGGggggaaGGAGaAaGAAAAAGAGGAAAAAAgAgAAAAaagAAGAAAgAGgAAaAAAAAAAgaAggAaAGgGGAGgggGGGaaAGGAGGAAGGAGaaGAAagGGgaaGAgggGGAAgaaAAggggggAGggaaaAgaagGgaaAAAAaGagAGAAaaagaaaggaAaaAAggaAGAAggAAaaggggGAAgaAgaaagaGAgaaAAaagAgaaaAgggaGAAgAAAAAgAGaggAgaaggggAgg	?;6B<==;?C<>BBEGFADCBH@HCCHC:BFCHFFECCHBCCFCCCCCFCHHBHCHCBHACGHCHCCHHCCHCEFCFGGCC;H?CCHIDCCCCHCFCDCHFHBHHHCCHHCCDCD=FGCCHCAHG?HHHHC=F?CHHHGHHDHDHHHDFGCHHCHHHDHCCHHG@HHHHHHDGH?DGGGBD9CGBDDD@CBGBHCCHCBGGBBGBG;BGFGDBBDGEBG=DDBBGGDGFGGD?9>D>GBDDGGGGDGGBBDHHGGGGGBGCGBGGDGDDGGGDAGGGFGGDDGGBGGDDGGGGDCDDBGGCGGCFHGDGBGAEGGGGGDGCGGGGDDCFCGGBEEEEE?C>?=>>>>B<=<8;?<	A	198	G	157	132	74	66	83	0.00024
19	4511860	G	361	AGGgGAGGGAaGGGGgaaaggAGGGgGgGGGGGGGGGGGGGGGGGggGaGGGGggGGAGGGaGAgGGgGGGGGGGagGaaGggGGaAAGGgggAGAggGAAGGAGGGAGAggGGgaGGgggAGaaaAGGGggGGgaagGAaagggGggggGaggGGGGgAgggGGGGgggaggggagGggGGgagGAGGaaGGggaagAGGggGagggGggGGggGGggaGggggGggagGGGgGGGGGaGAgggGagggggaGaaGgaaGGaGGGgggGGagaGGggggGggggGGgGGGGGGGgGgGGGGGGggGGGgGggggGggGggGGGGGGGGGgGGGGGggGGggGGgGgGGGGGGGGGGGGGG	@=@CA=@BB?EFHHGFCDDEFEGHH@HFHH=HH:GHHHHHHCGHHF@FDHHHHAFH=EHHHDHFFHHFEEIIHHHDFHD9HD:HHD@EHHFDFEFDGFHEEHHEH@HEGBGFHGGDHHGFDEGEEEEHHHDFCEBAEGHEEEGE>HGG;>GEGGFHGGGDG9EHHHHE;EBECAG=EAAGGHGEGHEHH;DHGGGED<EHFDGHEGGDGGGHHAGGGF@BHGGG9HGGECGGG9HHGGGEGDGG?GBGEBEGBGEEGG?EGGEDGGGBBGFFEFGGEBFG@DGFFGFGGGGGGGGGGGGGGGGFGGG?GGGGEGGFG:GEGGGGGGGGBGGFFGGFGGGGFFGGEFC@CDD@B@CCCCCC?	G	300	A	61	181	22	119	39	0.00063
19	4511920	T	413	CTttTTttcctttcTcccttCTTcTTTTTcTCtcctTcttccccTccCcccTTccTTTcccTTctcTTttttTttttTTtttTTTTTTTcTcTTTTTTctTTTtTccccTtcTttcTTTTTTTTTTtTTTTTttTTttTTtTtTTTTTTTTTTTTTtTTtTTTTTTTTtTTtTTTTTttTTtTTTtTTTtTTTtttttTtttTTTTTTtttTTTTTTttTTTtTTTTTTTTtttTTtTTTTttTTTTTctTTtTtTTTtttTTTTTTTTTttTTTttTttttTTTTtTTTtttttTTTtTTtTTTTTTTTTTtttTTTTTTTTttTTTTTtTTTTTtTTTtttTTtTTTTTTTTtttttttttTttTtTTTTTttTTTTTtttcTtTttTTtttttTTTttTTTttTttTttt	ADA?B>@@>=DDD8B?@@EFCEF@FFGGGBECFAAFGAFGAABADBACBBBGFB9GGGBBBGGBGAGGGC?GCGGGGGFGFGGGGFGGGBGBGGGGHABGGHGGG@BBAGGBGG>B7GGGGGGGGGEGFGGGGGGGGG?GGGHGGGFGFGEFGGGGGGGHFFFGDGGG;GGFGDFGGHHGGHGFFHGGG;GGGHHH;GGHHHGGGGGGHHHGGGGGGHHGGGHGEFGFDFF?HHGFHGEGFHHFFFFFAHFFHFHCFFHHGFFFFFFFFFGGGFFHH@HGHHFFFFHCFFHHFHHFBFIFCDFFFFFFFFFFHHEFFFFFFFFHHFCF>FHFFFFFHEFFDHHFFHFFFFFFFFHHGHHEHGGFHHFHF?FEFHHEFEEEFHH:FBGGGEDED>EECEDCCC<B:>CCBC@BE	T	371	C	42	238	4	133	38	0.00000
19	4511927	G	396	GAgaagGaggaaaaGGGaaGGaaaGGgGGggggGggggGGgggGGGGGGGaGaGGGGGGagGGGgGaaaaGgaGggaGGGGGGGGGGgGGGGGggGGggGGgGgGGGGGGGGGGGGGGgGGgGGGGGGGGgGGgGGGGggGGgGGGggGGGGGGgggggGgggGGGGGGgggGGGGGGGggGGGgGGGGGGGGgggGGgGGGGggGGGGGgGGgGgGGGgggGGGGGGGGGggGGGggggggGGGGgGGGgggggGGgGGgGGGGGGGGGgggGGGGGGGGggGGGGGgGGGGgGGGgggGGgGGGGGGGGgggggggggGggGgGGGGGggGGGGGggGgGggGGgggggGGGggGGGgGgGgggGGGgggGggGGggGGGGggGGgGGGggggg	>BA???:?>@?BCB>CDED8EEDDADEEEF>DF<DEEEEDDEFDEEEEDEEEEEEEEDAEFEEEEDEEEEEEEEEBEEEEEEEEEEEFEFEECFEEEEECDBEEEEEEEEEEEEDE@?AEDCEEDE:EEEDEE=EDEEEFE?FE=EF=EEDADEGGGEFDGAFEEEEEEFFFEE?EBEBFFEEEFEEEEE@EEFFFEEFEEEEFFEEEEDFEDGEG>EDFFEDDEDEEDDDFGEDDGEGFFFEDED>DDDGGGFFDDFDDBADDDDDDDDGFFDDDDDDDDEFD@D>DEDDDDGDDDGFGDDFDDDDDDDCEGEEEFEFFDGCDFDDDDDFFDDDDDGGDFDFFDDGF@FDDDDGGDCDGDGDEFFCCDEDFEEEDDCBBCCB@BBA>@@BBDBDC	G	374	A	22	238	1	136	21	0.00000
19	5215472	C	48	cctctcccTccctccctcTttcctttcCCtCTTTccctTTTTTCTTcc	AAACCDCCFDDDEDDDEDEEDDDEEEDGFBFEFEEEE:EEEEEFEED>	C	25	T	23	4	12	21	11	0.01349
19	5787214	T	70	TtttTtTttttTtTTTtTttttTttttttCtttCCCttCCcTTttCCCCCCCctCttTCTTcCCtttctt	@GFGECAGGEGEG7GF@DHHFGBHH@?FHFFH@D:GG8GECEF<HF@GFFEBBHFCEFFEAGEEHFCGHG	T	49	C	21	14	17	35	4	0.00007
19	5787215	G	76	GgggGGgGggggGgGGGGgGggggGggggggAgggAAAgggGGggGGgggAGAAGAAgggAggGAGGaAAgggagg	FC=CCF;HCCCCHB9HGEDHDDDDGDDD@DDDDDDCFHCDDC>DDGHDDDB@HGBGGACDEDDGGHDHFF@DDFDD	G	61	A	15	20	13	41	2	0.00025
19	5787225	G	80	CcCccccCcCCCCcCccccccccccGccGGGggaGGggGGgcgGGGGGGGgggGccGGGGgGGggggggGGGgGGGGGGG	B<ACABBBBEGHE9GBCCBBCCC@BCC=GDHC@GH;7DFHD>D;CHGFHHDCCCAB>GEBDGGDCDDBCGFEDEHGEDDA	G	49	C	30	32	8	17	22	0.00114
19	5787234	C	78	ttTtTTTtTtttttttttttCtttCCCCCcCCcctcCCCCCCcccCttCCCCcCCccccccCCCcCCCCCCCCCCcCC	CEDG8@FFEGGGGGGGF>HH5CGHGGGC>BGE@BHBDGGEGF9BBDHHF?8CBFDCBA?BBFFCCFFFFFFFFFGBA@	C	52	T	26	36	5	16	21	0.00004
19	5787245	G	78	ACaCaaccaaaaaacGaccGGGGGgGgaGGGGGGGgggaaGGGgGGggggggGGGgGGGGGGGGggGGgGGGGGGGGg	<DEFFFBBFFFGF<C>FC;HGHG;C>CGGAHGDHH@ACF>HDHD9HCCCDCCGFGDGGFGGGGGDDDGCFGGFGFECA	G	57	A	14	40	1	17	13	0.00002
19	5867177	G	52	aaagAgaaaagGgaAaGaaGGAGGAAAaGGGgAGAGAAAaGGaagaGGaAAG	??DCHCFFFFCCCGHFCG=BBHCCHHGGBBBDGBG>FGGDBBGH?GBAEECA	A	30	G	22	13	16	17	6	0.04932
19	6833777	A	67	gaaAagAaAggAaaAaagaggGgAggAAggAaaAaggaGAAaAaagggaagaaAaaaGAgAagaAaa	CDFEEEGDHFDHEEFBEFEFECFHEFHHEFHEEHEEEECHHDHFFGFGFFGFBGF@EBGCFDD:?CC	A	44	G	23	17	3	27	20	0.04759
19	6960200	G	41	GGGAGGAGAAGAAAAAGAAAAGAGgAAGGggAAGgAGgAGG	@CCH5CHCHGC=EGHGAGGGGBGBEGGBBGGGEBGFAE@=?	G	21	A	20	16	20	5	0	0.04784
19	7593169	A	84	AGaAgGgaAgaAggggAaAGAAggaagaggggaaAGgaagAaaagaAgAaaaggaggagAaagggggagagaggggaaaagaga	>>B;B=BC<DECFFFFHEFBHCEFEEFEEEFEEDH@FDDEHEEEGEHFHDEEGFDGGBDHE=GGGEDDG:GEFFGGFECFED@=	A	44	G	40	13	4	31	36	0.03154
19	9296664	T	39	TTcCTccccccccTCCTTTCTTcTcCTTTtTCCtTtCcT	EEBGEBB@BBB?CEGEBEEGCE<D=FDDDHDDFHCEB=A	C	20	T	19	8	16	12	3	0.00791
19	11105608	T	155	TTccCctccCCTcTTctccTTTttTtCCTccCCctTCCTtcTcCtccCCcTCttcctccTtccCtTCCCtccTtccCtTtccctTCTCctctTccTCcTtTccTtctTcTCTCTcTTTTttCTCcTCCtcCTTCtcTTTttTtTtCTTccTTtCt	BC?C;:C=?FBCCEFBFAAGGGGGGGG@G@BGFBGGGGGGBGBGHCCFGBGFHFBBFCCGHCCDHFGGGHCCGGCCGGGHCCBGGFGFCH>HFCCFFCEEFCCEGCHFCFFFFF;FFFFHGFFFBFFFHAEEEFHAEEEHGDDBC@AB>;?A=?E	T	79	C	76	46	31	33	45	0.03697
19	11170585	C	34	cttCcttCtCtctttCttCCcTttCtCCTTCCtc	?FGGGGGDGGGBHHHGHHGGCEHHGHFFEFFC;6	T	18	C	16	3	11	15	5	0.00447
19	14091543	T	107	tTTtTtTtTTttTtTtTtTTTttTtTtTtTTttttTtTtTTTTttttTTTTTTtTTtTTttTttcCCCCCCCCCCCccccccccccccccccaccccCcccCccccc	EADG>GEGEEBGEGDGEGECBGG<EDGBEEEGGGADHEFEDEBHGFHEEEEEEGEAGEAHAEHH?FGFGDGAFFFECCCCCCCCACCC<CCCAC;CBFCC@E;=9>;	T	64	C	42	34	13	30	29	0.02906
19	14091555	G	107	GgGGgGgGGGggGgGgGgGGggGggGgGgGGGggggGGGGGGgGGgGGggGgggGCGGGGGGCGCcccggcgcgccgcgggcgccgggCgcccggcGcGcggccgcc	=A;?BECGGHCCHCHCGCHHCCECDHCIBHHHCCCCHDHHHGDAD=HHDDHDDGFFFHHGE8FFEHHGG=HGHGHHEHGGCHEH>GGDFGHH7GEHGHFHFEDB;A;	G	82	C	25	39	4	43	21	0.00512
19	14091556	A	103	GgGGgGgGGGggGgGgGgGGggGggGgGgGGGGggggGGGGGGgGgGGggGggaAAAAAAAAAAaaaaaaaaaaaaaaaaaaAaaAaaaaaaaAaAaaaaaaa	?C9=A@BBDC@CEBECDCEECCDCCECDCEFFCCC@CEADDEBDBDEEDDDDDEEFBFFBCGEEFGDG@GGDGGGGGG=GBG>GGFEGGFGBFDGDGGFFC?A	G	53	A	50	29	14	24	36	0.00908
19	15133762	G	374	GcCGGCcgcCcGGgCCGccGGGgCCCCgcCGCCCCGGCGGcCCGCGCGCGgGGCCGCCgGGcCgccCCGGCGCCCcCgCGGCCGGGcgcGCccGCCGGgCGCGcCCgggCCGCCCCCCCcccCGcggcGGgGcgggcGGcGgGGcCCCGCcCGCCGcCGcgccgccgcCGCGGCCCCCgccGCGgCGCCCggccCGCccgGGCCCGgGCGCgcCgcGcGGGcggccCGCcgCGGggGcCGGGgcggGcccGgccCGGcCCcGGCcccCGGgcgCcCGGcgcGGGCcgcCcccgcGCcCGGCGcccccGGGgccgCGCCCGGgcccggGCCccCCcggcgccccCGgGggcgcgGcCccGGgccgcGGGGggccc	BC9<<?>9A<>CCDBEGDCFGGDGFDGECGEGGGGEGFBCD=EGGGGGEGFGGAGF=BAHAC<FDDGDGDGGEFFDGEGGGGGCGGDFDGGEDGFGGGFGGGGEGGFGFFGF>7AGGGECEEGGEGFEGG;FDFFFEFFEGFGGEGGFGGEGFGGGEGGEGEEFEEFEGGGFGGGGGFEDEGGFGGGG=DGFDEGGFEAFGFFFEGGFFFFFDG8CGEFFFEEE;EFGFEFAGFFEFEFEEFFEFDFEEEFGEEFFFEFFD:F<E@DFEFGFFFE@FFEFEF=FFEAEFBEEFEFF?FFFFFECEDDFFFFEEFDFF@FFFG;E;GFFD8EBFAEGFEFEEEEEFFFEEEECFGCC?BDC@@@A>?CBB>>=B@	C	205	G	169	106	107	99	62	0.02763
19	15229993	A	84	AAGAGAAAAAAgGAAGAGaAAGGgAGGGGAAAGaAAaaAGAaGAAAAAAGAAGGaaGGAGaAaAGGaAAAaGAAGaaaAaAAGG	HG@GBHHHHHGFCDHCGCGHHCAGH@CCCHHHCFGH=CGCFGCGGFGGGBGGBBGFBBGBCGGG@>GGGGGBGGBDDEEGFGBC	A	56	G	28	41	26	15	2	0.04415
19	15905529	C	79	acccccCccAcaaccccCCcccccAcAccAcacCcccccAAAcAaACacCcCcCAaaAAaCCCAcCAcCcAcaACACCc	C>@>BA@EE7DEDDCCDFFDCDDDFCFCDFDEDGDDEDAFBEEFFDFFEFEFEEDFFEEDFFEEEFEEFEEDFDCAAB>	C	52	A	27	16	17	36	10	0.00825
19	15918177	G	119	GGTGggggggggGGgggggGggggggggGGGGgTTGTGgggggGggggTGGGGGgggggGGgGggGGGgTTggGGGGTGGGTGgggGGGGGgGgGGGGGGggGGgGGGGGGGGgGGGGG	B@>=>BBABBDD8EDFDEEEBEFEFEEFCEEDEFFEFEFFDFDEGFEEFEEEEEGEGG:?EFAGFEEEGFBGFECDEEDDDEAGAFDDD=DFDECADDDDEGDDFDDCDCDDDD@>BBA	G	110	T	9	59	9	51	0	0.00989
19	17362526	A	63	aagggaggaaggggggaagAaaaaaaggaggagggggAggAagAgaAggaggaaagggggaag	CC?@@DCCFFBBCCCCFFCFFFFF@BCCFCCF@CCBCFDCFGDECEF;DGADGGGEDCDCFC?	G	35	A	28	0	5	35	23	0.01398
19	18377496	C	338	CGCccgGGGCGcCGcCCGGCcGCGGGCGGCggGCCCCCcCCGCGGGcccGGcCcGccGCccGcgCCCcGGgCGCgcGCGCCCcCgcCGCcgGGCCCCCcGCGGCcCCGGGcCGGGCccggccCGcgcGGccgcGccGGcgcgccCCGggCccgCGcggCcGCCgcGCGGccgccCGCcggcCggCGGcGGGgGCcgGcGcgCCCCGCGGcgcCgCCCggcggcGggCGccgcGGgCCccccGCCgccggGccgGCGCGGGCGcGcCGGCGcgggGCccGCgcgCGCggcCCgcGGGcccCccGCcgcggcgccGcGGgCGGccGGCcCCcGGGcgGGg	DCBBCAA@@:ACCCDEFFFFEGGGGFE=GGEFGGGGDGFGGGGGGGFFFGGF7FGECGGFFEFFGGFFGAFDGGFFGGGGGGFGFBGFGFGGGGGGGGEGGFGFFGGGGGGGGGGGGFFFGFGGE<EGGEGGFGFGGGGGGGGGDDGGGFGGGFFGEGGGGGGGGGGGGGGFGFGGGGFGDGGFGGGGGGGDGDGGGGGGGFDFEEEGFGGGGGAGEGGGEGGFCGFFGGGGFFFFFGGGGGFFGGGGGFDGFEFFFFFFFFGFGFFFFFGEGGFFGGFFGGGF@FGEGFAGG:FFGGGFGGEBGGFGGEGEFEEGGFBDACDCCCB<BA?CBB?ACD	C	181	G	157	88	100	93	57	0.00611
19	22363826	G	30	gGGccgcccGGGcgGGcggGGgGGGGGgGG	EDGDDFDDDHHHDEEHEGFGGEGGGGG:FG	G	23	C	7	16	0	7	7	0.00169
19	33355055	A	110	AGGaAgAAaAAgGAggAGGaAGGGAAGAGAaGAaaaAGAGaaAAGGGaAaaGGAAAGGGAAGagGaGAGgGAaGaaGaGGaaGgAggAgAGGGGaaGGaagaGGaaaaag	@>CEHEGGEGHECHFDHCCEHCCCH5CHCEFCHFFFHCFCEFHHCCCFHEFC=;HHBCBGGBEGBF@GBGBGFBFFBDABFE@FGGFFEFAA@AFE??AA::===BBCBE	A	59	G	51	29	39	30	12	0.00556
19	36018407	T	104	cctcttTccttttcTTctttctTccTtTttTtttttttTTttcTTccTttTTtTTctcTTTTTttTTTTTTTtTtTtTtTTtTTTTTtTTTTTTtttTTTTtTT	AAECDEGCDEEEEDFDDEDEDEFDDDECEEG9EEEEEFG?EEDGGDDEFEGGEDFEFEGGGGCDFGEGEEAF@FFFEFDEEEDFFFFEFFCFFEFDDCBBB>AC	T	89	C	15	50	0	39	15	0.00002
19	36018413	T	119	tattTaattttaTTatttatTTaaTtTttTtttttttTTttaTTaaTtTtTTtTTataTTTTTttTTTTTtTtTtTtTtTtTTttTTTTTtTTTtTTTtttttTTTTtTTTttTtTttt	CA@BBDEGGFG=GGFGGGFGAGFFGGGAGGEGGGGGGFDDFFDGFGGG<HFGGGFGHEAGFGGHGGFGGGHGHG;FHFDGHFFGGFEFFFDEFF<FFFEGHACFEEFCEFFDFEEDCBC	T	106	A	13	55	0	51	13	0.00019
19	38282727	T	59	TCTtCttttcTttTtCtttCtTtctcCcTcCTCtCTttTCtCTTTttttCCTCtccTtC	D>EEGEDEEDGEE7EGEDEGFGEDEEGEGDGFGFGG<FGFEGEFFFFFFFFFE9BAC>@	T	38	C	21	14	14	24	7	0.03365
19	39372244	C	57	cGgcgcGGgcGcgcccGGggcccgGccgggcgccGcggcgccgggggcgggggccgc	@:CEFFGFFEGFFEFFGHCFFFFFDFGFGGFGGG:GGGFGFGGGGGGGGGGFGFG9@	G	33	C	24	8	0	25	24	0.01576
19	40376562	A	65	aAaaGaAAGaaaaaAGAaaAaaaAAAaGaaaaaAAaaAAaAAAAaAAAAaGAAaGAGAGAaAAGA	FFEFBFEFGEFEFFFGFFFFF7FFEFDGGEGGGFFGDEEGEEEBGBEEEGCEEFFDDCADBBBB?	A	56	G	9	29	9	27	0	0.00789
19	41351321	C	91	CcccTcCtCcctcctccccCtCcCccCccccCcCCccccCCCtcccCCCCttCCcCCtCCcCcctcCCcCcCCCccccCCcccCCtcCcCc	DCC??A>BBCCBCC<CDDD7EEDEDDADDDDFDEGDCDDGEFEDDADFFEFBFEEFFFFF@FEDEAFECFAEFDEEDDEDEEEFCA9A8?A	C	80	T	11	36	1	44	10	0.02491
19	41381647	A	220	AaAAAAAAAAAaAAAAcAAAcaAAAAAAAAAaAAAcAAAAAAaccaAAAAaaAAAAAAAAAcAAaacAAAAAAAaAccAAAAacaaAAaAaAAAaaaAAaAAAAAAAcaaAAAAaaAAAAaAAacAAccaaaaAaaaAaaaaAAaAAaAaAAaaAAaaaaAAcAaacaaaaaaaaAAaAaaaAAAAAaaaAAAaaAaaAaaAaAaAaAaAaaaaaacaca	BC>;>BAEEFFEFFEDDFFFDEFFBFEFFFFEFFGDFFFFFFEDDEFFFFEEFFFFFFFEEDEFD;CFEFEFFFEFDDFFFEFDFFEFFFFFFFFFEFFFFFFFFEF?FFFFFFFFEFEFFFFFEDFE@EF;EEDFEEFDFEFEFFEEEEEEEFEEFF=FEEEDFFFCFFF@FFFEEFDAFDEEEEEFDDEEEEFEEEEFEDDEFECEDCAA@?:>BBB;	A	202	C	18	121	0	81	18	0.00000
19	41531522	G	72	GTtGGGGgttTtGTTGTtttGTgTTTGtgtttTGgGgtGGgtgGTTGGGTGTtGGTGtGGGttGtGGGTGTt	@=B@CEEFEECEEFFEFEEEEFFF7FBFGFDFFEGDGEEEFEGCFEDDDFD=FDDE>FDDDFEDDDEABB?C	G	36	T	36	29	17	7	19	0.00640
19	41932084	G	192	GTGTtTGTTTtgttTTgttgGTtggTGgTTTggGgGTgGGtgggGggGTtggTtGTTtgggTggTgGgggtGGGGGTggTgGTTgggtGgTTggtgTTGTTTgttTgGGgTTTGgTgggGTtTtgggtgTTgtTGTtTggTGGtGTtGggGTttGtggTGGGtGGTgGgGGgtGTGtTtGgttGgtggTTGG	CAC:@AFEFEFBCFGGB@GCGGGCCEGCGGGCCFCGGCGFGCCCG?CGFGCCHGGGGGC=CFCCGCGCCCGGGFGGFCDGDAG;CDDHGDDFADHDGCGGFFDHGGDGFDGGGADFDDD>FHFHCDAHDDFDHFFFHDBC<CFIFFHFDEFEHGFHCDFFFFHFFFDFDEFDHEFFHEHEDHHF@DD<AAA@	G	107	T	85	46	52	61	33	0.01386
19	43883273	G	63	CCGGGGGGGcccgGGGGGGGCggCGccGGCggGCGccccgCGggccCCgGcggcccccGgccc	B?DEAEEEEB@>CEEEEEEEFCCFEBBEDECCCGECCCCDGD@DCCGFDDBDDCADCCDDCCC	G	34	C	29	22	9	12	20	0.01143
19	46094597	G	225	aAAAGGGAGgGGAgAGAAAAaAGGAgggaAGGgGAAAAaGgAGgAAAggAgAAGgAGgAGggaAaGAAgAAaGGgAGGaAGGgaGagAAAGgggagGaGGggaGAAAGAGAgagAAAgAAaggGGAgGAgaGgaAAggAaaggagGGaaAGAGGaaaaAgAAGGggAaGGagggAaGggaAAGaaGaagaggaggaAAgGGggaAGAgGgaaAagGAgggAGGga	C?@@>BBAACCCBDEEDEFFEEGGFFFFEEGGFGFFEEEGFBGEF?AF?@DGGGFFFFFGFFEFAGEEBBFCFFFEGGFFGGGFFFFFFFFGEG@FGFGFGFFGFFEGFGFFFGFFEFFFCGGGF>FGFFFFGEFFAEEFFFFAGFFFAFFFG5@FFEEGEEBFGGEFFFFGGFBFFHGEEEFEEFFFFFGGFFEEDE?FFGGCEF@FFGDCDFFEEFBBBCBCC	G	116	A	109	55	67	61	42	0.04446
19	49868959	G	116	tgGgGTgGGgggGTgggTGTGGtGtTggTTTggTtTgGTgGTtGGGGGTgGgTGgTtTGtTTGTGTgTTTTTGgTGgTgttTGTTtggGtttTGTTtggGTTTTgtgGGGgggTGt	AB>B@GFC@FEECGFEFECGCCE@DGEF>GFCEGEGECGECGDCCCCCGFCGFB=GFGAFF@CGAGGDFC<FBFFBGF>FFCBCFFGFBFF@FBFF?GFBFFCF<FGAABEEC9AB	G	62	T	54	31	38	31	16	0.03670
19	54726784	A	25	AAAaaaaaaAaaaAaaaaGGGGGGG	HHHFFFEFGH??GHGGGGBBBBBAC	A	18	G	7	5	7	13	0	0.00165
19	54726816	A	36	tttTtttTttttAAAAAAAAAAAAAAaAAaAAaaAA	CDDGC<DGEDEBHFEFGGFGEGGGGGFGGCGGEECC	A	24	T	12	20	2	4	10	0.00019
19	54726833	T	38	cccCccccTTTTTTTTTtTTTTTTTttTTttTTttttt	C>>EBBBBFFFFEFFFF@FFFFFEEAHE@@DEEHC?A@	T	30	C	8	20	1	10	7	0.01301
19	54745507	T	47	TTTTcttctctTTTcccTTTcTTtTcCTTTttcttttTtTTTTtttt	>?EDGGGFGGBEE>GGGEEEGEEFDHGEDEHHHGHHHDFDCD;EEB;	T	37	C	10	21	1	16	9	0.01184
19	54745508	G	47	GGGGaggagagGGGaaaGGGaGGgGaAGGGggaggggGgGGGGgggg	=AHHFFCFFFDHG5FFEHGHGHHFHGGHHHGEFGGGGGHGFFFGCBA	G	37	A	10	21	1	16	9	0.01184
19	54746081	T	162	CTTCCTttTttttTtttTCttCcTCTtCcTTtTCccCTtctCTttCCtCcCCcTtcCtCttcCCCttCTtctTtctttTCccctCctttcCTTCCCTtCctccCccctCttttCtCCctTCtttCtCCTCcCCCccCtccttccctCCCcTttctCccctcC	DBBDD>CB>BCFEDHGGE<EGEBEGEGGB<;FEG@BGEGBGFFGGABGGBGGBEGBGFGGGBGGGGHGBFCFEFCHHHDGCC>HGCHHHCGE9GGDCHGCBCBGCBCGFHHHHFHFFCHD=HHC@HFFDFCFFFCCFHCC7HC=CEFFFCCGHCHFCA@C>C	C	84	T	78	47	23	37	55	0.00084
19	54746611	T	48	CccTtctTTctcTTttcccTTTcTTttTTTtTTTtTtttttTttTttt	D?@>?ABBCD;@EE=EDDDEECBFEEEEEEEDDEFEFF;FFDFDBFDA	T	38	C	10	19	1	19	9	0.03115
19	55271967	C	72	cCccTCcttCtCCtcttCcCtcCCcCtttCCCCctCcCCcCcCCcCCCCtCCCTCcCACCCCccTCCCCCCc	>A?BDDAFGDGDDGBGGDCDGCDDBDCEHDDDDCGDCDD=DBDBBCCCCHCCCFCCCGCCCCCCFCCBCA>@	C	56	T	15	39	3	17	12	0.00083
19	55329892	A	194	AGAGGAgAgGGAGGgagGAGgGgGGGGGGgAAAGGGGAGggggGgGGgGGGGGGgGGGggGGGGgggGgAAAGaGgggGGGGGGAggGAgAGGGGggGggGagAgGGGGGGGGggAAGGGagggAgAGAGaGggggggAGggAAGGgAAAGAAggGAAGGGAGgGGAGGggAAgAGAGggAGgggggAggGgGg	@?A89CCHCCBHBCBFBCH7C@CBCBCCCCHHHCCCCHCCCCCCCCCCCCCCBBCCCADCCCACDDDCDGHHCECDDDCCB<C;GDDCHCH8CC?DDC?DBGCHDCB=BBBB>DDGGBBBGD?CGDG<GBGBEDDCAEGADDGGBBDGGGBGGDDBGGABB;>DBAFABDAFG>FAFBCDGC@AA?<><=><AA	G	149	A	45	85	40	64	5	0.00007
19	55329901	A	185	AGAAaAAAAAAaGGGAAAAGAaaaaAaAAaAAAAAAaAAAaaAAAAaaaAaGGGAgAaaaAAAAAAGaaAGaGAAAaaAaaAgaAaAAAAAAAAaaGGAAAgaaaGaGaAGAgAaaaaaaGAaaGGAAaGGGAGGaaAGGAAAAaAAGAAaaGGaAAGAaaGAaaaaaGaaAaAaaAAaAaaaGg	E=<BCCCCEDDF;CCHHHHCHFFEEHFHDEHHHHH@FHHIFFHHHHEFEHG>CBHFHGGGHHAHGHCGEEBGCGHHGGHGFHFEHFHHHHHHHHGGCBHHHGGDEBDBFHBGGG=GGGGGBF<DBBGGGBBAGBBCGGAB>GGBGGGBGGECBBCGGBGGGBGGGEFGBGGGGEGFGGCF?;@CA	A	147	G	38	82	33	65	5	0.00032
19	56274086	G	125	agagaggaagaGaagggaagaGaGagaaaGGagaagggagaagggaaaagggagggGaagagGagggaaGgaagaGGGaGGGaagggagGaggaGGGGGaGgagGAaaGgGGgGaaGGgGGGgGG	CBBBCEEEDDDGDEAEFDDFCHEHEFEEEDHEEEDEEFEFEEFEFEEEEEEEBFDE>EEGAEHEEFD>EHEEFFEGHAFHHHFFFFF:GHEGFFGGFGGCGGFFG>DFGGGGGGCEGGFFGG:C?	G	76	A	49	33	1	43	48	0.00000
19	56274116	A	92	agGaaaaaaGgaaaaGGGaGGGaagagaaGagaaAGGGGaGgagGAaaGaGGaAaaGGgGGGGAGGaGGggGGGGggGGgGGGGGgGGggGG	?B;BCFDDDCDEEBEBCCECCCEEEEEBBCEFEEHC7CC=CFEFCAFFCECCFHCDBCFCCCBGB@FBBGGBBBB@FAAGABABA??@B;A@	G	59	A	33	43	4	16	29	0.00000
19	56274193	G	177	GggGGGggGGgGGGGGgGGggGGGGgGGGgGGgGGGggGGGGGCGgGGCGGggGGGGGGGggGGGgGgGgGGGGggGCgGGGGggGGGGGGgGgggGGGgGGGGCggGGgggGGgggCGGCGGggggGgggGgGgGgggGgGGGGGgggGgGCgCgggGGggGggCCGgggCCGggg	CDDFGGDEHHFHHHHHFHHFFHHHDFHIIFHGFHHHFFDGHHHGHDAHFHHGFHHHHHHHGFHGBGHGHGHHHHGG?GFHHHHEGHHHHHHGHGDBGHH>FH;GFGGG@GGAGAGGGFGGFGGEGGGFGFGGGGGGGGAGFGGGGGGGGGFGFGEGGG@FGGFFC>CC<>B<C?DD@	G	165	C	12	95	12	70	0	0.00369
19	56413532	G	133	AggaGGagaaGagaaagaGgagaaGaagGAaggggaggAagaaagaggGgaaagagaagggggagaaGGaggaggaagagGggaaGggggggagaaaggggaaaaagGaaaggaagGgagagaggggggggaG	ACCC@?BBBDCDFGE;EEGEEFFFEFAFGFFFFFFFFFFFFFFEFFFF?CFFFFEFFFDFFFFFFEEGGBFFFFFFFFEGFFDEGGEGFFGGGGGEGGGGGGGGGEGGGFFGADGGGGGGGGFEGGGEGG8BC	G	75	A	58	14	3	61	55	0.03375
19	58016474	T	187	TttTtTCCTCTCtTCTCCCCTtCTCtCtTtCCTCTttTttTTtTttTttCCTtTTCTtTTttCtCCTCCCCTCTTCCCCCTTTCTCtTCTtTTCTTTCTTTCTCtCTTTTTCCCTCCCCTTTCtcCCTcttttTTttTccttcCTTttctTTCcttcCtccTtctcTCtcttccTccttCtccttct	?BBCCDFEE@FFDFFFGEGFFEGFFDAEFEEFFGGDEFEEFEEFFEFEBGGFEFFFEEFFFFF?GGFFGDFFGFFEGEGFEDFGED<FFFCEFGFFFGFFFGFF:FEEBFDDDEEEFEDE@EEFFFEBEFFFFEEFFEEDFFEFEEFFEFEEEDFFDFFEEDFCFEDD=DD@DEE?BBBBA?<@@BA	T	113	C	74	62	54	51	20	0.01403
19	58420682	T	211	TTtTTTTttttTTTTttTttTTtTtttTtTttttttttttttTtttTTtTTtTTTTtttTtttTTTtttTTTttTTtttTTtTTttTTtTtTtTTTTTtCtTTtTTTTTTTttttTTtTTCTTTtTtTCTTCTtTTtCttTTtttTTtCTTCCCTCCtCCTTtttCTtTCTtCCtTCCTCttCTCtCTttCCccttCttTTtTCCTCCtcT	BADFEFEEECEGHGGEEBDEGGEGEEEGEGEDEEEEEEEEEEHEEEG6EHHEGGAGEEECEEEGGDEDEGGGBFDGDFEFGFE?F7GFFGEGFGFGFGFDFGGFGGGG<GGFAFFGDFFGCGGE?FEFCGGCFFGFFCBFFFFGAFFFCFFCCCFCCFCCFFFFFCCFFCFACCFFCCFCFF>FBFCFDECDEFDDCBBDD?D@=DAA<AC	T	178	C	33	91	30	87	3	0.00001
19	58420699	C	245	CcccacaaaccaaaCacaAaAAcAACAaccAaccCAAcaACCaaAAaaaAAcCAaaAAaAaAcCAAAAaCcCAcCCACAAAaccACcCACCCCaAaCCACCCaCCaCaaAAacaCAcCCCCCCCCaCCCAaacCCcACAaCCcCCCACaaCACaCCacCCccacCcaACaCCCCCCccCccaccCccCacCCCCCcaaccaAACACCCCAacCCCCcCAcCCCaCACCcccaCCCCCccAACaca	ECA?CCCDB>?EECBFAFFEFFBFFCFFBBFFBBGFFBFFGGEFEFFFFFGBG@C8FFFFGFBGFFFFFGBGFCGGFGEEBGCCFGCFFFGGFDFGGGFGGGGGBGDGGFFFCGFECFDFFGGFFGFFFEGGCFFCDFEGFFCFFFEFGHFBFEFFGC=FCCGCDCGEFGFFFF;FBBFCCGCCFCCFGCFDFFF?FGCCHDDFEFFFFEG@FFFFCDECEFFGGF;GBABEBCBCB>>??AB7D	C	143	A	102	92	49	51	53	0.01284
20	1895705	C	64	CCCCCCCCCCCcCCCCCCcCCCcCcCTCCtCCttCCctcCtcTtCcCcCCtCcCccCcCCcCCc	GGGGGGGGGGGBGGGGGGCGGFCF?GEFFHFFIIFFAHCFHAFHFCFCFFHFCFBCF>A?>@?>	C	55	T	9	40	2	15	7	0.00584
20	17639857	G	26	gTgGgGggggggTTtTTTtTTtTtTT	@GC;CCCCCCCDGGGGGFGFEEFGGD	T	15	G	11	11	2	4	9	0.01542
20	29628271	C	126	ATTtcCttCcccCccCTCCCtTCccCttTttccCcCCcCTtCttCCCCttCccttcttttCtttCCCCcCtcCccCCtttCttcccccccCcCcCCCtCcctCCccCcCCCCCcccCccccCCCcC	BBBCC@A?@EEFEHGFEFFFDFFGGGDDDDDGGFGFEGFFDGDDGFEFDDAHFEDFEEEEFEBEAFFFHGEHDHGEFCBEGEEEHHHHGGFHFHFFFEF<HEFEHHFHFFFAEHDHEHHHEGCA@A	C	89	T	36	48	6	41	30	0.00013
20	29633952	C	25	ttCtttCctCttctCcCCcCCCccc	:BFDEEGDEEEEDEGDC?<GFGEA>	C	16	T	9	9	0	7	9	0.00779
20	32245789	T	46	cccccCcTcTCcTTTctTccTCctTCTTtcTttctCTtccctTctt	AC?BAF=FAFEAFAFCG;C;FFCHFFFFHCFHH6HFCID@CHECA@	C	23	T	23	5	13	18	10	0.03311
20	43252915	T	56	CCtcCTtCCcCtCCCTttttccttCtTtttctcttttctCCccctccTccttctcc	=>@ECEEADGCDDDDGDDCDGGDDDDGDDEGDHDDDEHE>DHGHEEHFHHDEHDB:	C	29	T	27	12	4	17	23	0.03922
20	43681951	C	33	TCctCttccCCCCtttCCttttcctctccctct	>B?HDFFBBFGDFGGGFGGAHGCBGBHC@CDCG	C	18	T	15	8	1	10	14	0.02141
20	43837303	C	141	CTTctctTtcCccccctCTCccttCttcTctttCcccCTCCtcctcCCtCCTCCtctCctctctctCccCCtcttttTCtccctcttTtctttctCccttcctcttctttctcccctctcttctcctCttttcctcccctc	=CD?CC??@=:@@A@AEBFFB@GGGFGAGBGGGGBBBGGGGGBBGBGFGGGGGGGBFFAGCGBGBGGBCDGG?GGGGGGCCCCHCH9FHCHHHCBGBBHHCCHBHHCHHFBHBCCCHCDCHHCECCHFHHHH?BHCCB@C7	C	77	T	64	22	9	55	55	0.04304
20	47258763	C	242	ctTccTTCTccTCCCtccTTtccCTTcCTTTTtcTTCTCTTccCCccCCTTTtTTTccTtCctccctccctcccTTTtTTtcccCccCttCTccCTtccttcTTTctCTtttTCtcTcttCCCCCttcTcCCtcTcTCCTctTctTTtttCcttTTctCtTcCTcccttcttCccccCcctttTccTtcTtcttcTtcctttctccTttcCtttTcttcCcTcctCtccctTCtttCtttct	A?@??BBB=BEFFEFEEFGGEEFFFGFGFEGGEFGGGFGEGFFGGFFGGGGFEGAFFFGEGFEFEDBFFFEFFFGGGEGGDFFEGFFGEEBFFFGG@EFFEEGGGGFFEEEDGGFGG>EDGGFFGFFGGGGGFGFBGGGGGFGGF8GFFFGGFFGGGFEFFGGFGGGFFGFEF<GFGFGG?CEFGFEFGFFGFFGFEFGFEDGFGGFFFGFEFEFGFEGFFFGGFFFGDDFFFEDECA@?@?	T	125	C	117	57	38	68	79	0.04796
20	47273726	C	118	cTccTTCtcCCcttTcTCTTCtcctctCcTCcCCCTCCTtTTTCccTCTCCTCttTtTttccTTTctcCTCTCccTTCttctcTCttTTctcccTCcTcTCcccTctTTTCcTTTtTC	>;9BFGBEDGGDEEGCEGGGGED8CDEGDGGDDGGGGGGEGGDGEEFGFGGGFFFGDFEBEEG@FEFEGEGFFEEECDFFEFEFFFFFFEFEEEFFCFEFFEAEFEFFDFF>ECDBC?	T	60	C	58	39	26	21	32	0.04131
20	47942184	G	346	GGGGGGGGGGGGGGGGGGGGGGGGGGGGGGGGGGGGGgGgGGGGGGGGGGGGGGGGGGGGGgGGgGGGGGgGGGGGGGGGGGGGGGGGGGGGGGgGGGGGGGGGgggGGGGGGGGGgGGgGgggGGgGGGggGgGGGGgGGgGGggGGGGgGGGGggGagaggaaaAAAAAGAAAAAAAAAAAAAAAAAAAAAAAAAAAAAAAAAAAAAAAAAAAAAAAAAAaaaaaaaaaaaaaaaaaaaaaaaaaaaaaaaaaaaaaaaaaaaaaaaaaaaaaaaaaaaaaaGAAGAGAAGgGGgaAGGGGAGAAgGGAGGGGaggAGAGggAAAGagagGGGGaggaGGGagg	B??ADEDEEEAECEEEEEEFEFEEEEEEEEEEEEEEEFEFEEEEEEDEEDEEDEEEDDEE9GEEGEEEEEFEEEEEEEEDCEDAEEEEEEDDDDGDDDDDDDDDGGDDDDDDDDDDGCCGCEFGBDGDDDGGDDDDDDGDCGDDGG?DDDFDDDDGGDB=EGGEEC<B=FECEEEFAEEF?FEEDEBEEB9EEECCDF@EEDF:FEEECEEDFEFEEF<FCEEE@EDEC9DDEEDEDDEE?EEEEEEE>C;E?ED;DDED<DDEEDDBDDEBDDEDECCCCAC:DD7DDCDECGCCEDDDDCC:CDDEDDEDDDCBC@?BCBAA=BAA@@89@@AB@?A=ACCBDD	G	202	A	144	161	70	41	74	0.00000
20	54941140	C	101	cCCcCcCccccCcCCTTTCcCcTTTtcTCtCtcTcccCCCTTcCTcCTCcCTCcTCcttcTTCtCTtctcCcccTcTTtcccCcCTCcTTccctCTtTtcc	A9BCDDDCDDDEDFFE;A<DGDEFFEDFFDFEEFDEDAGEFEEGEEFFFDFFEEEFEEFEDEGFFEFEFEDEEEEEEDFEE@DEEDFEEEEE:EEDDED=B	C	64	T	37	27	25	37	12	0.02245
20	55108538	C	372	CtCCCTCttCCCCCcCCTtTcCCcctCTCcCCCCCCctccTTcTCCCcCtTcccCTCcCcCccCCTCccctctcccctTccccccCTccccTCCCctCTTCCCccctCCCCtCCCCCcctcCCcctcCCCcCCttctcctcCctcCTCCTCCCCtcCCCcctcCCCcctcCctccCtCttCCttCcctctcCCtcccCCCcccccttccCtctTCCCTcccCCCtcctCCCccCCCcCtctCCCcccccttCCCcctccccctcCctttcCttctcccCcCctcccCCccCtcccCCCccCCcCCCcCCccCCCCCcCcCccCCccccccccccccCCcccccCccCcccccccccccCcccCccccccccc	DA@B@B>ACB??@;ABAACDDAEDDEGFGCGGEGGGCEDDGADGGGGDGEGDDDGGG:GDGDDGGGGD@DEDEDDDDEGDDDDDDDGDDDDGDFECEHHHHHECCDDGGGGEGGGGGDDEDGGDDEDGGGDEGEEDED>DDGEED<GGGGGFFFDDGEGEEFCGGGECECGEEDDEFGEEGEEFGEEFEDDGFFEEED;GEEEEEBFEEFFEFGGFGFEEDGGGDEEEGGGEEGGGEGFEFGGGEDEEEFEGGGDDFCE9EEFEGBFEFDGDFEFEEEGEFEFCEEGG@DFFADDFGF9EFFEFFFEGFEEFFFFFEFFAEEFFEDEEEEEEEEE;FFEEEEDFEEEEEEDD=DDCACCAAAC@?9>==B@B	C	301	T	71	134	19	167	52	0.00713
20	61987822	C	133	CCCtctCTtTCctTCctTCtctcTCCCCCCTtctCCtttCCtcCCctCCcttTTcctctcCctTctcctcctctttttccccttctctttcCttttctctctctttccctccctcttctcctccccctcctcc	AA@CBA?ABEBEEFCCDFCDDED<DDDD?CGEDECEEEEBDDDDCDEDEDEEGGCCEDED7DE=DEDEEEDECFFFFEDD9EFFEFEFFF?BFFEFEFAEEEEFEEEEEFEEEFEFF?FEDF;EDEAFEEE@B	C	73	T	60	23	9	50	51	0.04054
20	62959184	T	41	CTTttTTCTTCTCCTtTCttTCTCCCCTTTTtTtttTTCtC	:FFGGFFEFFFFFFFGFCHHEGBFFGFEDEECFCHHEEE?A	T	28	C	13	18	13	10	0	0.01717
21	9825838	T	151	TCTCTCCTTCATTTCTCCTCCCCCTCTCCTTTTCTTCTcTTcTTTTTcTTcCCtTTccTcCCcttcTTTCCTTcCcTCTTCTCTTTcTTCTTtTTTcCCTTtTtTTCCccTcTccCTTTCCTTTtgTcTCTTTTcTcTCcTTCTCTGCGCC	B?@AECBAGD;GFGADDCGDDC:CFDEDBFGGGDHF>HBGGBGGGGG9GGADDBDGABFA?DC:CCFGGDDGG;D;G?GGCGCGGGAGGDGE<FFFCDCFFFF:FFCC99FBFBBCFFFCCFFFACFCFCFFEEBECEBAFDBE;C>AAC?	T	82	C	65	75	43	7	22	0.00015
21	9907345	C	187	TCcCTTtTTtTCtCtctttTcttCctcTCtTTTTtttCTTcCtccTTTTTTttCTCTTttttccTCttTCttctcttTttCTtTcTTTTTcccTcCCCcCTCcCCctTCCtctcTTtcTcccTTcTTcctCctctcTTtTtcTctTCtTTTtCttTcttcccccCcccccccccccCccCccccccc	?A>?@AC?DHGGGGGBGGFGBGGGB8BGGGGGGGGCEGGGBGGBAFGEGGEGGGFEHHGGFGBBGGEGGGGGBGBGGGGGGF@FC@EEGGCC?GBGFGCGGGCFGCHG;GHCHCGGHCGCC?GBBGGB@HGCH>HCGGHGFCEBGGGCFFBEFHGFCHH@CBCCFDBCCCCCCBCCFCBFCBC@A<>	T	99	C	88	52	28	47	60	0.00499
21	9907375	T	139	ctctccCccTCcCtCCCCCtttCtTTTtTCTtTTtcCtTTctctCCctCtttCCtCCttcTtctctCCcCctCtcCTcCCccTccCtcctttttTtttttttttttTttTttttttttccctctcctccccctccctcc	AC@CCCB>ADFAFGGGGGAGGGGAEE>GEEEGEDGBEGEEBGBGGGBGFGGFGBGEFGGBEGBGBGGGBEBGGGBGE=AGCBEBCGCBBGGGHHEHHHGHHHHH@H8HHEHHHHGHHBCACHCG@CHCBAACHCC?C@<	T	73	C	66	16	26	57	40	0.02794
21	10910291	C	373	CTTTTTCCTCTTCTCTCTTTCTCTCTTTTTTCCCTCTTTCTTTCTCCCTTCTTCCCCCTTCCTTCCCTtTTTCtCTCTTCTtTCCCCTCCCCCTTTtTCttCcTTCCCCTCTTTTTTTCTCCctTTtTTTtTTCCTTCTTTcTcTtcCTTCCTtccttccCCccccCCccTCTcTTcCTCCTCccTCCCTTTTTTCTTTCtcCTCcTTCTtCCTTTcTCTTCTTccCCCTTtTCCtTTTTtttCCttccCCCCTTTTcTCTTcCTTTtCTTctTTTCtTTTTCTCCtccTTTTTcccTtctTTTTctcTCctccccTTTccccCCCTCtTTCcTCTTCtCCTtCTTTCctTTTcttttccTTCCtccTTCTct	DD??=B=AFEEGGGGGGGGGGGGGFGGGGEFGGGGGGGGGGGG@FGGGGGGGGGGGGEGGFGHHGGGGEGGGGEGGEGGGGEGGGGGFGFFFGGGDEGGEEFGGGGGGGGG<FFFGGFFFGGGFGGFGGFFGGG=FGGGGGFGGGFEGGGGGEFGGFFFGGFEGFGGFFGFFEGECGFDFFFFGGFFFFDFFFFFFEFFFFGFFFDFFCFEFFFFEGDF>EFEEHGFFFFFEFFFFFFFFFFFFFFEGGFFFFFEFEGFFFFGFFFFFFFEGFFFFFFFDFFFFFFFGBFFFFFGG5FEGFFFFFGFGFFBFGGGGEEFGGGFEEEEFEFFEGEGGFFEDCCBACCCC@AAC=B>>>>?A?BAA>?AAA??DC	T	206	C	167	166	113	40	54	0.00566
21	10919969	C	69	CccGCCCCCCGGCCGGGcCCcCCCCCCCCGCCCCGCCGCCCCCccCGCCCGcGCCGcCccccccGCcCC	<DDCDBDDEDCCDDCBCCDADDDDDDDDCCCCDCB;CBC7CCCEECBCCCBE=CCB<BEDA@?A=@:AC	C	55	G	14	40	14	15	0	0.02955
21	10973798	T	123	TTcTTtttcttccTttctTttctcttcttcttttctcTctttttctTccctTtcctctctctttccccctctttctCttcttcttcctcctttttctctctccttcctcttcctcctccccct	DDCB?>A@DBBEGECCFCFDDGBGBDGDDGDDDDGDDGGDDDD=DDGGGGAEDGGDGDGDGDDDGGDGFDGDDEGDDEEHEDGDDGFEGHEEEEEHDGEHEGHEEHHEGEEHGEHHEHHHG@B	T	71	C	52	9	1	62	51	0.04320
21	11027085	A	35	acAAccAcAAaAAacaAcccaaaaaacacacacaa	C?<>BB@BEFDFFEDEEDDDEEFEEED@?EEFE;F	A	23	C	12	8	0	15	12	0.03156
21	11038882	C	402	CCCCcccccCCcCcCCCCcCCccCCccccCccCcccccccCccCcccCcCcCcCcccCCCcCCccCCCCccccCCCCcccCCCcccccCcccCcCCCcCcccCCCCccccCccccCcCCcccccCccccccccCcCCcccccccCCCccccCCCccccccccCCCcCcccCcCcCcccTCCCTTCTcccCCCCCCCCCTccCTcCCCCCCTcCCCTCCCCcccCCCCTCCCCTCCCcccTCccCCTCcCCCTTCcCCTcccccCcCCCTcccCCTcTTcccCTTTCcccCCCCCCcCccCTTCCCCTcCTcccCTTTCCcccCCCCTccccCCTCCccccccCCCCCCCCCCCTccTtcCCCCcccCCccccccCCCCCcccCCCcccCTccccCCCCccTc	BD@CCAC??>>=?8@DBDCFFBAGFBABBFBAFB=BBBBB6B=GBBBGBGBEBGBBBGGFBGFBBHHGGBBBBG8FFBBBFFF@BBBBDBB@GBEDGBFCBBGFFFBCCBGBCBBFC?GCCCCCFCCACCBBCGCGGCCCBBBCGFFCCCCGFFBCBBBCCCFFFBFCCCE?FCFCCCEFGGEEEECC=FFEEFFFFEECCFECFFFFEEECFFEDEEFFCCCCCCEEFFDFED=DDDDEF>CEEEFCFEEEEDCFAECCCCCFCFFDCCCBFEECEECCCFEEEFACBFDFFDFCFCCFEEEDEFECFEB@CFEEEEECCCFEEFECC>CEDEDDCC@C@CFDEDDDEDDBFEBCDHBDDEEBABFFBA?BABCC>DD@<?=BC>>=BA>>75@AAB<;@@	C	366	T	36	180	35	186	1	0.00000
21	11181697	G	51	GtGGGgttgggGGtgttgtGtggtGggGTtGgggGgGGgttgggttggtGG	BA@??BFDFFFEEEFEEEEDEEG7DFFEFFEGGGEFEEGF:GGFFFEFEAD	G	35	T	16	15	1	20	15	0.00983
21	14916669	C	103	cTCcCCTTCCTTccCTTTcccTcCCTCCccTctTTTCCTCTCtTccTcTccTCTcTCCCTCTTTTTTCTcCCTccCtTtCttTcctctCtCCTcTTcTccctC	C@?>BFGGGCGFBBFGFGBA=G@GG>DCCCGCHGGFGGGBGGHDCCGBGCCEGFCFFFFFFFA<FECFF;FFFCCFHEHFFHFBCHCHEHEFEBGDAE???C@	C	56	T	47	28	37	28	10	0.00387
21	34925659	T	238	TTtTTTtTTttTTTTTttTTTTTTTTTtTTTtttTTttTTttTTTTTTTTtTTtttTTTtTtttTtttTttttTTTTtTTttTTTttTTTTTTTTTtttTTTtTTttTtTTtttTttTTtttttTtttTTtTttTtTTttCccccctCCCCCCCtcccctcccccccccTtcttCTcTTCtctTTtcCCTTctctccCTCCccTTttCccTTCCTTTttTTcccCCTTtTCctTtccc	CDBB?@CBACEFFFEFGHGG@FFFGGDGGGGGGGGHGGGGGGGGGGGGGGGGGGGGGGGGGGGGDDGGGHGFHFGGFCGGGHFGFGHGGGGGFGFGHHHGGGHGGFGGHGGHHHGHH>GHHHHHEHHHFFHFHHFHFFCHCDDDCCHDDDCDCDH@CCCHCCCCCCCCBFHCHH8FBFFCHCHFFF<CCFFCACHCCCFCCCCFFHHBCCEFCCEEEHGEDABCCAFEEDA=B?@><;	T	180	C	58	102	21	78	37	0.00986
21	38593620	G	268	GTttGGGGGTTGTTTggtTTTTGtggtTGGGTGGgggttGtgtGTTTttGtggtgTTggtggGgtGtgtgGTGgGTGgTTgtGTggggggtgggGGgggtGTgGgTGgggGtTgttTgGtTTggtTTgtgtTggttTGttTTTTttGGggTgtTTtttgggGTGtTGtgTTTTggttGggGtgtggTgtggggggGggtTTgTgTGGGGGgtgGTTGggtTgTggGgGGgGGTggtttgttTTgggtTtggggTTgTgGgTttTTGGt	@CCC=>;<;>B>ABAB=C@CCB?DCGEABCAFCCFFFDECDFDCGGFEEC7FFEFGGFFEFFBCEBEFDFCGCFAECFAGFDC=FFFBFFEDFDAAFFFECGFCFECFFFCEFFEEGGCEFGGFEGGGFGEBGBFFG@EFFEGGFFCCGGGGFGGFFFGGGCGB@GCEFGGG<FGEDCGGAFGFFGGGFDGGGGGBGFEFFGGGFBBBBBGFGBFFBDGFFGFGEBG@ADBBFGGFFFGFFFFCGGEFCGGF;FFEFF@BC@<DDAAC	G	147	T	121	54	64	93	57	0.00946
21	43523972	G	160	cccgcGcCGCggCccGGCGCgGgccGggCGGcCGgCcggcCccGCgcGgcgcggGcGcCCGGcgGccCcccGGcccGcCggGGGcGccccCCgcCCGGGGcgGccggGgcgGGgCcgcccCGGgCGgcccGccCcgGcgGCCGGgcCGGGCCcCCcgggg	AC?C<C;AGFCBCBBHHGHGCHCBBHCCGHHBGHCGBCCBGBBHGDBHDBBBC=HBHBFGHHCDHCCGCCCHHCCCGCGDDHHHCHCCCCGFDCFFHHHGBD6BCDDGDCCGGDFCDCDDFGGDFGDC@CGCCFCDGCDGFFGGDCDGFGEEBDA8>@AA	C	82	G	78	29	43	53	35	0.01688
21	44323590	T	48	GttGgttGGgtttgtGgTtgttTtTGGtGgGggttttGggGggggGtg	@DEAFDECCFEEEFEAFHEFEFGFGCCFCGBGG@GDFBGGBGGGGBDA	G	27	T	21	12	3	15	18	0.03192
21	45506649	C	43	TTCCCTTCCCCCTtCTCCCCCCtTTTTCCtTCTTtCCTCTtCt	EGFFDFEGFGFGFEEEDEEEFEFECEEEEEEFEDCEFFCB@CB	C	22	T	21	22	15	0	6	0.00890
21	45649543	G	40	ccCcccccccgcCGCCGGCgGgccggcGcGGgGGCGGGGG	AGFGGFGGGGFHGBAGEE7EE@HGEGHDHDDGDDDDDDCD	C	20	G	20	6	14	14	6	0.02564
21	46020473	C	37	CCCCCCCCCCCCCCCCCCCCCCCcttttTtTtTtTtt	DCGGGGGGGG>GDGGGGGGFGGGGFFFF;DCBBAACB	C	24	T	13	23	4	1	9	0.00005
21	46057590	A	63	TTTAAATAtTTAAATtAaATAAtTTtAAtAttAAatAATttttTAtATTTtTTTTTTTTtTTt	B=?BDHFEEDG=HHHEHEFGH7FCGEH:FEFFHHEFCGF<E?FFCFGDFFFFFFFFFFFFDC:	T	41	A	22	25	20	16	2	0.01797
21	47958657	C	86	CccCtttctCttcttCtctCttttttcttccccCtttCcccCtttcccccttttttcctccTTtcttttCtttctttttcttcttt	D?C?BC;>@CDFBGFGGBGGGGGGGGBGGABBBGGGGGBAAGGGGBBAB<HHGHHHCCHCAGGHCGFCHFHHHA6FIHGBHGCHFC	T	51	C	35	2	9	49	26	0.00603
22	16414200	A	150	AAGGAAAAAGGaGaAAAAAAAAAGAGGGAAAAGAGaGAaAgAGAAgAAAaGGaaGGGaGAAAaGAGAGAAAGGGGAagAaaGAaAAAgGGGGGGGGGAGGGGAGAGAaaAGGaaGaAaaaAaaAAaaaaAAAaaaGaaaaGGGGGAGgga	E@=ACFHHHCCECDGHCHHEHFHBHBCCHHGHCHC7>HEHFHCGEGGGCFCCFECBC=CHHG7AHCHCFHHBCCCH=DGAFCAFG?GGC<BBBBBCBGBBBBGACAGFFGBBFFBFG;FFGFFGG?EFFFGGFED?AA@@<<:CCC?CC@	A	92	G	58	57	52	35	6	0.00016
22	16414348	T	153	TTtTTcctctcTcTTTtTCttcttTccTcTtTtctctTtcTTTTttTTctttctTtTcTcTcttcccTttTctTctccTTtttTTttctTtCTttcttttttccttttttctttttttttttccttctttttttccttctttttttttttttt	DDC7@CBDFEEGFGGGDGFEEFEEGFF@FGEGEFEFEGDFGGGGEEGFFEEEFEFEFFB?E9FEFFCDEEGFEE9EFC8GEEE8FEFGCGEGGEFGFFFFFEGGFFFDFFGFBEEFFCC;>FFFFFGEFFBDFFGGFFGFFFFFFFEE<B=?C	T	116	C	37	33	2	83	35	0.00299
22	19119589	G	127	gaGGgAAAAAagAGGAAAGgAAAAggaAgAAAggGgGAgAgGggaaGAaGAAGaAAgaGAAaGAGgAGAGgAGgaaAAGAggGGAAgAGGaAAGGGaAgaaAgaggAAaAAAAGgAaGGGAAGgaAa	>CACB>FHHH?FACCH8HCFHHCBFFFGFHHHFFCFCHDHECGGGFCHDCFH;GEHGGBGFGBGBGFBFBEGBGGGGGBDGGBBGGGGBBGGGBBBGGGGGGFCGGGGGBECFBGGEBB@DC=@@?D	A	70	G	57	50	30	20	27	0.04170
22	19486600	C	84	TCTCTCCTTCTTCTCCTTCtccCTCtCTCTTtcTCTCTCCtTtTTccCCtTtCCCCttCCtCtCcCTtCTCtCCCCCCtcCCtC	CDFBFGGFFGFFGFFFFFFFGGGEDFFFGD@F@FEFDEEGFEFBEGGEEF>EEDF:FFFDEDFEGFDEEDFEFEBBBB>A>B>?	C	46	T	38	39	23	7	15	0.01419
22	22424857	G	25	GAgAggAaAAagggAAggAAaaaga	AHCHCCHFHBFDDBFHDDHHFGF>A	A	15	G	10	9	1	6	9	0.01772
22	23247169	T	161	TTTTTtttttTTTTttTttTTtgtttTttTtTTtggTttTttttgttTttttgTtggttgttggttttTTgTTgTtggTTtgttgggTtTTtgTTtTTtttTTTTtTTtttttTTttttTtttTttttttttttttTttttttTTTttttttttttttttt	;>=9?BCDEF6E;AFGEGFEEGFGGGEGGEGECGFFFGGAFGGGFGGEHHGGFB7FFEGFGGGGFFHHE5DEDF@FFGEEHGGHGGEDHDEHGECGEEHHHECEEGCEH>HH=DDHGHHDFHECHHHEBHGHHHHHDHIE;HFDDDHHHFHHGHAHHFGEE	T	142	G	19	48	0	94	19	0.00097
22	23247170	G	160	GGGGGgggggGGGggGggGGgtgggGGggGGgGGgGttggGggggtggGggggtGgttggtggttggggGGtGGGtGgttGGgtggtttGgGGgtGGgGGgggGGGGgGGgggggGGggggGgggGggggggggggGgggggGGGggggggggggggggg	EE;=@=@<BBHFCBCHCBHHCCCCCHHCCHGCHECBGGCCFCCCCDCCHCCCCFHAGGCCGCCEGACCCHC@FHHHGCFHHHCHCDHHDGDEHDHHFDHHDDDHGHHDGHD;DD9HFDDDDG?DDGDDDDDDDDDCGDDDDDGGGDDDDDDDECDDCDC<	G	141	T	19	50	0	91	19	0.00091
22	23247174	G	153	GGGggGggGGgagggGGggGGgGGgGaaGggGggggaggGggggaGgaaggaggaagggGGaGGGaGgaaGGgaggaaaGgGgaGGgGGgggGGGGgGGggggGGggggGgggGggggggggggggGggggggGGGggggggggggggggggg	>?CABDCCGFFEFCEHGFFGHFHEFHFFBFF;FFFFFDFDFFFFFBFFEFFFFDFF??FHGBGHHFHFFFHGGGFFFGDHFHAFHHFHGFGFHHHHDHHGGGGHGGGGGHGGGDEGGGGGGGGGGGGGGC=EGGGGGGEGGGGGGGGGEGEA?	G	134	A	19	45	0	89	19	0.00099
22	23631639	T	59	CcCCTTTCTTCcTTCCTCTCTTTTCCTCTTcTTcCTTTTTTCcTCTCCctTcCTCCCTT	FBGF=FFGEEFCFBGFFFFFDAEFAFEFEE<EECFEEEEEEFCEEEEECHDCE=BBAAC	T	31	C	28	30	21	1	7	0.02151
22	24580807	C	43	CTCTCCCTTTTTcCTCcTCCCTCCTCTTTccTCCcCCTCcCCc	DGDHDDEFGEGGCDGCBFCCCF@@FC?FFCCFBBBDCEC@AA@	C	27	T	16	20	16	7	0	0.03462
22	26247607	C	75	CttttccCtttcCttccCCCctttTttctctcctctcttcccccctCctcttCctcccCtcctctttcccccctc	@A<BBFFEDDDGGDDGGGGGFDDDGDDGDGDGGDGDGEDGGHGHGEGHDGEDGHEHGHGEHGEHEEBHGHHGG@E	C	43	T	32	9	1	34	31	0.03707
22	29819081	G	69	GGGGGgGggGAgGGggGgGGggGAGgAGgGGgggGGAAGGGGGAGGAgggAgAgGGggGgAGgGAGgGg	AABCCFCFF=HFCB=F@GABGGCHCEHCGCCGD>BCGGCABBBGBBGGGGGGGGBBGG@DGBGAGBG@?	G	58	A	11	33	11	25	0	0.00535
22	29837847	G	231	GggggggGGGggggggggggggGgggggggggGgggGgggGggGGgGGGGGGGGGggGGggggggggggGgggGGGGgggGggggGggggggGGgGGGggggGgGGGggGGGGGgggGggggGGgGgGggGgggGggCGGggGGgCCgGggGCGGggggggggggCgggGggggggggGGggggggGgggCCgggggGCGgggCGGggggggggGGggGcgGGcgGgGGgC	@ACC@@@=5;8ABCCCDCD>DCACBB@B?CBBCCCCCCCCCCCCCCBCC;BCCCCCCCBCCCC7CCCCCCCCCCCCCCCCCC?CBCCCCCCCCCCCCCCCCCCCCCCCCCCAC<DCCCDDDDCCDBDBDDCDDDCDDDCCDCCCDDDDCCDCCCBDDDDD9DDCDCBDDBDDDDDDCDBBDDDDDDBDDDCCDDDDDBCBDDDCBBDDDDDDDDBBDDBCDAAB?B???>C	G	219	C	12	73	10	146	2	0.00080
22	30733111	C	31	aaCcaCCcCcaaaaccCaccaaccaCcaaaa	C@BFDFFGFGDDDDFGFC8G;EGHDCEFEEE	C	16	A	15	6	0	10	15	0.01767
22	32756652	A	100	GAaAaaaAaaaaaAaaAAaAGaaAaaaAaAaaAaAaaaAGAaaaaAAaaGAAAAAGaAaAGAAGAAaAAgAAAAaAAGGAGAaGAGAaGGagAGaAAagg	BCBADDFFEEFFFFFFBFFEFFFFFGFFFEFFFD@GGGCFEGFEGFFGGGEFFFDEGEGEFE:FEEGEEEEEEEGEEFFDFDGF@EEFEEFCEFFBC@8=	A	81	G	19	42	15	39	4	0.04005
22	36545826	T	74	CCCCTTTTtTCtTCTtCCcTCcCtTCTTTTcCTCCTCCCTTTtTCCCTCCCCtCCTtTTtCTCCtttTtttTTc	GGGEHGGGEGG>GGDEG=GGGGFEFDEEEEGFDFFFFFCFEF=FFFFFFFFFBFFF<FFEFFFFC>EG@@=AB<	T	41	C	33	27	29	14	4	0.03265
22	36919375	G	151	GGGccGggGcGGcCcGGGgGgCcggcggGgcGGccgccGgGGcCgCcccgcCggcCCgGGgccgcGgggcgcgccggGcccggcGggcggcgcGccGgccgGGcGgGccgccccgggggggggcccgccgcggcggggggggggcgcgggg	BBBCC@AABDDCDFDDDDEEEFDFEDFFEFDEEDDEDDCEEDDG?FDDDFDGFFDGEDEEFDD9DEFFDDDDFDDFEEDDDEGEEGGEFDDFDE9EAGEDFEEEEFDEEFEEEEFGGEGGFF<EEEGEEGEGGCFCGGBGGGGFDGEAEAC	G	92	C	59	28	7	64	52	0.00986
22	38025640	G	36	gggGaaagaaGaggagGaagGGaaGGAGGagggaag	??@BDEBE?EGEEEDDG=@EGGEDFDFGGCGGADEE	G	21	A	15	9	1	12	14	0.02447
22	40271614	C	30	gggcggggcgcccccgccgCcCCCCCcCgC	AAACEEFFDEDDDDDFEEGFEFFFFFEFBB	C	19	G	11	8	0	11	11	0.01401
22	40271822	A	78	AAaAaAaAAAaaaaAaAaAAGAaGAGGGGAGaaaaaGAAAAGaAAAaaGGaaaGAaAAaaAaGAGAGAAAaaaAGGaA	?@CDDDEEEEEEEEEEEEEEGEEHEGGHDEHEFCFFHEEEDFFDDDFFGHDFFGCFDDEFDEG@GDGDDDFFEEGGDC	A	61	G	17	32	17	29	0	0.00013
22	41747717	G	38	aagGaaagGgaaaaaaGaagaaaagagagaagaggaag	DECFEFFCGCFFFFFFEDFCFFAGCFDFDGGDGDBBF=	A	24	G	14	0	3	24	11	0.04315
22	42523539	A	179	AAAAAAAaaaAAgAAAaagAAgaAAaAAaAAgAgaGagAAAAaagaaAaaAAAaAaaaAAaAAaAAAAAAGaaAAAaaaaAaAAAaaAaaaAaaaagaaaaaaaaAAAgaaAAAaaAaaaAAaAagaaaaAAAAagaagaAAaaaaaAaAgaAaaaAaaagaaAAaaaagaAAaaAAga	:CA@@<>BACGDFGHGEEFHHFEHHFHGFHHFHFFCFFCHDHFFFFFHFEHHHFHFFFDHEHHFHHHCHHCGFHHHGGGFEG8GGGGFEGGGGGGGGFGGGG:FGHHHG6GHHHDG@GGGGHGHGGGGGGGGGGCGFDCEGGFEGGG:FGGGGGGGGCE;FEGFGGGGEGFFGFEDEAB	A	161	G	18	75	2	86	16	0.00461
22	42536653	T	89	TTTTttTTTTTTtTTTTtTtttTttTTTTTtTttttttTTTTttttTTTTCtCCTTTCCCtttCTTCTCTTtttCtCtTTTTtTCCtCT	EEECEEDEEEEEEEFEFD8DED;FDDEEDEFBFFF:DFEEEEE:FFDDDDFEFFDDDFFFFCFFDDFDFDDFFE@EFCDDDDFD>EF@C	T	75	C	14	44	14	31	0	0.00170
22	42537280	T	53	CCCCcCCcTCCcccCCCcTTTCCCCTtcTCTcTCccccccTcTcccTcCcCcc	@BDFBFGBGG>@BBFG9CFFFGFGGEHCFFFCFFCCCC>@ECECCCDCE<F>>	C	41	T	12	19	11	22	1	0.00706
22	42546864	C	114	tttCcccccccCCCCCCcCCCccCCCtCCtCCccccCCCCcCcCCCccCcCcCctccctccccCccCcccccccCccccCcccCcCCccCCccccCccCCCCcccccccCCccc	CA?B<@@?@BAFFGGFFAFFFBBFF:CFFG>GBBBBGGGFBGB?FFBBFBECFCG:9AHCCCCCBCGCCCCCCBFCCBCECCCFCEFCAEFCCCCFC@FEEECCCAA@@CB>;@	C	107	T	7	44	0	63	7	0.04207
22	44285765	A	40	ggaAAGaGAAgaggAaAAAAggAGAAAgAagAAGAGAgGG	CCFHHCFCHHCGCDHFHHHH=DHB@FHDGGDGGBGBGC>C	A	23	G	17	18	7	5	10	0.02351
22	50650907	T	132	TCCCTCCCCTCCTTCTCTCTCTTTTTCtTTCTCTcTTTcTTTCTccTTCTTCCCCTCTCcTTTTCTTTcTTTCCTTCcccTTtttTTTTcctcTCCCTCTTcTCcTTTCCTTcTtCcTTttTTCTTcCCtCC	BFGGGGGGGGDDGGGGGFDGGFGGFFDHGGFDGGCGGGBEGGGGBBGG=GEGFGGGGGDCF=FGGFGE=FBFFFDFFCCCFFGHHFEFFC;B?DFFFFFFFAFFCCAFFFFFCFHFCEFHHDC@BB;@A?C@	T	74	C	58	65	41	9	17	0.01633
22	50876235	T	318	CTcTTtCTCCTCTTCTCCTCTTTTCTCttTTTTCTCTTtTCttTCCTTTCCTtTCCCtCTCTCTCCTtCTCcCTCTTTCTCttTTTCCCTCtCTttCCCCCTTCCTTTTCCTTCCcTCCCtCCctcTTTttCCTtTCCTTTtTTTTCCTCCtTCTttCCCtTTTTcTCCtCTTTTCTCTTCTTTCtCCTCTcCCcctCCcTTTtccctccTTTtcttTCTTttcttttCCcCCCCTtttttTTCctTTTTTTTTTtctttTCTCTTccctCCTTCCTcTTTCTTCtttTTCTCTCtCTTCttCtCCTctCCCtTTctC	AE<?BC>D?CCCGGDG?DGDGGDGDGDGGGDGGDEDGGFGEGFHDDGGGDDGGGDDDGDGDGDGDDFGCGDBDGDGGGDG@HHGFFCDA?DFDCHHACDDDGGDDGGGGDDGGDDBGDDDGDDBGBGDGHHDDGHGDCGGFHEFGGCDFCCHGCGHH@BCF@FFFCFCCHCFFEFCFCFFCFFFCHCCF@FCCCCC>@CCFEF:CBCFBCFFFDCHFFCFFHHCHHHHCCCCCCCFHDHHDFFCCHFFFFFFFFFHCHHHFCFCFFCACHCCFFCCFBFFFCEFCHCHEECFCFCEBEFCGFCDABE<B@AABCC8@C	T	185	C	133	126	107	59	26	0.01493
X	139298295	C	72	CccttTCtCtCtcCTCCTtccCCcttCCccCCCcccCctCcCtcctcCccCctcCccCtttCCcCcCcctcc	ACBBCBBC<FFDFFFFGFEFFGFFEEFGFGEGFFGGGG?=GFBGGFGGFGEGFGFGHFFFEFEFFGFGFCDD	C	53	T	19	25	3	28	16	0.02661
X	140993877	C	47	ccacCCCacaCAaaaccCCCCcCCCCCCCCCcCccCcCcCCCcccCc	B@>AAADE9EEHE?EDDD?ADEDDDDCCCCBECEECEC=CBCCA>A<	C	40	A	7	24	1	16	6	0.04001
X	149101934	A	140	AAaAcAcAaaaAcacaaAAacaaAaacaaaAAcAAcAccaAAAcaaaaAacAAaaaccAAaacaAcccacAaAAAAAaAAacAaaaaaaaAaAaaAaAAAaaaAAAaaaaaAAaAaaaaaaaaAaaaAaaaAaAaAAAAa	@CC<>A@BEEF7DDCDEDFEDDEEE<DCEECDDFFDEDD?FFFDEEEEFEDFEEBED@DFFFDEFDDAED<FFEFFFFEEFDFEF@@FFFFFFEFFFEDFEFDEEAEEFFFEDFEFFFEEF;FEFDFDEAEEFFBBACA>	A	120	C	20	52	0	68	20	0.00007
